YEAR,NAME,ST,FIPS,TOTAL_FILINGS,CHAP_7,CHAP_11,CHAP_12,CHAP_13,TOTAL_BUSINESS_FILINGS,BCHAP_7,BCHAP_11,BCHAP_12,BCHAP_13,TOTAL_NON_BUSINESS_FILINGS,NBCHAP_7,NBCHAP_11,NBCHAP_13
1999,Autauga,AL,1001,231,120,1,0,110,4,3,1,0,0,227,117,0,110
1999,Baldwin,AL,1003,695,401,6,0,288,10,6,4,0,0,685,395,2,288
1999,Barbour,AL,1005,98,45,0,0,53,7,3,0,0,4,91,42,0,49
1999,Bibb,AL,1007,183,51,0,0,132,5,4,0,0,1,178,47,0,131
1999,Blount,AL,1009,284,141,1,0,142,2,1,1,0,0,282,140,0,142
1999,Bullock,AL,1011,42,17,0,0,25,0,0,0,0,0,42,17,0,25
1999,Butler,AL,1013,112,36,0,0,76,1,0,0,0,1,111,36,0,75
1999,Calhoun,AL,1015,891,443,3,0,445,5,3,2,0,0,886,440,1,445
1999,Chambers,AL,1017,392,102,0,0,290,2,2,0,0,0,390,100,0,290
1999,Cherokee,AL,1019,111,53,0,0,58,0,0,0,0,0,111,53,0,58
1999,Chilton,AL,1021,205,95,0,0,110,5,5,0,0,0,200,90,0,110
1999,Choctaw,AL,1023,59,16,1,0,42,1,0,1,0,0,58,16,0,42
1999,Clarke,AL,1025,161,63,0,0,98,2,2,0,0,0,159,61,0,98
1999,Clay,AL,1027,83,15,0,0,68,0,0,0,0,0,83,15,0,68
1999,Cleburne,AL,1029,46,19,0,0,27,0,0,0,0,0,46,19,0,27
1999,Coffee,AL,1031,268,145,2,0,121,9,7,2,0,0,259,138,0,121
1999,Colbert,AL,1033,363,119,3,0,241,3,0,3,0,0,360,119,0,241
1999,Conecuh,AL,1035,77,33,0,0,44,0,0,0,0,0,77,33,0,44
1999,Coosa,AL,1037,92,22,0,0,70,1,1,0,0,0,91,21,0,70
1999,Covington,AL,1039,211,106,4,0,101,9,2,4,0,3,202,104,0,98
1999,Crenshaw,AL,1041,79,34,0,0,45,5,5,0,0,0,74,29,0,45
1999,Cullman,AL,1043,435,259,2,1,173,4,2,1,1,0,431,257,1,173
1999,Dale,AL,1045,373,188,2,1,182,12,3,2,1,6,361,185,0,176
1999,Dallas,AL,1047,265,125,0,0,140,0,0,0,0,0,265,125,0,140
1999,DeKalb,AL,1049,325,173,1,0,151,0,0,0,0,0,325,173,1,151
1999,Elmore,AL,1051,393,182,0,0,211,5,4,0,0,1,388,178,0,210
1999,Escambia,AL,1053,198,78,0,0,120,0,0,0,0,0,198,78,0,120
1999,Etowah,AL,1055,775,343,4,0,428,4,2,1,0,1,771,341,3,427
1999,Fayette,AL,1057,106,27,0,0,79,5,3,0,0,2,101,24,0,77
1999,Franklin,AL,1059,155,66,0,1,88,1,0,0,1,0,154,66,0,88
1999,Geneva,AL,1061,189,101,0,0,88,8,4,0,0,4,181,97,0,84
1999,Greene,AL,1063,86,8,0,0,78,5,1,0,0,4,81,7,0,74
1999,Hale,AL,1065,182,13,0,0,169,4,1,0,0,3,178,12,0,166
1999,Henry,AL,1067,104,64,0,1,39,3,1,0,1,1,101,63,0,38
1999,Houston,AL,1069,661,309,1,3,348,31,16,1,3,11,630,293,0,337
1999,Jackson,AL,1071,269,162,0,0,107,2,2,0,0,0,267,160,0,107
1999,Jefferson,AL,1073,6802,2275,19,0,4508,42,17,19,0,6,6760,2258,0,4502
1999,Lamar,AL,1075,86,29,0,0,57,1,1,0,0,0,85,28,0,57
1999,Lauderdale,AL,1077,503,175,2,0,326,5,2,2,0,1,498,173,0,325
1999,Lawrence,AL,1079,166,70,1,0,95,0,0,0,0,0,166,70,1,95
1999,Lee,AL,1081,564,192,2,0,370,11,2,2,0,7,553,190,0,363
1999,Limestone,AL,1083,346,166,0,1,179,4,3,0,1,0,342,163,0,179
1999,Lowndes,AL,1085,61,16,0,0,45,0,0,0,0,0,61,16,0,45
1999,Macon,AL,1087,126,30,0,0,96,1,0,0,0,1,125,30,0,95
1999,Madison,AL,1089,1469,821,5,0,643,13,8,3,0,2,1456,813,2,641
1999,Marengo,AL,1091,112,20,0,1,91,2,0,0,1,1,110,20,0,90
1999,Marion,AL,1093,145,88,1,0,56,8,5,1,0,2,137,83,0,54
1999,Marshall,AL,1095,480,280,1,0,199,3,3,0,0,0,477,277,1,199
1999,Mobile,AL,1097,2846,1246,14,0,1586,21,7,13,0,0,2826,1239,1,1586
1999,Monroe,AL,1099,128,37,3,0,88,3,0,3,0,0,125,37,0,88
1999,Montgomery,AL,1101,1447,557,5,0,885,19,8,5,0,6,1428,549,0,879
1999,Morgan,AL,1103,687,376,3,0,308,8,6,2,0,0,679,370,1,308
1999,Perry,AL,1105,58,16,0,0,42,1,0,0,0,1,57,16,0,41
1999,Pickens,AL,1107,177,16,0,0,161,9,2,0,0,7,168,14,0,154
1999,Pike,AL,1109,147,56,1,0,90,3,2,1,0,0,144,54,0,90
1999,Randolph,AL,1111,157,44,1,0,112,5,4,1,0,0,152,40,0,112
1999,Russell,AL,1113,202,89,0,0,113,2,2,0,0,0,200,87,0,113
1999,St. Clair,AL,1115,384,211,2,0,171,4,3,1,0,0,380,208,1,171
1999,Shelby,AL,1117,702,373,14,0,315,23,7,14,0,2,679,366,0,313
1999,Sumter,AL,1119,112,8,0,0,104,3,0,0,0,3,109,8,0,101
1999,Talladega,AL,1121,759,174,1,0,584,3,2,0,0,1,756,172,1,583
1999,Tallapoosa,AL,1123,262,58,1,0,203,3,2,1,0,0,259,56,0,203
1999,Tuscaloosa,AL,1125,1592,208,3,0,1381,63,24,2,0,37,1529,184,1,1344
1999,Walker,AL,1127,468,241,0,0,227,27,15,0,0,12,441,226,0,215
1999,Washington,AL,1129,99,33,0,0,66,0,0,0,0,0,99,33,0,66
1999,Wilcox,AL,1131,39,12,0,0,27,0,0,0,0,0,39,12,0,27
1999,Winston,AL,1133,133,77,0,0,56,9,8,0,0,1,124,69,0,55
1999,Aleutians East Borough,AK,2013,0,0,0,0,0,,,,,,,,,
1999,Aleutians West Census Area,AK,2016,0,0,0,0,0,,,,,,,,,
1999,Anchorage Borough,AK,2020,720,646,13,0,61,47,24,13,0,10,673,622,0,51
1999,Bethel Census Area,AK,2050,3,3,0,0,0,0,0,0,0,0,3,3,0,0
1999,Bristol Bay Borough,AK,2060,1,1,0,0,0,0,0,0,0,0,1,1,0,0
1999,Dillingham Census Area,AK,2090,236,220,1,0,15,22,17,1,0,4,214,203,0,11
1999,Fairbanks North Star Borough,AK,2100,0,0,0,0,0,,,,,,,,,
1999,Haines Borough,AK,2110,62,58,0,0,4,6,5,0,0,1,56,53,0,3
1999,Juneau Borough,AK,2122,0,0,0,0,0,,,,,,,,,
1999,Kenai Peninsula Borough,AK,2130,42,42,0,0,0,3,3,0,0,0,39,39,0,0
1999,Ketchikan Gateway Borough,AK,2150,30,29,0,0,1,4,4,0,0,0,26,25,0,1
1999,Kodiak Island Borough,AK,2164,0,0,0,0,0,,,,,,,,,
1999,Lake and Peninsula Borough,AK,2170,197,174,0,0,23,6,5,0,0,1,191,169,0,22
1999,Matanuska-Susitna Borough,AK,2180,1,1,0,0,0,0,0,0,0,0,1,1,0,0
1999,Nome Census Area,AK,2185,,,,,, , , , , , , , , 
1999,North Slope Borough,AK,2188,0,0,0,0,0,,,,,,,,,
1999,Northwest Arctic Borough,AK,2201,0,0,0,0,0,,,,,,,,,
1999,Sitka Borough,AK,2220,0,0,0,0,0,,,,,,,,,
1999,Southeast Fairbanks Census Area,AK,2231,0,0,0,0,0,,,,,,,,,
1999,Valdez-Cordova Census Area,AK,2240,0,0,0,0,0,,,,,,,,,
1999,Wade Hampton Census Area,AK,2261,0,0,0,0,0,,,,,,,,,
1999,Wrangell-Petersburg Census Area,AK,2270,0,0,0,0,0,,,,,,,,,
1999,Yukon-Koyukuk Census Area,AK,2290,0,0,0,0,0,,,,,,,,,
1999,Apache,AZ,4001,84,73,1,0,10,4,4,0,0,0,80,69,1,10
1999,Cochise,AZ,4003,437,389,1,1,46,36,27,1,1,7,401,362,0,39
1999,Coconino,AZ,4005,285,245,8,0,32,13,6,6,0,1,272,239,2,31
1999,Gila,AZ,4007,216,178,2,0,36,3,1,1,0,1,213,177,1,35
1999,Graham,AZ,4009,113,101,0,0,12,5,5,0,0,0,108,96,0,12
1999,Greenlee,AZ,4011,50,43,0,0,7,0,0,0,0,0,50,43,0,7
1999,La Paz,AZ,4012,60,54,2,0,4,5,3,2,0,0,55,51,0,4
1999,Maricopa,AZ,4013,14509,11292,264,1,2952,425,159,240,1,25,14084,11133,24,2927
1999,Mohave,AZ,4015,845,748,5,0,92,39,19,5,0,15,806,729,0,77
1999,Navajo,AZ,4017,212,171,0,0,41,5,5,0,0,0,207,166,0,41
1999,Pima,AZ,4019,3867,3206,29,0,632,201,126,26,0,49,3666,3080,3,583
1999,Pinal,AZ,4021,737,635,2,0,100,24,14,2,0,8,713,621,0,92
1999,Santa Cruz,AZ,4023,138,123,2,0,13,7,3,2,0,2,131,120,0,11
1999,Yavapai,AZ,4025,611,522,1,0,88,14,10,1,0,3,597,512,0,85
1999,Yuma,AZ,4027,520,437,10,0,73,17,8,7,0,2,503,429,3,71
1999,Arkansas,AR,5001,205,61,0,0,144,6,0,0,0,6,199,61,0,138
1999,Ashley,AR,5003,147,93,0,0,54,3,1,0,0,2,144,92,0,52
1999,Baxter,AR,5005,156,150,0,0,6,3,2,0,0,1,153,148,0,5
1999,Benton,AR,5007,781,530,6,1,244,19,11,6,1,1,762,519,0,243
1999,Boone,AR,5009,164,144,0,0,20,6,6,0,0,0,158,138,0,20
1999,Bradley,AR,5011,78,35,1,0,42,4,1,1,0,2,74,34,0,40
1999,Calhoun,AR,5013,26,12,0,0,14,1,0,0,0,1,25,12,0,13
1999,Carroll,AR,5015,86,70,0,0,16,4,4,0,0,0,82,66,0,16
1999,Chicot,AR,5017,73,36,0,0,37,3,1,0,0,2,70,35,0,35
1999,Clark,AR,5019,167,84,0,0,83,2,0,0,0,2,165,84,0,81
1999,Clay,AR,5021,69,66,0,0,3,1,1,0,0,0,68,65,0,3
1999,Cleburne,AR,5023,120,97,0,0,23,2,2,0,0,0,118,95,0,23
1999,Cleveland,AR,5025,59,24,0,0,35,3,1,0,0,2,56,23,0,33
1999,Columbia,AR,5027,108,64,0,0,44,1,1,0,0,0,107,63,0,44
1999,Conway,AR,5029,98,68,0,0,30,0,0,0,0,0,98,68,0,30
1999,Craighead,AR,5031,443,358,3,0,82,10,6,2,0,2,433,352,1,80
1999,Crawford,AR,5033,329,274,0,0,55,6,4,0,0,2,323,270,0,53
1999,Crittenden,AR,5035,521,246,1,0,274,2,1,1,0,0,519,245,0,274
1999,Cross,AR,5037,95,75,0,0,20,1,1,0,0,0,94,74,0,20
1999,Dallas,AR,5039,60,15,0,0,45,4,2,0,0,2,56,13,0,43
1999,Desha,AR,5041,123,60,0,0,63,2,0,0,0,2,121,60,0,61
1999,Drew,AR,5043,114,50,0,0,64,5,1,0,0,4,109,49,0,60
1999,Faulkner,AR,5045,451,281,0,0,170,6,5,0,0,1,445,276,0,169
1999,Franklin,AR,5047,94,70,0,0,24,2,1,0,0,1,92,69,0,23
1999,Fulton,AR,5049,44,41,0,0,3,0,0,0,0,0,44,41,0,3
1999,Garland,AR,5051,755,426,4,0,325,22,10,4,0,8,733,416,0,317
1999,Grant,AR,5053,131,42,1,0,88,4,0,1,0,3,127,42,0,85
1999,Greene,AR,5055,211,200,0,0,11,0,0,0,0,0,211,200,0,11
1999,Hempstead,AR,5057,107,68,1,0,38,2,0,1,0,1,105,68,0,37
1999,Hot Spring,AR,5059,229,106,0,0,123,2,1,0,0,1,227,105,0,122
1999,Howard,AR,5061,91,57,2,0,32,3,1,2,0,0,88,56,0,32
1999,Independence,AR,5063,142,121,2,0,19,3,1,2,0,0,139,120,0,19
1999,Izard,AR,5065,39,36,0,0,3,1,1,0,0,0,38,35,0,3
1999,Jackson,AR,5067,77,59,0,0,18,0,0,0,0,0,77,59,0,18
1999,Jefferson,AR,5069,872,350,4,0,518,20,10,3,0,7,852,340,1,511
1999,Johnson,AR,5071,105,78,0,0,27,3,2,0,0,1,102,76,0,26
1999,Lafayette,AR,5073,41,21,0,2,18,3,0,0,2,1,38,21,0,17
1999,Lawrence,AR,5075,89,81,0,0,8,1,0,0,0,1,88,81,0,7
1999,Lee,AR,5077,36,19,0,0,17,1,1,0,0,0,35,18,0,17
1999,Lincoln,AR,5079,90,43,0,0,47,3,2,0,0,1,87,41,0,46
1999,Little River,AR,5081,66,43,0,0,23,0,0,0,0,0,66,43,0,23
1999,Logan,AR,5083,85,71,0,0,14,2,1,0,0,1,83,70,0,13
1999,Lonoke,AR,5085,441,232,1,0,208,2,1,1,0,0,439,231,0,208
1999,Madison,AR,5087,59,42,1,1,15,5,1,1,1,2,54,41,0,13
1999,Marion,AR,5089,67,63,0,0,4,0,0,0,0,0,67,63,0,4
1999,Miller,AR,5091,169,122,0,0,47,5,3,0,0,2,164,119,0,45
1999,Mississippi,AR,5093,371,254,1,0,116,3,3,0,0,0,368,251,1,116
1999,Monroe,AR,5095,53,31,0,0,22,0,0,0,0,0,53,31,0,22
1999,Montgomery,AR,5097,39,25,0,0,14,4,1,0,0,3,35,24,0,11
1999,Nevada,AR,5099,72,44,0,0,28,0,0,0,0,0,72,44,0,28
1999,Newton,AR,5101,22,19,0,0,3,0,0,0,0,0,22,19,0,3
1999,Ouachita,AR,5103,207,127,0,0,80,4,3,0,0,1,203,124,0,79
1999,Perry,AR,5105,58,34,0,1,23,1,0,0,1,0,57,34,0,23
1999,Phillips,AR,5107,116,66,0,0,50,4,4,0,0,0,112,62,0,50
1999,Pike,AR,5109,47,28,0,0,19,0,0,0,0,0,47,28,0,19
1999,Poinsett,AR,5111,146,129,0,0,17,1,1,0,0,0,145,128,0,17
1999,Polk,AR,5113,68,60,0,0,8,4,3,0,0,1,64,57,0,7
1999,Pope,AR,5115,319,229,4,0,86,6,2,4,0,0,313,227,0,86
1999,Prairie,AR,5117,72,23,0,1,48,3,0,0,1,2,69,23,0,46
1999,Pulaski,AR,5119,3499,1491,5,0,2003,38,21,5,0,12,3461,1470,0,1991
1999,Randolph,AR,5121,66,61,0,0,5,0,0,0,0,0,66,61,0,5
1999,St. Francis,AR,5123,140,98,0,1,41,2,0,0,1,1,138,98,0,40
1999,Saline,AR,5125,436,250,0,0,186,4,3,0,0,1,432,247,0,185
1999,Scott,AR,5127,44,39,0,0,5,0,0,0,0,0,44,39,0,5
1999,Searcy,AR,5129,29,25,0,0,4,0,0,0,0,0,29,25,0,4
1999,Sebastian,AR,5131,722,569,1,0,152,12,8,1,0,3,710,561,0,149
1999,Sevier,AR,5133,43,33,0,0,10,0,0,0,0,0,43,33,0,10
1999,Sharp,AR,5135,79,68,0,0,11,0,0,0,0,0,79,68,0,11
1999,Stone,AR,5137,33,30,0,0,3,0,0,0,0,0,33,30,0,3
1999,Union,AR,5139,255,183,0,0,72,7,4,0,0,3,248,179,0,69
1999,Van Buren,AR,5141,56,38,1,0,17,0,0,0,0,0,56,38,1,17
1999,Washington,AR,5143,839,652,1,0,186,21,13,1,0,7,818,639,0,179
1999,White,AR,5145,399,186,0,0,213,6,1,0,0,5,393,185,0,208
1999,Woodruff,AR,5147,37,19,3,0,15,2,0,2,0,0,35,19,1,15
1999,Yell,AR,5149,112,81,0,0,31,2,1,0,0,1,110,80,0,30
1999,Alameda,CA,6001,5725,4170,40,0,1515,206,104,36,0,66,5519,4066,4,1449
1999,Alpine,CA,6003,0,0,0,0,0,,,,,,,,,
1999,Amador,CA,6005,166,141,1,0,24,15,13,1,0,1,151,128,0,23
1999,Butte,CA,6007,983,917,0,3,63,40,26,0,3,11,943,891,0,52
1999,Calaveras,CA,6009,189,157,1,0,31,6,4,0,0,2,183,153,1,29
1999,Colusa,CA,6011,73,55,3,0,15,7,0,3,0,4,66,55,0,11
1999,Contra Costa,CA,6013,4271,3014,19,0,1238,113,63,17,0,33,4158,2951,2,1205
1999,Del Norte,CA,6015,85,74,0,0,11,1,1,0,0,0,84,73,0,11
1999,El Dorado,CA,6017,755,665,5,0,85,45,35,5,0,5,710,630,0,80
1999,Fresno,CA,6019,3822,3386,15,6,415,140,108,14,6,12,3682,3278,1,403
1999,Glenn,CA,6021,106,99,0,0,7,3,3,0,0,0,103,96,0,7
1999,Humboldt,CA,6023,546,485,4,0,57,18,7,4,0,6,529,478,0,51
1999,Imperial,CA,6025,518,469,2,0,47,6,4,2,0,0,512,465,0,47
1999,Inyo,CA,6027,62,62,0,0,0,4,3,0,0,0,59,59,0,0
1999,Kern,CA,6029,3915,3504,10,3,398,96,68,8,3,17,3819,3436,2,381
1999,Kings,CA,6031,553,516,2,0,35,13,9,2,0,2,540,507,0,33
1999,Lake,CA,6033,312,260,2,0,50,13,7,2,0,4,299,253,0,46
1999,Lassen,CA,6035,145,140,0,0,5,4,4,0,0,0,141,136,0,5
1999,Los Angeles,CA,6037,62232,48298,292,0,13642,1451,1031,252,0,168,60781,47267,40,13474
1999,Madera,CA,6039,539,476,4,2,57,23,14,4,2,3,516,462,0,54
1999,Marin,CA,6041,652,578,12,0,62,45,28,10,0,7,607,550,2,55
1999,Mariposa,CA,6043,74,72,0,0,2,1,1,0,0,0,73,71,0,2
1999,Mendocino,CA,6045,311,289,2,0,20,7,4,1,0,2,304,285,1,18
1999,Merced,CA,6047,982,891,1,1,89,21,16,1,1,3,961,875,0,86
1999,Modoc,CA,6049,31,27,0,0,4,1,1,0,0,0,30,26,0,4
1999,Mono,CA,6051,22,21,0,0,1,2,2,0,0,0,20,19,0,1
1999,Monterey,CA,6053,2198,907,13,1,1277,142,44,13,1,84,2056,863,0,1193
1999,Napa,CA,6055,316,275,4,0,37,18,9,3,0,6,298,266,1,31
1999,Nevada,CA,6057,414,368,0,0,46,34,26,0,0,8,380,342,0,38
1999,Orange,CA,6059,12670,11170,126,0,1374,503,347,119,0,37,12167,10823,7,1337
1999,Placer,CA,6061,1137,965,4,2,166,76,53,4,2,17,1061,912,0,149
1999,Plumas,CA,6063,78,69,1,0,8,4,2,1,0,1,74,67,0,7
1999,Riverside,CA,6065,9995,8311,35,2,1647,201,147,33,2,19,9794,8164,2,1628
1999,Sacramento,CA,6067,7716,6190,30,0,1496,243,159,30,0,54,7473,6031,0,1442
1999,San Benito,CA,6069,232,140,1,0,91,18,8,1,0,9,214,132,0,82
1999,San Bernardino,CA,6071,11825,9791,18,0,2016,176,139,16,0,21,11649,9652,2,1995
1999,San Diego,CA,6073,14664,11307,60,0,3297,171,112,49,0,10,14493,11195,11,3287
1999,San Francisco,CA,6075,2169,1703,26,0,440,132,55,23,0,54,2037,1648,3,386
1999,San Joaquin,CA,6077,2961,2388,10,0,563,74,42,9,0,23,2887,2346,1,540
1999,San Luis Obispo,CA,6079,954,900,4,0,50,32,28,4,0,0,922,872,0,50
1999,San Mateo,CA,6081,1924,1534,16,0,374,89,41,14,0,34,1835,1493,2,340
1999,Santa Barbara,CA,6083,1497,1311,9,0,177,20,14,6,0,0,1477,1297,3,177
1999,Santa Clara,CA,6085,4971,3519,51,1,1400,322,180,46,1,95,4649,3339,5,1305
1999,Santa Cruz,CA,6087,980,725,10,0,245,98,68,9,0,21,882,657,1,224
1999,Shasta,CA,6089,1233,1120,3,0,110,44,31,2,0,11,1189,1089,1,99
1999,Sierra,CA,6091,8,6,0,0,2,1,1,0,0,0,7,5,0,2
1999,Siskiyou,CA,6093,217,205,1,0,11,8,7,1,0,0,209,198,0,11
1999,Solano,CA,6095,2396,1805,5,0,586,72,41,5,0,26,2324,1764,0,560
1999,Sonoma,CA,6097,1721,1459,17,4,241,94,58,14,4,18,1627,1401,3,223
1999,Stanislaus,CA,6099,2788,2371,11,2,404,76,52,11,2,11,2712,2319,0,393
1999,Sutter,CA,6101,381,332,2,0,47,29,15,2,0,12,352,317,0,35
1999,Tehama,CA,6103,280,260,0,0,20,3,2,0,0,1,277,258,0,19
1999,Trinity,CA,6105,43,41,0,0,2,0,0,0,0,0,43,41,0,2
1999,Tulare,CA,6107,1709,1541,3,4,161,47,30,3,4,10,1662,1511,0,151
1999,Tuolumne,CA,6109,248,224,1,0,23,10,7,1,0,2,238,217,0,21
1999,Ventura,CA,6111,3394,2935,17,0,442,44,28,12,0,4,3350,2907,5,438
1999,Yolo,CA,6113,612,529,3,0,80,24,14,3,0,7,588,515,0,73
1999,Yuba,CA,6115,334,284,2,0,48,14,8,2,0,4,320,276,0,44
1999,Adams,CO,8001,1706,1398,8,0,300,30,20,7,0,3,1676,1378,1,297
1999,Alamosa,CO,8003,44,33,0,0,11,0,0,0,0,0,44,33,0,11
1999,Arapahoe,CO,8005,2240,1828,32,0,380,73,34,32,0,7,2167,1794,0,373
1999,Archuleta,CO,8007,26,25,0,0,1,1,1,0,0,0,25,24,0,1
1999,Baca,CO,8009,7,6,0,0,1,0,0,0,0,0,7,6,0,1
1999,Bent,CO,8011,22,20,0,0,2,1,1,0,0,0,21,19,0,2
1999,Boulder,CO,8013,957,846,6,1,104,27,19,6,1,1,930,827,0,103
1999,Chaffee,CO,8015,32,27,0,0,5,1,1,0,0,0,31,26,0,5
1999,Cheyenne,CO,8017,5,5,0,0,0,0,0,0,0,0,5,5,0,0
1999,Clear Creek,CO,8019,17,14,0,0,3,0,0,0,0,0,17,14,0,3
1999,Conejos,CO,8021,20,15,0,0,5,0,0,0,0,0,20,15,0,5
1999,Costilla,CO,8023,11,8,0,0,3,1,1,0,0,0,10,7,0,3
1999,Crowley,CO,8025,11,8,0,0,3,0,0,0,0,0,11,8,0,3
1999,Custer,CO,8027,11,9,0,0,2,0,0,0,0,0,11,9,0,2
1999,Delta,CO,8029,97,89,0,2,6,4,2,0,2,0,93,87,0,6
1999,Denver,CO,8031,2511,1971,15,0,525,49,32,15,0,2,2462,1939,0,523
1999,Dolores,CO,8033,7,7,0,0,0,0,0,0,0,0,7,7,0,0
1999,Douglas,CO,8035,319,273,1,0,45,9,8,1,0,0,310,265,0,45
1999,Eagle,CO,8037,53,48,0,0,5,2,2,0,0,0,51,46,0,5
1999,Elbert,CO,8039,50,40,0,0,10,1,0,0,0,1,49,40,0,9
1999,El Paso,CO,8041,2253,1980,10,0,263,50,40,10,0,0,2203,1940,0,263
1999,Fremont,CO,8043,189,163,1,0,25,4,2,1,0,1,185,161,0,24
1999,Garfield,CO,8045,144,140,0,0,4,3,3,0,0,0,141,137,0,4
1999,Gilpin,CO,8047,20,15,0,0,5,0,0,0,0,0,20,15,0,5
1999,Grand,CO,8049,38,37,0,0,1,1,1,0,0,0,37,36,0,1
1999,Gunnison,CO,8051,20,19,0,0,1,1,1,0,0,0,19,18,0,1
1999,Hinsdale,CO,8053,1,1,0,0,0,0,0,0,0,0,1,1,0,0
1999,Huerfano,CO,8055,36,28,0,0,8,1,1,0,0,0,35,27,0,8
1999,Jackson,CO,8057,3,3,0,0,0,0,0,0,0,0,3,3,0,0
1999,Jefferson,CO,8059,1557,1291,7,0,259,13,6,7,0,0,1544,1285,0,259
1999,Kiowa,CO,8061,9,9,0,0,0,2,2,0,0,0,7,7,0,0
1999,Kit Carson,CO,8063,14,14,0,0,0,0,0,0,0,0,14,14,0,0
1999,Lake,CO,8065,20,18,0,0,2,0,0,0,0,0,20,18,0,2
1999,La Plata,CO,8067,120,116,1,0,3,6,5,1,0,0,114,111,0,3
1999,Larimer,CO,8069,905,772,1,0,132,16,14,1,0,1,889,758,0,131
1999,Las Animas,CO,8071,43,34,0,0,9,0,0,0,0,0,43,34,0,9
1999,Lincoln,CO,8073,14,12,0,0,2,0,0,0,0,0,14,12,0,2
1999,Logan,CO,8075,60,56,1,0,3,2,1,1,0,0,58,55,0,3
1999,Mesa,CO,8077,455,445,2,0,8,6,4,2,0,0,449,441,0,8
1999,Mineral,CO,8079,0,0,0,0,0,,,,,,,,,
1999,Moffat,CO,8081,42,36,0,1,5,2,0,0,1,1,40,36,0,4
1999,Montezuma,CO,8083,46,44,0,0,2,3,3,0,0,0,43,41,0,2
1999,Montrose,CO,8085,93,87,0,0,6,2,1,0,0,1,91,86,0,5
1999,Morgan,CO,8087,116,97,1,5,13,6,0,1,5,0,110,97,0,13
1999,Otero,CO,8089,67,58,1,0,8,2,1,1,0,0,65,57,0,8
1999,Ouray,CO,8091,4,4,0,0,0,0,0,0,0,0,4,4,0,0
1999,Park,CO,8093,40,28,0,0,12,3,3,0,0,0,37,25,0,12
1999,Phillips,CO,8095,10,10,0,0,0,0,0,0,0,0,10,10,0,0
1999,Pitkin,CO,8097,33,33,0,0,0,4,4,0,0,0,29,29,0,0
1999,Prowers,CO,8099,37,30,0,1,6,3,2,0,1,0,34,28,0,6
1999,Pueblo,CO,8101,707,524,3,1,179,12,6,3,1,2,695,518,0,177
1999,Rio Blanco,CO,8103,31,28,0,0,3,0,0,0,0,0,31,28,0,3
1999,Rio Grande,CO,8105,39,32,0,0,7,1,1,0,0,0,38,31,0,7
1999,Routt,CO,8107,28,24,0,0,4,0,0,0,0,0,28,24,0,4
1999,Saguache,CO,8109,21,15,0,1,5,2,1,0,1,0,19,14,0,5
1999,San Juan,CO,8111,0,0,0,0,0,,,,,,,,,
1999,San Miguel,CO,8113,18,15,1,0,2,4,3,1,0,0,14,12,0,2
1999,Sedgwick,CO,8115,5,5,0,0,0,1,1,0,0,0,4,4,0,0
1999,Summit,CO,8117,40,33,1,0,6,2,1,1,0,0,38,32,0,6
1999,Teller,CO,8119,88,76,0,0,12,0,0,0,0,0,88,76,0,12
1999,Washington,CO,8121,7,7,0,0,0,0,0,0,0,0,7,7,0,0
1999,Weld,CO,8123,689,639,1,2,47,10,7,1,2,0,679,632,0,47
1999,Yuma,CO,8125,20,19,1,0,0,1,0,1,0,0,19,19,0,0
1999,Fairfield,CT,9001,2174,1824,57,0,293,68,22,46,0,0,2106,1802,11,293
1999,Hartford,CT,9003,3235,2835,12,0,388,30,18,12,0,0,3205,2817,0,388
1999,Litchfield,CT,9005,611,550,0,1,60,2,1,0,1,0,609,549,0,60
1999,Middlesex,CT,9007,495,437,2,1,55,3,0,2,1,0,492,437,0,55
1999,New Haven,CT,9009,3744,3190,28,0,526,37,16,21,0,0,3707,3174,7,526
1999,New London,CT,9011,952,873,1,0,78,6,5,1,0,0,946,868,0,78
1999,Tolland,CT,9013,240,218,0,0,22,2,2,0,0,0,238,216,0,22
1999,Windham,CT,9015,415,363,2,0,50,5,3,2,0,0,410,360,0,50
1999,Kent,DE,10001,544,372,8,0,164,8,0,8,0,0,536,372,0,164
1999,New Castle,DE,10003,1420,924,30,0,466,45,12,29,0,4,1375,912,1,462
1999,Sussex,DE,10005,450,333,2,0,115,2,1,1,0,0,448,332,1,115
1999,District of Columbia,DC,11001,2639,1753,44,0,842,80,31,41,0,8,2559,1722,3,834
1999,Alachua,FL,12001,509,394,2,0,113,12,7,2,0,3,497,387,0,110
1999,Baker,FL,12003,69,49,0,0,20,1,1,0,0,0,68,48,0,20
1999,Bay,FL,12005,511,442,5,0,64,14,8,5,0,1,497,434,0,63
1999,Bradford,FL,12007,60,45,0,0,15,1,0,0,0,1,59,45,0,14
1999,Brevard,FL,12009,2166,1885,6,0,275,28,21,6,0,1,2138,1864,0,274
1999,Broward,FL,12011,8987,6483,252,1,2251,391,145,244,1,1,8596,6338,8,2250
1999,Calhoun,FL,12013,34,30,0,0,4,0,0,0,0,0,34,30,0,4
1999,Charlotte,FL,12015,577,385,6,0,186,17,8,6,0,3,560,377,0,183
1999,Citrus,FL,12017,568,491,1,0,76,6,4,1,0,1,562,487,0,75
1999,Clay,FL,12019,608,415,0,0,193,6,5,0,0,1,602,410,0,192
1999,Collier,FL,12021,700,478,15,0,207,35,16,14,0,5,665,462,1,202
1999,Columbia,FL,12023,216,145,1,1,69,5,3,1,1,0,211,142,0,69
1999,Dade,FL,12025,12977,8769,88,1,4119,288,200,83,1,3,12690,8569,5,4116
1999,DeSoto,FL,12027,80,60,1,0,19,1,1,0,0,0,79,59,1,19
1999,Dixie,FL,12029,38,33,0,0,5,0,0,0,0,0,38,33,0,5
1999,Duval,FL,12031,3983,2159,17,0,1807,48,26,15,0,7,3935,2133,2,1800
1999,Escambia,FL,12033,1190,912,3,0,275,4,2,2,0,0,1186,910,1,275
1999,Flagler,FL,12035,190,164,1,0,25,1,0,1,0,0,189,164,0,25
1999,Franklin,FL,12037,23,21,2,0,0,2,0,2,0,0,21,21,0,0
1999,Gadsden,FL,12039,132,73,0,0,59,0,0,0,0,0,132,73,0,59
1999,Gilchrist,FL,12041,44,41,0,0,3,0,0,0,0,0,44,41,0,3
1999,Glades,FL,12043,0,0,0,0,0,,,,,,,,,
1999,Gulf,FL,12045,33,29,0,0,4,0,0,0,0,0,33,29,0,4
1999,Hamilton,FL,12047,38,11,0,0,27,0,0,0,0,0,38,11,0,27
1999,Hardee,FL,12049,65,54,1,0,10,1,0,1,0,0,64,54,0,10
1999,Hendry,FL,12051,80,61,0,0,19,4,3,0,0,1,76,58,0,18
1999,Hernando,FL,12053,631,496,3,0,132,21,12,3,0,6,610,484,0,126
1999,Highlands,FL,12055,346,269,4,0,73,8,3,4,0,1,338,266,0,72
1999,Hillsborough,FL,12057,5135,3519,45,3,1568,180,111,42,3,24,4955,3408,3,1544
1999,Holmes,FL,12059,50,46,0,1,3,2,0,0,1,1,48,46,0,2
1999,Indian River,FL,12061,379,337,7,1,34,14,6,7,1,0,365,331,0,34
1999,Jackson,FL,12063,147,121,0,2,24,9,7,0,2,0,138,114,0,24
1999,Jefferson,FL,12065,35,30,0,0,5,0,0,0,0,0,35,30,0,5
1999,Lafayette,FL,12067,9,5,0,1,3,1,0,0,1,0,8,5,0,3
1999,Lake,FL,12069,807,660,2,0,145,11,9,2,0,0,796,651,0,145
1999,Lee,FL,12071,1740,1299,11,0,430,41,25,11,0,5,1699,1274,0,425
1999,Leon,FL,12073,609,434,22,0,153,26,4,20,0,2,583,430,2,151
1999,Levy,FL,12075,105,85,1,0,19,2,1,1,0,0,103,84,0,19
1999,Liberty,FL,12077,16,13,0,0,3,0,0,0,0,0,16,13,0,3
1999,Madison,FL,12079,32,26,0,0,6,0,0,0,0,0,32,26,0,6
1999,Manatee,FL,12081,1127,835,4,0,288,31,21,4,0,6,1096,814,0,282
1999,Marion,FL,12083,1161,988,5,2,166,19,7,5,2,5,1142,981,0,161
1999,Martin,FL,12085,379,332,5,0,42,11,7,4,0,0,368,325,1,42
1999,Monroe,FL,12087,213,190,3,0,20,5,1,3,0,1,208,189,0,19
1999,Nassau,FL,12089,208,114,1,0,93,4,3,1,0,0,204,111,0,93
1999,Okaloosa,FL,12091,758,687,3,0,68,7,4,3,0,0,751,683,0,68
1999,Okeechobee,FL,12093,129,96,1,0,32,1,0,1,0,0,128,96,0,32
1999,Orange,FL,12095,4791,3590,69,1,1131,119,48,69,1,1,4672,3542,0,1130
1999,Osceola,FL,12097,981,812,2,0,167,10,7,2,0,1,971,805,0,166
1999,Palm Beach,FL,12099,4414,3610,49,0,755,97,57,40,0,0,4317,3553,9,755
1999,Pasco,FL,12101,1848,1422,7,1,418,62,42,6,1,13,1786,1380,1,405
1999,Pinellas,FL,12103,4838,3289,51,0,1498,182,118,43,0,21,4656,3171,8,1477
1999,Polk,FL,12105,2439,1880,23,0,536,74,38,19,0,17,2365,1842,4,519
1999,Putnam,FL,12107,222,177,3,2,40,7,3,2,2,0,215,174,1,40
1999,St. Johns,FL,12109,393,301,1,0,91,2,1,1,0,0,391,300,0,91
1999,St. Lucie,FL,12111,1014,789,1,0,224,12,11,1,0,0,1002,778,0,224
1999,Santa Rosa,FL,12113,490,398,2,0,90,2,0,2,0,0,488,398,0,90
1999,Sarasota,FL,12115,1358,1006,16,0,336,57,42,14,0,1,1301,964,2,335
1999,Seminole,FL,12117,1654,1310,6,0,338,24,18,6,0,0,1630,1292,0,338
1999,Sumter,FL,12119,146,127,1,0,18,4,3,1,0,0,142,124,0,18
1999,Suwannee,FL,12121,149,101,2,1,45,3,0,2,1,0,146,101,0,45
1999,Taylor,FL,12123,55,40,0,1,14,2,1,0,1,0,53,39,0,14
1999,Union,FL,12125,27,20,0,0,7,0,0,0,0,0,27,20,0,7
1999,Volusia,FL,12127,2319,1862,10,0,447,27,15,10,0,2,2292,1847,0,445
1999,Wakulla,FL,12129,71,54,2,0,15,1,0,1,0,0,70,54,1,15
1999,Walton,FL,12131,106,98,0,0,8,0,0,0,0,0,106,98,0,8
1999,Washington,FL,12133,73,62,0,0,11,0,0,0,0,0,73,62,0,11
1999,Appling,GA,13001,190,30,0,0,160,1,0,0,0,1,189,30,0,159
1999,Atkinson,GA,13003,85,5,0,1,79,2,0,0,1,1,83,5,0,78
1999,Bacon,GA,13005,88,15,0,0,73,1,1,0,0,0,87,14,0,73
1999,Baker,GA,13007,15,6,0,0,9,0,0,0,0,0,15,6,0,9
1999,Baldwin,GA,13009,377,100,0,0,277,4,2,0,0,2,373,98,0,275
1999,Banks,GA,13011,72,28,0,0,44,1,1,0,0,0,71,27,0,44
1999,Barrow,GA,13013,296,150,0,0,146,2,2,0,0,0,294,148,0,146
1999,Bartow,GA,13015,725,260,4,0,461,12,5,4,0,3,713,255,0,458
1999,Ben Hill,GA,13017,144,72,0,0,72,3,2,0,0,1,141,70,0,71
1999,Berrien,GA,13019,160,66,0,0,94,2,1,0,0,1,158,65,0,93
1999,Bibb,GA,13021,1772,638,4,0,1130,21,14,4,0,3,1751,624,0,1127
1999,Bleckley,GA,13023,119,36,0,0,83,0,0,0,0,0,119,36,0,83
1999,Brantley,GA,13025,128,32,0,0,96,3,2,0,0,1,125,30,0,95
1999,Brooks,GA,13027,105,28,0,0,77,3,1,0,0,2,102,27,0,75
1999,Bryan,GA,13029,210,40,1,0,169,4,2,1,0,1,206,38,0,168
1999,Bulloch,GA,13031,287,59,1,0,227,2,1,1,0,0,285,58,0,227
1999,Burke,GA,13033,162,40,0,0,122,0,0,0,0,0,162,40,0,122
1999,Butts,GA,13035,54,29,0,0,25,1,0,0,0,1,53,29,0,24
1999,Calhoun,GA,13037,17,6,0,0,11,0,0,0,0,0,17,6,0,11
1999,Camden,GA,13039,235,94,1,0,140,6,3,1,0,2,229,91,0,138
1999,Candler,GA,13043,69,13,2,0,54,2,0,2,0,0,67,13,0,54
1999,Carroll,GA,13045,685,248,5,0,432,69,16,4,0,49,616,232,1,383
1999,Catoosa,GA,13047,325,133,0,1,191,3,2,0,1,0,322,131,0,191
1999,Charlton,GA,13049,60,15,0,0,45,3,1,0,0,2,57,14,0,43
1999,Chatham,GA,13051,2304,340,11,0,1953,37,13,9,0,15,2267,327,2,1938
1999,Chattahoochee,GA,13053,30,12,0,0,18,0,0,0,0,0,30,12,0,18
1999,Chattooga,GA,13055,196,53,0,0,143,3,2,0,0,1,193,51,0,142
1999,Cherokee,GA,13057,575,353,2,0,220,14,8,2,0,4,561,345,0,216
1999,Clarke,GA,13059,394,160,1,0,233,4,1,1,0,2,390,159,0,231
1999,Clay,GA,13061,11,6,0,0,5,0,0,0,0,0,11,6,0,5
1999,Clayton,GA,13063,2375,852,8,0,1515,17,5,7,0,5,2358,847,1,1510
1999,Clinch,GA,13065,84,16,1,0,67,2,0,1,0,1,82,16,0,66
1999,Cobb,GA,13067,3157,1708,18,0,1431,57,30,17,0,10,3100,1678,1,1421
1999,Coffee,GA,13069,526,50,0,1,475,3,1,0,1,1,523,49,0,474
1999,Colquitt,GA,13071,77,43,1,1,32,2,0,1,1,0,75,43,0,32
1999,Columbia,GA,13073,532,296,2,0,234,8,6,2,0,0,524,290,0,234
1999,Cook,GA,13075,140,50,0,0,90,0,0,0,0,0,140,50,0,90
1999,Coweta,GA,13077,824,330,1,1,492,42,16,1,1,24,782,314,0,468
1999,Crawford,GA,13079,64,21,1,0,42,2,1,1,0,0,62,20,0,42
1999,Crisp,GA,13081,126,56,2,0,68,2,0,2,0,0,124,56,0,68
1999,Dade,GA,13083,92,30,0,0,62,1,0,0,0,1,91,30,0,61
1999,Dawson,GA,13085,61,31,0,0,30,1,1,0,0,0,60,30,0,30
1999,De Kalb,GA,13087,186,76,1,0,109,3,0,1,0,2,183,76,0,107
1999,Decatur,GA,13089,5305,1782,22,0,3501,58,20,21,0,17,5247,1762,1,3484
1999,Dodge,GA,13091,102,31,1,0,70,1,0,1,0,0,101,31,0,70
1999,Dooly,GA,13093,66,24,1,2,39,3,0,1,2,0,63,24,0,39
1999,Dougherty,GA,13095,693,347,1,0,345,4,2,1,0,1,689,345,0,344
1999,Douglas,GA,13097,697,375,1,0,321,8,5,1,0,2,689,370,0,319
1999,Early,GA,13099,64,26,0,3,35,4,1,0,3,0,60,25,0,35
1999,Echols,GA,13101,9,4,0,0,5,0,0,0,0,0,9,4,0,5
1999,Effingham,GA,13103,295,80,1,0,214,4,3,1,0,0,291,77,0,214
1999,Elbert,GA,13105,139,39,0,0,100,0,0,0,0,0,139,39,0,100
1999,Emanuel,GA,13107,217,44,0,0,173,0,0,0,0,0,217,44,0,173
1999,Evans,GA,13109,55,10,0,0,45,0,0,0,0,0,55,10,0,45
1999,Fannin,GA,13111,50,32,1,0,17,2,1,1,0,0,48,31,0,17
1999,Fayette,GA,13113,334,190,1,0,143,32,21,1,0,10,302,169,0,133
1999,Floyd,GA,13115,777,295,0,0,482,3,3,0,0,0,774,292,0,482
1999,Forsyth,GA,13117,265,157,1,0,107,6,2,1,0,3,259,155,0,104
1999,Franklin,GA,13119,97,35,0,1,61,2,1,0,1,0,95,34,0,61
1999,Fulton,GA,13121,4779,1770,72,0,2937,126,42,69,0,15,4653,1728,3,2922
1999,Gilmer,GA,13123,114,71,0,0,43,6,6,0,0,0,108,65,0,43
1999,Glascock,GA,13125,27,3,0,0,24,0,0,0,0,0,27,3,0,24
1999,Glynn,GA,13127,570,134,3,0,433,17,7,3,0,7,553,127,0,426
1999,Gordon,GA,13129,446,134,1,0,311,7,4,1,0,2,439,130,0,309
1999,Grady,GA,13131,135,68,0,0,67,0,0,0,0,0,135,68,0,67
1999,Greene,GA,13133,111,27,1,0,83,2,0,1,0,1,109,27,0,82
1999,Gwinnett,GA,13135,2729,1447,16,0,1266,53,28,15,0,10,2676,1419,1,1256
1999,Habersham,GA,13137,183,81,3,0,99,1,0,1,0,0,182,81,2,99
1999,Hall,GA,13139,808,296,2,0,510,10,6,1,0,3,798,290,1,507
1999,Hancock,GA,13141,70,11,0,0,59,1,0,0,0,1,69,11,0,58
1999,Haralson,GA,13143,148,49,0,0,99,15,4,0,0,11,133,45,0,88
1999,Harris,GA,13145,179,79,0,0,100,0,0,0,0,0,179,79,0,100
1999,Hart,GA,13147,73,35,0,2,36,2,0,0,2,0,71,35,0,36
1999,Heard,GA,13149,84,25,0,0,59,11,4,0,0,7,73,21,0,52
1999,Henry,GA,13151,822,428,4,0,390,7,3,3,0,1,815,425,1,389
1999,Houston,GA,13153,815,430,3,0,382,12,7,3,0,2,803,423,0,380
1999,Irwin,GA,13155,78,27,0,0,51,0,0,0,0,0,78,27,0,51
1999,Jackson,GA,13157,246,99,0,0,147,3,3,0,0,0,243,96,0,147
1999,Jasper,GA,13159,67,26,0,0,41,2,1,0,0,1,65,25,0,40
1999,Jeff Davis,GA,13161,174,37,1,0,136,3,0,1,0,2,171,37,0,134
1999,Jefferson,GA,13163,160,30,0,0,130,0,0,0,0,0,160,30,0,130
1999,Jenkins,GA,13165,78,18,0,0,60,0,0,0,0,0,78,18,0,60
1999,Johnson,GA,13167,79,11,0,0,68,1,1,0,0,0,78,10,0,68
1999,Jones,GA,13169,112,43,0,0,69,1,1,0,0,0,111,42,0,69
1999,Lamar,GA,13171,38,17,1,0,20,1,0,1,0,0,37,17,0,20
1999,Lanier,GA,13173,41,15,1,0,25,1,0,1,0,0,40,15,0,25
1999,Laurens,GA,13175,404,88,0,0,316,0,0,0,0,0,404,88,0,316
1999,Lee,GA,13177,167,95,0,0,72,1,1,0,0,0,166,94,0,72
1999,Liberty,GA,13179,757,106,0,0,651,6,4,0,0,2,751,102,0,649
1999,Lincoln,GA,13181,51,23,0,0,28,1,1,0,0,0,50,22,0,28
1999,Long,GA,13183,83,11,0,0,72,0,0,0,0,0,83,11,0,72
1999,Lowndes,GA,13185,692,283,1,0,408,5,3,1,0,1,687,280,0,407
1999,Lumpkin,GA,13187,103,49,0,0,54,1,1,0,0,0,102,48,0,54
1999,McDuffie,GA,13189,230,51,2,0,177,3,1,2,0,0,227,50,0,177
1999,McIntosh,GA,13191,102,14,0,0,88,0,0,0,0,0,102,14,0,88
1999,Macon,GA,13193,102,25,0,0,77,1,0,0,0,1,101,25,0,76
1999,Madison,GA,13195,137,63,2,0,72,1,0,1,0,0,136,63,1,72
1999,Marion,GA,13197,13,6,0,0,7,0,0,0,0,0,13,6,0,7
1999,Meriwether,GA,13199,164,39,0,0,125,15,5,0,0,10,149,34,0,115
1999,Miller,GA,13201,43,20,0,0,23,0,0,0,0,0,43,20,0,23
1999,Mitchell,GA,13205,174,48,1,4,121,5,0,1,4,0,169,48,0,121
1999,Monroe,GA,13207,138,51,0,0,87,1,1,0,0,0,137,50,0,87
1999,Montgomery,GA,13209,45,17,0,0,28,1,1,0,0,0,44,16,0,28
1999,Morgan,GA,13211,119,37,0,0,82,2,1,0,0,1,117,36,0,81
1999,Murray,GA,13213,376,141,0,0,235,1,1,0,0,0,375,140,0,235
1999,Muscogee,GA,13215,1972,791,6,0,1175,12,5,6,0,1,1960,786,0,1174
1999,Newton,GA,13217,483,195,0,0,288,1,1,0,0,0,482,194,0,288
1999,Oconee,GA,13219,50,29,0,0,21,0,0,0,0,0,50,29,0,21
1999,Oglethorpe,GA,13221,68,27,0,0,41,0,0,0,0,0,68,27,0,41
1999,Paulding,GA,13223,529,269,0,0,260,6,5,0,0,1,523,264,0,259
1999,Peach,GA,13225,305,130,2,0,173,3,2,1,0,0,302,128,1,173
1999,Pickens,GA,13227,112,52,1,0,59,3,2,0,0,1,109,50,1,58
1999,Pierce,GA,13229,130,18,1,0,111,4,0,1,0,3,126,18,0,108
1999,Pike,GA,13231,108,33,0,0,75,13,5,0,0,8,95,28,0,67
1999,Polk,GA,13233,352,93,0,0,259,3,2,0,0,1,349,91,0,258
1999,Pulaski,GA,13235,86,26,0,0,60,0,0,0,0,0,86,26,0,60
1999,Putnam,GA,13237,118,49,0,0,69,1,1,0,0,0,117,48,0,69
1999,Quitman,GA,13239,11,5,0,0,6,0,0,0,0,0,11,5,0,6
1999,Rabun,GA,13241,48,33,1,0,14,2,1,1,0,0,46,32,0,14
1999,Randolph,GA,13243,57,26,0,0,31,0,0,0,0,0,57,26,0,31
1999,Richmond,GA,13245,1862,697,1,0,1164,5,4,1,0,0,1857,693,0,1164
1999,Rockdale,GA,13247,442,200,1,0,241,7,3,1,0,3,435,197,0,238
1999,Schley,GA,13249,26,13,0,0,13,0,0,0,0,0,26,13,0,13
1999,Screven,GA,13251,118,24,0,0,94,1,1,0,0,0,117,23,0,94
1999,Seminole,GA,13253,60,29,0,0,31,0,0,0,0,0,60,29,0,31
1999,Spalding,GA,13255,596,205,1,0,390,33,7,0,0,26,563,198,1,364
1999,Stephens,GA,13257,146,64,0,0,82,1,1,0,0,0,145,63,0,82
1999,Stewart,GA,13259,34,11,0,0,23,2,2,0,0,0,32,9,0,23
1999,Sumter,GA,13261,221,86,1,6,128,8,0,1,6,1,213,86,0,127
1999,Talbot,GA,13263,57,22,0,0,35,0,0,0,0,0,57,22,0,35
1999,Taliaferro,GA,13265,23,4,0,0,19,0,0,0,0,0,23,4,0,19
1999,Tattnall,GA,13267,123,40,1,1,81,2,0,1,1,0,121,40,0,81
1999,Taylor,GA,13269,62,25,0,0,37,1,1,0,0,0,61,24,0,37
1999,Telfair,GA,13271,101,16,2,0,83,1,0,1,0,0,100,16,1,83
1999,Terrell,GA,13273,117,32,1,1,83,4,1,1,1,1,113,31,0,82
1999,Thomas,GA,13275,279,113,0,0,166,2,2,0,0,0,277,111,0,166
1999,Tift,GA,13277,296,123,1,0,172,2,1,0,0,1,294,122,1,171
1999,Toombs,GA,13279,190,57,0,0,133,2,2,0,0,0,188,55,0,133
1999,Towns,GA,13281,22,12,1,0,9,1,0,1,0,0,21,12,0,9
1999,Treutlen,GA,13283,41,6,0,0,35,0,0,0,0,0,41,6,0,35
1999,Troup,GA,13285,672,187,0,0,485,21,12,0,0,9,651,175,0,476
1999,Turner,GA,13287,104,35,1,5,63,6,0,1,5,0,98,35,0,63
1999,Twiggs,GA,13289,87,25,0,0,62,0,0,0,0,0,87,25,0,62
1999,Union,GA,13291,62,42,0,0,20,1,1,0,0,0,61,41,0,20
1999,Upson,GA,13293,134,35,0,0,99,2,0,0,0,2,132,35,0,97
1999,Walker,GA,13295,662,218,1,0,443,6,3,1,0,2,656,215,0,441
1999,Walton,GA,13297,371,163,0,1,207,7,4,0,1,2,364,159,0,205
1999,Ware,GA,13299,330,53,0,0,277,4,1,0,0,3,326,52,0,274
1999,Warren,GA,13301,67,7,0,0,60,0,0,0,0,0,67,7,0,60
1999,Washington,GA,13303,145,39,1,0,105,1,0,1,0,0,144,39,0,105
1999,Wayne,GA,13305,242,33,1,0,208,5,1,1,0,3,237,32,0,205
1999,Webster,GA,13307,15,9,0,0,6,0,0,0,0,0,15,9,0,6
1999,Wheeler,GA,13309,25,9,0,0,16,0,0,0,0,0,25,9,0,16
1999,White,GA,13311,99,47,2,0,50,0,0,0,0,0,99,47,2,50
1999,Whitfield,GA,13313,778,308,2,0,468,10,7,2,0,1,768,301,0,467
1999,Wilcox,GA,13315,53,29,1,1,22,2,0,1,1,0,51,29,0,22
1999,Wilkes,GA,13317,73,20,0,0,53,0,0,0,0,0,73,20,0,53
1999,Wilkinson,GA,13319,124,27,0,0,97,3,0,0,0,3,121,27,0,94
1999,Worth,GA,13321,161,65,0,0,96,2,2,0,0,0,159,63,0,96
1999,Hawaii,HI,15001,430,402,3,0,25,16,13,3,0,0,414,389,0,25
1999,Honolulu,HI,15003,4087,3659,23,0,405,58,31,23,0,3,4030,3628,0,402
1999,Kalawao,HI,15005,0,0,0,0,0,,,,,,,,,
1999,Kauai,HI,15007,231,216,2,0,13,7,4,2,0,1,224,212,0,12
1999,Maui,HI,15009,677,613,8,0,56,14,7,7,0,0,663,606,1,56
1999,Ada,ID,16001,1880,1289,11,0,580,83,47,10,0,26,1797,1242,1,554
1999,Adams,ID,16003,14,9,0,0,5,0,0,0,0,0,14,9,0,5
1999,Bannock,ID,16005,426,377,2,1,46,10,7,2,1,0,416,370,0,46
1999,Bear Lake,ID,16007,16,13,0,0,3,1,0,0,0,1,15,13,0,2
1999,Benewah,ID,16009,52,45,0,0,7,0,0,0,0,0,52,45,0,7
1999,Bingham,ID,16011,171,151,3,1,16,10,5,2,1,2,161,146,1,14
1999,Blaine,ID,16013,52,43,1,0,8,3,1,1,0,1,49,42,0,7
1999,Boise,ID,16015,21,16,0,0,5,1,0,0,0,1,20,16,0,4
1999,Bonner,ID,16017,144,135,0,0,9,11,11,0,0,0,133,124,0,9
1999,Bonneville,ID,16019,403,319,2,0,82,17,7,2,0,8,386,312,0,74
1999,Boundary,ID,16021,38,37,0,0,1,0,0,0,0,0,38,37,0,1
1999,Butte,ID,16023,12,9,0,2,1,2,0,0,2,0,10,9,0,1
1999,Camas,ID,16025,4,4,0,0,0,0,0,0,0,0,4,4,0,0
1999,Canyon,ID,16027,912,667,1,2,242,36,23,1,2,10,876,644,0,232
1999,Caribou,ID,16029,27,22,0,1,4,3,1,0,1,1,24,21,0,3
1999,Cassia,ID,16031,108,95,4,1,8,8,3,4,1,0,100,92,0,8
1999,Clark,ID,16033,3,2,0,0,1,0,0,0,0,0,3,2,0,1
1999,Clearwater,ID,16035,51,40,0,0,11,2,1,0,0,1,49,39,0,10
1999,Custer,ID,16037,13,12,0,0,1,2,2,0,0,0,11,10,0,1
1999,Elmore,ID,16039,158,125,0,0,33,5,2,0,0,3,153,123,0,30
1999,Franklin,ID,16041,32,27,0,1,4,2,1,0,1,0,30,26,0,4
1999,Fremont,ID,16043,56,47,1,1,7,4,2,1,1,0,52,45,0,7
1999,Gem,ID,16045,94,65,1,0,28,9,6,1,0,2,85,59,0,26
1999,Gooding,ID,16047,74,66,1,3,4,7,2,1,3,1,67,64,0,3
1999,Idaho,ID,16049,49,38,0,0,11,2,1,0,0,1,47,37,0,10
1999,Jefferson,ID,16051,90,65,1,0,24,4,2,0,0,2,86,63,1,22
1999,Jerome,ID,16053,101,84,2,1,14,7,4,2,1,0,94,80,0,14
1999,Kootenai,ID,16055,787,701,5,0,81,29,19,4,0,6,758,682,1,75
1999,Latah,ID,16057,87,72,1,0,14,10,3,1,0,6,77,69,0,8
1999,Lemhi,ID,16059,16,12,0,0,4,2,1,0,0,1,14,11,0,3
1999,Lewis,ID,16061,27,19,1,0,7,4,2,1,0,1,23,17,0,6
1999,Lincoln,ID,16063,16,13,2,1,0,4,1,2,1,0,12,12,0,0
1999,Madison,ID,16065,60,50,1,0,9,2,0,1,0,1,58,50,0,8
1999,Minidoka,ID,16067,110,98,0,4,8,8,3,0,4,1,102,95,0,7
1999,Nez Perce,ID,16069,222,179,2,0,41,12,9,2,0,1,210,170,0,40
1999,Oneida,ID,16071,19,18,0,0,1,1,1,0,0,0,18,17,0,1
1999,Owyhee,ID,16073,59,48,0,0,11,4,3,0,0,1,55,45,0,10
1999,Payette,ID,16075,142,110,0,1,31,5,3,0,1,1,137,107,0,30
1999,Power,ID,16077,44,38,1,0,5,1,0,1,0,0,43,38,0,5
1999,Shoshone,ID,16079,96,88,0,0,8,2,1,0,0,1,94,87,0,7
1999,Teton,ID,16081,12,11,0,0,1,1,1,0,0,0,11,10,0,1
1999,Twin Falls,ID,16083,296,265,3,3,25,16,9,3,3,1,280,256,0,24
1999,Valley,ID,16085,37,31,0,0,6,3,2,0,0,1,34,29,0,5
1999,Washington,ID,16087,44,38,0,1,5,3,1,0,1,1,41,37,0,4
1999,Adams,IL,17001,304,280,1,4,19,12,7,1,4,0,292,273,0,19
1999,Alexander,IL,17003,44,36,0,1,7,4,2,0,1,1,40,34,0,6
1999,Bond,IL,17005,46,37,0,1,8,5,3,0,1,1,41,34,0,7
1999,Boone,IL,17007,197,158,0,0,39,0,0,0,0,0,197,158,0,39
1999,Brown,IL,17009,19,17,0,0,2,0,0,0,0,0,19,17,0,2
1999,Bureau,IL,17011,138,124,0,2,12,4,2,0,2,0,134,122,0,12
1999,Calhoun,IL,17013,8,5,0,0,3,1,1,0,0,0,7,4,0,3
1999,Carroll,IL,17015,72,60,2,1,9,3,0,2,1,0,69,60,0,9
1999,Cass,IL,17017,65,60,0,1,4,1,0,0,1,0,64,60,0,4
1999,Champaign,IL,17019,912,831,4,0,77,10,5,4,0,1,902,826,0,76
1999,Christian,IL,17021,183,172,1,3,7,4,0,1,3,0,179,172,0,7
1999,Clark,IL,17023,119,108,1,1,9,10,9,0,1,0,109,99,1,9
1999,Clay,IL,17025,81,72,0,0,9,12,9,0,0,3,69,63,0,6
1999,Clinton,IL,17027,101,65,0,1,35,10,8,0,1,1,91,57,0,34
1999,Coles,IL,17029,304,276,0,0,28,4,4,0,0,0,300,272,0,28
1999,Cook,IL,17031,30441,19053,196,0,11192,394,199,185,0,10,30047,18854,11,11182
1999,Crawford,IL,17033,106,97,0,0,9,15,15,0,0,0,91,82,0,9
1999,Cumberland,IL,17035,101,88,1,0,12,6,5,1,0,0,95,83,0,12
1999,DeKalb,IL,17037,307,239,5,0,63,8,5,3,0,0,299,234,2,63
1999,De Witt,IL,17039,112,108,0,0,4,2,2,0,0,0,110,106,0,4
1999,Douglas,IL,17041,91,81,0,0,10,2,2,0,0,0,89,79,0,10
1999,Du Page,IL,17043,2820,2236,30,0,554,83,54,28,0,1,2737,2182,2,553
1999,Edgar,IL,17045,119,105,1,1,12,3,0,1,1,1,116,105,0,11
1999,Edwards,IL,17047,27,25,0,0,2,0,0,0,0,0,27,25,0,2
1999,Effingham,IL,17049,163,143,0,1,19,20,17,0,1,2,143,126,0,17
1999,Fayette,IL,17051,119,106,1,0,12,9,6,1,0,2,110,100,0,10
1999,Ford,IL,17053,67,63,0,0,4,2,2,0,0,0,65,61,0,4
1999,Franklin,IL,17055,290,221,1,0,68,28,22,1,0,5,262,199,0,63
1999,Fulton,IL,17057,248,177,1,1,69,3,1,1,1,0,245,176,0,69
1999,Gallatin,IL,17059,31,28,0,0,3,7,6,0,0,1,24,22,0,2
1999,Greene,IL,17061,71,69,0,0,2,0,0,0,0,0,71,69,0,2
1999,Grundy,IL,17063,228,216,0,0,12,6,6,0,0,0,222,210,0,12
1999,Hamilton,IL,17065,32,30,0,0,2,3,3,0,0,0,29,27,0,2
1999,Hancock,IL,17067,80,62,0,2,16,3,0,0,2,1,77,62,0,15
1999,Hardin,IL,17069,24,20,0,0,4,2,1,0,0,1,22,19,0,3
1999,Henderson,IL,17071,38,29,0,0,9,1,1,0,0,0,37,28,0,9
1999,Henry,IL,17073,245,192,2,1,50,3,0,2,1,0,242,192,0,50
1999,Iroquois,IL,17075,136,126,0,0,10,1,1,0,0,0,135,125,0,10
1999,Jackson,IL,17077,301,255,2,0,44,35,27,2,0,6,266,228,0,38
1999,Jasper,IL,17079,55,49,0,1,5,4,3,0,1,0,51,46,0,5
1999,Jefferson,IL,17081,184,135,0,0,49,29,20,0,0,9,155,115,0,40
1999,Jersey,IL,17083,114,88,0,1,25,10,8,0,1,1,104,80,0,24
1999,Jo Daviess,IL,17085,51,44,2,0,5,3,1,2,0,0,48,43,0,5
1999,Johnson,IL,17087,79,63,0,0,16,7,6,0,0,1,72,57,0,15
1999,Kane,IL,17089,1674,1378,5,2,289,29,22,5,2,0,1645,1356,0,289
1999,Kankakee,IL,17091,659,568,0,3,88,4,1,0,3,0,655,567,0,88
1999,Kendall,IL,17093,208,193,1,0,14,4,3,1,0,0,204,190,0,14
1999,Knox,IL,17095,297,215,0,1,81,3,1,0,1,1,294,214,0,80
1999,Lake,IL,17097,2227,1717,32,0,478,49,19,30,0,0,2178,1698,2,478
1999,La Salle,IL,17099,698,669,0,1,28,6,4,0,1,1,692,665,0,27
1999,Lawrence,IL,17101,61,52,0,0,9,5,5,0,0,0,56,47,0,9
1999,Lee,IL,17103,173,149,1,1,22,5,3,1,1,0,168,146,0,22
1999,Livingston,IL,17105,166,146,0,0,20,0,0,0,0,0,166,146,0,20
1999,Logan,IL,17107,178,173,0,0,5,0,0,0,0,0,178,173,0,5
1999,McDonough,IL,17109,111,80,0,1,30,3,2,0,1,0,108,78,0,30
1999,McHenry,IL,17111,909,733,9,0,167,24,15,9,0,0,885,718,0,167
1999,McLean,IL,17113,665,612,0,3,50,10,5,0,3,2,655,607,0,48
1999,Macon,IL,17115,877,832,0,1,44,6,5,0,1,0,871,827,0,44
1999,Macoupin,IL,17117,218,200,1,5,12,8,2,1,5,0,210,198,0,12
1999,Madison,IL,17119,1599,1106,1,4,488,107,75,1,4,27,1492,1031,0,461
1999,Marion,IL,17121,258,201,2,1,54,36,26,2,1,7,222,175,0,47
1999,Marshall,IL,17123,59,43,0,1,15,1,0,0,1,0,58,43,0,15
1999,Mason,IL,17125,89,77,0,0,12,0,0,0,0,0,89,77,0,12
1999,Massac,IL,17127,74,70,0,0,4,7,7,0,0,0,67,63,0,4
1999,Menard,IL,17129,52,50,0,0,2,2,2,0,0,0,50,48,0,2
1999,Mercer,IL,17131,62,46,0,2,14,3,0,0,2,1,59,46,0,13
1999,Monroe,IL,17133,72,53,0,0,19,5,4,0,0,1,67,49,0,18
1999,Montgomery,IL,17135,156,149,0,2,5,3,1,0,2,0,153,148,0,5
1999,Morgan,IL,17137,156,142,1,2,11,4,0,1,2,1,152,142,0,10
1999,Moultrie,IL,17139,70,67,0,0,3,0,0,0,0,0,70,67,0,3
1999,Ogle,IL,17141,215,183,0,0,32,2,1,0,0,1,213,182,0,31
1999,Peoria,IL,17143,1147,789,4,1,353,10,5,4,1,0,1137,784,0,353
1999,Perry,IL,17145,144,116,0,0,28,19,14,0,0,5,125,102,0,23
1999,Piatt,IL,17147,55,46,0,0,9,0,0,0,0,0,55,46,0,9
1999,Pike,IL,17149,98,90,0,3,5,4,1,0,3,0,94,89,0,5
1999,Pope,IL,17151,20,16,0,0,4,2,2,0,0,0,18,14,0,4
1999,Pulaski,IL,17153,47,46,0,0,1,3,3,0,0,0,44,43,0,1
1999,Putnam,IL,17155,20,17,0,0,3,0,0,0,0,0,20,17,0,3
1999,Randolph,IL,17157,156,112,0,0,44,11,9,0,0,2,145,103,0,42
1999,Richland,IL,17159,74,62,0,1,11,10,8,0,1,1,64,54,0,10
1999,Rock Island,IL,17161,791,596,3,0,192,8,5,3,0,0,783,591,0,192
1999,St. Clair,IL,17163,1900,1126,9,0,765,118,74,8,0,36,1782,1052,1,729
1999,Saline,IL,17165,174,139,0,2,33,29,20,0,2,7,145,119,0,26
1999,Sangamon,IL,17167,988,915,4,3,66,16,8,4,3,1,972,907,0,65
1999,Schuyler,IL,17169,26,24,0,0,2,0,0,0,0,0,26,24,0,2
1999,Scott,IL,17171,18,18,0,0,0,0,0,0,0,0,18,18,0,0
1999,Shelby,IL,17173,67,60,2,2,3,4,0,2,2,0,63,60,0,3
1999,Stark,IL,17175,37,35,0,0,2,0,0,0,0,0,37,35,0,2
1999,Stephenson,IL,17177,224,186,0,0,38,0,0,0,0,0,224,186,0,38
1999,Tazewell,IL,17179,686,528,2,0,156,12,9,2,0,1,674,519,0,155
1999,Union,IL,17181,77,67,0,0,10,10,8,0,0,2,67,59,0,8
1999,Vermilion,IL,17183,611,559,2,0,50,3,1,2,0,0,608,558,0,50
1999,Wabash,IL,17185,52,46,0,0,6,2,2,0,0,0,50,44,0,6
1999,Warren,IL,17187,107,71,0,1,35,4,1,0,1,2,103,70,0,33
1999,Washington,IL,17189,64,40,0,0,24,10,5,0,0,5,54,35,0,19
1999,Wayne,IL,17191,84,68,0,6,10,17,10,0,6,1,67,58,0,9
1999,White,IL,17193,69,62,2,0,5,15,12,2,0,1,54,50,0,4
1999,Whiteside,IL,17195,270,240,2,4,24,6,0,2,4,0,264,240,0,24
1999,Will,IL,17197,2460,1857,6,0,597,28,22,6,0,0,2432,1835,0,597
1999,Williamson,IL,17199,499,384,3,0,112,57,37,3,0,17,442,347,0,95
1999,Winnebago,IL,17201,1741,1245,2,1,493,11,7,2,1,1,1730,1238,0,492
1999,Woodford,IL,17203,101,75,0,0,26,2,2,0,0,0,99,73,0,26
1999,Adams,IN,18001,98,85,3,0,10,2,0,2,0,0,96,85,1,10
1999,Allen,IN,18003,1749,1555,6,0,188,17,11,6,0,0,1732,1544,0,188
1999,Bartholomew,IN,18005,467,379,1,0,87,5,4,1,0,0,462,375,0,87
1999,Benton,IN,18007,49,40,0,0,9,0,0,0,0,0,49,40,0,9
1999,Blackford,IN,18009,84,81,1,0,2,3,2,1,0,0,81,79,0,2
1999,Boone,IN,18011,223,177,2,0,44,4,3,1,0,0,219,174,1,44
1999,Brown,IN,18013,99,76,1,0,22,1,0,1,0,0,98,76,0,22
1999,Carroll,IN,18015,92,77,0,0,15,0,0,0,0,0,92,77,0,15
1999,Cass,IN,18017,194,163,1,0,30,2,0,1,0,1,192,163,0,29
1999,Clark,IN,18019,798,502,0,0,296,5,4,0,0,1,793,498,0,295
1999,Clay,IN,18021,184,152,0,1,31,6,5,0,1,0,178,147,0,31
1999,Clinton,IN,18023,246,208,0,1,37,1,0,0,1,0,245,208,0,37
1999,Crawford,IN,18025,68,46,1,0,21,3,2,1,0,0,65,44,0,21
1999,Daviess,IN,18027,107,96,3,0,8,9,5,3,0,1,98,91,0,7
1999,De Kalb,IN,18029,141,119,0,0,22,2,2,0,0,0,139,117,0,22
1999,Dearborn,IN,18031,142,114,0,0,28,2,2,0,0,0,140,112,0,28
1999,Decatur,IN,18033,174,162,1,0,11,3,2,1,0,0,171,160,0,11
1999,Delaware,IN,18035,769,708,3,0,58,9,5,3,0,1,760,703,0,57
1999,Dubois,IN,18037,109,95,0,1,13,4,3,0,1,0,105,92,0,13
1999,Elkhart,IN,18039,1090,1024,3,0,63,8,5,3,0,0,1082,1019,0,63
1999,Fayette,IN,18041,196,178,0,0,18,0,0,0,0,0,196,178,0,18
1999,Floyd,IN,18043,417,253,1,0,163,5,4,1,0,0,412,249,0,163
1999,Fountain,IN,18045,131,104,0,0,27,0,0,0,0,0,131,104,0,27
1999,Franklin,IN,18047,69,59,0,0,10,2,2,0,0,0,67,57,0,10
1999,Fulton,IN,18049,124,105,1,0,18,3,1,1,0,1,121,104,0,17
1999,Gibson,IN,18051,166,143,0,0,23,7,5,0,0,2,159,138,0,21
1999,Grant,IN,18053,459,419,1,0,39,2,0,1,0,1,457,419,0,38
1999,Greene,IN,18055,181,123,1,0,57,4,2,1,0,1,177,121,0,56
1999,Hamilton,IN,18057,675,564,6,1,104,26,19,5,1,1,649,545,1,103
1999,Hancock,IN,18059,283,243,0,0,40,3,3,0,0,0,280,240,0,40
1999,Harrison,IN,18061,191,114,0,0,77,1,1,0,0,0,190,113,0,77
1999,Hendricks,IN,18063,483,409,6,0,68,15,9,6,0,0,468,400,0,68
1999,Henry,IN,18065,350,296,0,0,54,0,0,0,0,0,350,296,0,54
1999,Howard,IN,18067,546,491,1,0,54,4,3,1,0,0,542,488,0,54
1999,Huntington,IN,18069,186,171,0,0,15,3,3,0,0,0,183,168,0,15
1999,Jackson,IN,18071,257,165,0,1,91,2,0,0,1,1,255,165,0,90
1999,Jasper,IN,18073,191,162,0,0,29,2,1,0,0,1,189,161,0,28
1999,Jay,IN,18075,104,100,0,0,4,1,1,0,0,0,103,99,0,4
1999,Jefferson,IN,18077,201,139,1,0,61,4,3,1,0,0,197,136,0,61
1999,Jennings,IN,18079,233,157,0,0,76,1,1,0,0,0,232,156,0,76
1999,Johnson,IN,18081,799,691,2,0,106,11,11,0,0,0,788,680,2,106
1999,Knox,IN,18083,230,186,5,0,39,9,2,5,0,2,221,184,0,37
1999,Kosciusko,IN,18085,363,343,1,0,19,4,3,1,0,0,359,340,0,19
1999,La Porte,IN,18087,85,79,0,0,6,0,0,0,0,0,85,79,0,6
1999,Lagrange,IN,18089,3587,2562,11,0,1014,43,26,11,0,6,3544,2536,0,1008
1999,Lake,IN,18091,851,781,0,2,68,6,4,0,2,0,845,777,0,68
1999,Lawrence,IN,18093,358,243,1,1,113,4,2,0,1,1,354,241,1,112
1999,Madison,IN,18095,993,878,2,0,113,6,3,2,0,1,987,875,0,112
1999,Marion,IN,18097,7732,6169,21,0,1542,80,58,19,0,3,7652,6111,2,1539
1999,Marshall,IN,18099,198,183,0,0,15,0,0,0,0,0,198,183,0,15
1999,Martin,IN,18101,48,37,1,1,9,3,1,1,1,0,45,36,0,9
1999,Miami,IN,18103,181,166,0,0,15,3,3,0,0,0,178,163,0,15
1999,Monroe,IN,18105,533,354,2,0,177,13,11,2,0,0,520,343,0,177
1999,Montgomery,IN,18107,249,209,0,0,40,4,3,0,0,1,245,206,0,39
1999,Morgan,IN,18109,460,373,0,0,87,2,2,0,0,0,458,371,0,87
1999,Newton,IN,18111,67,57,0,1,9,2,0,0,1,1,65,57,0,8
1999,Noble,IN,18113,208,198,1,0,9,1,0,1,0,0,207,198,0,9
1999,Ohio,IN,18115,45,36,0,0,9,0,0,0,0,0,45,36,0,9
1999,Orange,IN,18117,156,116,2,0,38,3,1,2,0,0,153,115,0,38
1999,Owen,IN,18119,133,95,0,0,38,2,2,0,0,0,131,93,0,38
1999,Parke,IN,18121,93,74,0,1,18,1,0,0,1,0,92,74,0,18
1999,Perry,IN,18123,73,67,0,0,6,1,1,0,0,0,72,66,0,6
1999,Pike,IN,18125,54,49,0,0,5,2,2,0,0,0,52,47,0,5
1999,Porter,IN,18127,882,752,1,0,129,9,5,1,0,3,873,747,0,126
1999,Posey,IN,18129,86,67,1,0,18,4,1,1,0,2,82,66,0,16
1999,Pulaski,IN,18131,84,71,0,3,10,3,0,0,3,0,81,71,0,10
1999,Putnam,IN,18133,249,216,1,0,32,7,5,1,0,1,242,211,0,31
1999,Randolph,IN,18135,164,152,0,0,12,0,0,0,0,0,164,152,0,12
1999,Ripley,IN,18137,136,107,0,0,29,2,2,0,0,0,134,105,0,29
1999,Rush,IN,18139,124,108,1,0,15,1,1,0,0,0,123,107,1,15
1999,St. Joseph,IN,18141,1540,1330,9,0,201,16,8,7,0,1,1524,1322,2,200
1999,Scott,IN,18143,197,137,0,0,60,1,1,0,0,0,196,136,0,60
1999,Shelby,IN,18145,322,274,1,1,46,5,3,1,1,0,317,271,0,46
1999,Spencer,IN,18147,81,69,2,0,10,2,0,2,0,0,79,69,0,10
1999,Starke,IN,18149,149,133,0,1,15,1,0,0,1,0,148,133,0,15
1999,Steuben,IN,18151,147,142,0,0,5,2,2,0,0,0,145,140,0,5
1999,Sullivan,IN,18153,149,120,1,0,28,7,4,1,0,2,142,116,0,26
1999,Switzerland,IN,18155,39,32,0,0,7,0,0,0,0,0,39,32,0,7
1999,Tippecanoe,IN,18157,634,548,2,1,83,9,4,2,1,2,625,544,0,81
1999,Tipton,IN,18159,92,82,0,0,10,0,0,0,0,0,92,82,0,10
1999,Union,IN,18161,27,25,1,0,1,1,0,1,0,0,26,25,0,1
1999,Vanderburgh,IN,18163,1032,867,2,0,163,36,29,2,0,5,996,838,0,158
1999,Vermillion,IN,18165,116,91,0,0,25,0,0,0,0,0,116,91,0,25
1999,Vigo,IN,18167,672,495,3,0,174,18,11,3,0,4,654,484,0,170
1999,Wabash,IN,18169,191,179,0,0,12,0,0,0,0,0,191,179,0,12
1999,Warren,IN,18171,47,40,0,0,7,2,0,0,0,2,45,40,0,5
1999,Warrick,IN,18173,235,197,0,0,38,9,5,0,0,4,226,192,0,34
1999,Washington,IN,18175,187,116,0,0,71,1,1,0,0,0,186,115,0,71
1999,Wayne,IN,18177,397,358,3,0,36,6,4,2,0,0,391,354,1,36
1999,Wells,IN,18179,101,90,1,0,10,4,3,1,0,0,97,87,0,10
1999,White,IN,18181,168,150,0,1,17,3,2,0,1,0,165,148,0,17
1999,Whitley,IN,18183,138,124,1,0,13,1,0,1,0,0,137,124,0,13
1999,Adair,IA,19001,11,11,0,0,0,1,1,0,0,0,10,10,0,0
1999,Adams,IA,19003,13,12,0,0,1,0,0,0,0,0,13,12,0,1
1999,Allamakee,IA,19005,24,24,0,0,0,2,2,0,0,0,22,22,0,0
1999,Appanoose,IA,19007,52,45,1,0,6,1,0,1,0,0,51,45,0,6
1999,Audubon,IA,19009,17,16,0,0,1,0,0,0,0,0,17,16,0,1
1999,Benton,IA,19011,63,59,0,1,3,5,4,0,1,0,58,55,0,3
1999,Black Hawk,IA,19013,354,324,1,0,29,10,9,1,0,0,344,315,0,29
1999,Boone,IA,19015,73,70,0,0,3,0,0,0,0,0,73,70,0,3
1999,Bremer,IA,19017,37,35,0,0,2,2,2,0,0,0,35,33,0,2
1999,Buchanan,IA,19019,62,61,0,0,1,5,4,0,0,1,57,57,0,0
1999,Buena Vista,IA,19021,42,42,0,0,0,0,0,0,0,0,42,42,0,0
1999,Butler,IA,19023,39,35,0,0,4,1,1,0,0,0,38,34,0,4
1999,Calhoun,IA,19025,17,17,0,0,0,1,1,0,0,0,16,16,0,0
1999,Carroll,IA,19027,32,30,0,2,0,4,2,0,2,0,28,28,0,0
1999,Cass,IA,19029,45,45,0,0,0,1,1,0,0,0,44,44,0,0
1999,Cedar,IA,19031,45,40,0,0,5,0,0,0,0,0,45,40,0,5
1999,Cerro Gordo,IA,19033,113,111,1,0,1,2,2,0,0,0,111,109,1,1
1999,Cherokee,IA,19035,31,30,0,1,0,1,0,0,1,0,30,30,0,0
1999,Chickasaw,IA,19037,17,16,0,0,1,2,2,0,0,0,15,14,0,1
1999,Clarke,IA,19039,18,18,0,0,0,0,0,0,0,0,18,18,0,0
1999,Clay,IA,19041,46,44,0,0,2,0,0,0,0,0,46,44,0,2
1999,Clayton,IA,19043,40,40,0,0,0,2,2,0,0,0,38,38,0,0
1999,Clinton,IA,19045,177,149,0,0,28,3,1,0,0,2,174,148,0,26
1999,Crawford,IA,19047,26,26,0,0,0,1,1,0,0,0,25,25,0,0
1999,Dallas,IA,19049,106,97,1,0,8,2,1,1,0,0,104,96,0,8
1999,Davis,IA,19051,20,15,0,0,5,0,0,0,0,0,20,15,0,5
1999,Decatur,IA,19053,13,13,0,0,0,0,0,0,0,0,13,13,0,0
1999,Delaware,IA,19055,34,33,0,0,1,3,3,0,0,0,31,30,0,1
1999,Des Moines,IA,19057,231,228,0,0,3,3,3,0,0,0,228,225,0,3
1999,Dickinson,IA,19059,35,34,0,0,1,0,0,0,0,0,35,34,0,1
1999,Dubuque,IA,19061,207,203,0,1,3,7,6,0,1,0,200,197,0,3
1999,Emmet,IA,19063,22,22,0,0,0,0,0,0,0,0,22,22,0,0
1999,Fayette,IA,19065,54,51,0,2,1,4,2,0,2,0,50,49,0,1
1999,Floyd,IA,19067,25,25,0,0,0,1,1,0,0,0,24,24,0,0
1999,Franklin,IA,19069,19,19,0,0,0,0,0,0,0,0,19,19,0,0
1999,Fremont,IA,19071,25,23,0,0,2,0,0,0,0,0,25,23,0,2
1999,Greene,IA,19073,19,19,0,0,0,0,0,0,0,0,19,19,0,0
1999,Grundy,IA,19075,14,14,0,0,0,3,3,0,0,0,11,11,0,0
1999,Guthrie,IA,19077,27,27,0,0,0,0,0,0,0,0,27,27,0,0
1999,Hamilton,IA,19079,33,33,0,0,0,1,1,0,0,0,32,32,0,0
1999,Hancock,IA,19081,19,19,0,0,0,2,2,0,0,0,17,17,0,0
1999,Hardin,IA,19083,50,47,0,0,3,3,3,0,0,0,47,44,0,3
1999,Harrison,IA,19085,44,43,0,0,1,2,2,0,0,0,42,41,0,1
1999,Henry,IA,19087,71,67,3,0,1,4,1,3,0,0,67,66,0,1
1999,Howard,IA,19089,19,18,0,1,0,2,1,0,1,0,17,17,0,0
1999,Humboldt,IA,19091,24,24,0,0,0,0,0,0,0,0,24,24,0,0
1999,Ida,IA,19093,17,16,0,1,0,1,0,0,1,0,16,16,0,0
1999,Iowa,IA,19095,20,18,0,1,1,1,0,0,1,0,19,18,0,1
1999,Jackson,IA,19097,41,39,0,1,1,1,0,0,1,0,40,39,0,1
1999,Jasper,IA,19099,82,75,1,0,6,2,1,1,0,0,80,74,0,6
1999,Jefferson,IA,19101,50,48,1,0,1,1,0,1,0,0,49,48,0,1
1999,Johnson,IA,19103,168,155,1,0,12,4,2,1,0,1,164,153,0,11
1999,Jones,IA,19105,46,42,1,1,2,4,2,1,1,0,42,40,0,2
1999,Keokuk,IA,19107,29,24,0,0,5,1,1,0,0,0,28,23,0,5
1999,Kossuth,IA,19109,25,25,0,0,0,5,5,0,0,0,20,20,0,0
1999,Lee,IA,19111,140,137,0,0,3,1,1,0,0,0,139,136,0,3
1999,Linn,IA,19113,580,552,2,0,26,14,13,1,0,0,566,539,1,26
1999,Louisa,IA,19115,39,37,0,0,2,0,0,0,0,0,39,37,0,2
1999,Lucas,IA,19117,17,17,0,0,0,0,0,0,0,0,17,17,0,0
1999,Lyon,IA,19119,14,14,0,0,0,1,1,0,0,0,13,13,0,0
1999,Madison,IA,19121,49,46,0,0,3,0,0,0,0,0,49,46,0,3
1999,Mahaska,IA,19123,63,58,0,0,5,1,1,0,0,0,62,57,0,5
1999,Marion,IA,19125,92,82,0,1,9,1,0,0,1,0,91,82,0,9
1999,Marshall,IA,19127,94,93,0,0,1,3,3,0,0,0,91,90,0,1
1999,Mills,IA,19129,49,43,0,0,6,0,0,0,0,0,49,43,0,6
1999,Mitchell,IA,19131,19,18,0,0,1,1,1,0,0,0,18,17,0,1
1999,Monona,IA,19133,44,43,0,1,0,2,1,0,1,0,42,42,0,0
1999,Monroe,IA,19135,17,12,0,1,4,1,0,0,1,0,16,12,0,4
1999,Montgomery,IA,19137,36,36,0,0,0,1,1,0,0,0,35,35,0,0
1999,Muscatine,IA,19139,170,147,0,0,23,2,2,0,0,0,168,145,0,23
1999,O'Brien,IA,19141,31,29,0,1,1,1,0,0,1,0,30,29,0,1
1999,Osceola,IA,19143,10,10,0,0,0,0,0,0,0,0,10,10,0,0
1999,Page,IA,19145,45,41,0,2,2,3,1,0,2,0,42,40,0,2
1999,Palo Alto,IA,19147,19,19,0,0,0,0,0,0,0,0,19,19,0,0
1999,Plymouth,IA,19149,57,54,0,0,3,0,0,0,0,0,57,54,0,3
1999,Pocahontas,IA,19151,26,26,0,0,0,0,0,0,0,0,26,26,0,0
1999,Polk,IA,19153,1287,1207,3,0,77,17,14,3,0,0,1270,1193,0,77
1999,Pottawattamie,IA,19155,391,362,1,0,28,3,2,1,0,0,388,360,0,28
1999,Poweshiek,IA,19157,39,37,0,0,2,0,0,0,0,0,39,37,0,2
1999,Ringgold,IA,19159,9,9,0,0,0,1,1,0,0,0,8,8,0,0
1999,Sac,IA,19161,28,28,0,0,0,2,2,0,0,0,26,26,0,0
1999,Scott,IA,19163,649,527,1,1,120,14,12,1,1,0,635,515,0,120
1999,Shelby,IA,19165,26,23,1,0,2,2,1,1,0,0,24,22,0,2
1999,Sioux,IA,19167,43,39,0,0,4,3,2,0,0,1,40,37,0,3
1999,Story,IA,19169,122,118,0,0,4,2,2,0,0,0,120,116,0,4
1999,Tama,IA,19171,40,36,0,0,4,0,0,0,0,0,40,36,0,4
1999,Taylor,IA,19173,19,19,0,0,0,0,0,0,0,0,19,19,0,0
1999,Union,IA,19175,36,36,0,0,0,1,1,0,0,0,35,35,0,0
1999,Van Buren,IA,19177,20,19,0,0,1,1,1,0,0,0,19,18,0,1
1999,Wapello,IA,19179,158,137,2,0,19,6,3,2,0,1,152,134,0,18
1999,Warren,IA,19181,108,97,0,0,11,0,0,0,0,0,108,97,0,11
1999,Washington,IA,19183,65,64,0,0,1,3,3,0,0,0,62,61,0,1
1999,Wayne,IA,19185,22,21,0,1,0,1,0,0,1,0,21,21,0,0
1999,Webster,IA,19187,118,116,1,0,1,3,2,1,0,0,115,114,0,1
1999,Winnebago,IA,19189,20,20,0,0,0,1,1,0,0,0,19,19,0,0
1999,Winneshiek,IA,19191,13,13,0,0,0,0,0,0,0,0,13,13,0,0
1999,Woodbury,IA,19193,436,430,3,0,3,6,3,3,0,0,430,427,0,3
1999,Worth,IA,19195,19,19,0,0,0,1,1,0,0,0,18,18,0,0
1999,Wright,IA,19197,34,34,0,0,0,0,0,0,0,0,34,34,0,0
1999,Allen,KS,20001,46,40,0,1,5,1,0,0,1,0,45,40,0,5
1999,Anderson,KS,20003,27,19,0,0,8,0,0,0,0,0,27,19,0,8
1999,Atchison,KS,20005,65,50,0,0,15,0,0,0,0,0,65,50,0,15
1999,Barber,KS,20007,23,21,0,0,2,1,1,0,0,0,22,20,0,2
1999,Barton,KS,20009,109,103,1,0,5,1,0,1,0,0,108,103,0,5
1999,Bourbon,KS,20011,51,47,0,0,4,0,0,0,0,0,51,47,0,4
1999,Brown,KS,20013,71,45,0,0,26,3,1,0,0,2,68,44,0,24
1999,Butler,KS,20015,289,259,0,0,30,4,4,0,0,0,285,255,0,30
1999,Chase,KS,20017,6,6,0,0,0,0,0,0,0,0,6,6,0,0
1999,Chautauqua,KS,20019,15,13,0,0,2,1,0,0,0,1,14,13,0,1
1999,Cherokee,KS,20021,58,52,2,0,4,2,0,2,0,0,56,52,0,4
1999,Cheyenne,KS,20023,6,3,0,0,3,0,0,0,0,0,6,3,0,3
1999,Clark,KS,20025,5,5,0,0,0,0,0,0,0,0,5,5,0,0
1999,Clay,KS,20027,26,20,0,0,6,0,0,0,0,0,26,20,0,6
1999,Cloud,KS,20029,31,29,0,0,2,1,1,0,0,0,30,28,0,2
1999,Coffey,KS,20031,54,40,0,0,14,2,2,0,0,0,52,38,0,14
1999,Comanche,KS,20033,2,2,0,0,0,0,0,0,0,0,2,2,0,0
1999,Cowley,KS,20035,190,177,0,0,13,0,0,0,0,0,190,177,0,13
1999,Crawford,KS,20037,106,102,1,0,3,2,1,1,0,0,104,101,0,3
1999,Decatur,KS,20039,28,21,0,4,3,5,0,0,4,1,23,21,0,2
1999,Dickinson,KS,20041,61,53,1,0,7,1,0,1,0,0,60,53,0,7
1999,Doniphan,KS,20043,21,16,0,0,5,0,0,0,0,0,21,16,0,5
1999,Douglas,KS,20045,369,247,0,0,122,3,3,0,0,0,366,244,0,122
1999,Edwards,KS,20047,12,11,0,0,1,0,0,0,0,0,12,11,0,1
1999,Elk,KS,20049,11,9,0,1,1,1,0,0,1,0,10,9,0,1
1999,Ellis,KS,20051,63,56,0,0,7,1,1,0,0,0,62,55,0,7
1999,Ellsworth,KS,20053,13,12,0,0,1,0,0,0,0,0,13,12,0,1
1999,Finney,KS,20055,144,133,0,0,11,2,2,0,0,0,142,131,0,11
1999,Ford,KS,20057,104,93,0,2,9,2,0,0,2,0,102,93,0,9
1999,Franklin,KS,20059,128,74,0,0,54,1,1,0,0,0,127,73,0,54
1999,Geary,KS,20061,271,195,0,0,76,5,4,0,0,1,266,191,0,75
1999,Gove,KS,20063,9,7,1,0,1,2,0,1,0,1,7,7,0,0
1999,Graham,KS,20065,5,4,0,1,0,1,0,0,1,0,4,4,0,0
1999,Grant,KS,20067,29,26,0,1,2,2,1,0,1,0,27,25,0,2
1999,Gray,KS,20069,11,10,0,0,1,0,0,0,0,0,11,10,0,1
1999,Greeley,KS,20071,11,8,0,0,3,0,0,0,0,0,11,8,0,3
1999,Greenwood,KS,20073,41,35,0,0,6,0,0,0,0,0,41,35,0,6
1999,Hamilton,KS,20075,8,7,0,0,1,1,1,0,0,0,7,6,0,1
1999,Harper,KS,20077,22,22,0,0,0,0,0,0,0,0,22,22,0,0
1999,Harvey,KS,20079,156,141,0,0,15,2,1,0,0,1,154,140,0,14
1999,Haskell,KS,20081,7,6,0,0,1,0,0,0,0,0,7,6,0,1
1999,Hodgeman,KS,20083,2,1,0,0,1,0,0,0,0,0,2,1,0,1
1999,Jackson,KS,20085,63,35,0,0,28,0,0,0,0,0,63,35,0,28
1999,Jefferson,KS,20087,93,54,0,1,38,2,0,0,1,1,91,54,0,37
1999,Jewell,KS,20089,9,9,0,0,0,1,1,0,0,0,8,8,0,0
1999,Johnson,KS,20091,1278,1083,6,0,189,21,16,5,0,0,1257,1067,1,189
1999,Kearny,KS,20093,18,16,0,0,2,0,0,0,0,0,18,16,0,2
1999,Kingman,KS,20095,31,25,0,1,5,2,1,0,1,0,29,24,0,5
1999,Kiowa,KS,20097,9,9,0,0,0,1,1,0,0,0,8,8,0,0
1999,Labette,KS,20099,81,77,2,0,2,5,3,2,0,0,76,74,0,2
1999,Lane,KS,20101,9,8,0,0,1,0,0,0,0,0,9,8,0,1
1999,Leavenworth,KS,20103,292,248,1,0,43,3,1,1,0,1,289,247,0,42
1999,Lincoln,KS,20105,7,7,0,0,0,0,0,0,0,0,7,7,0,0
1999,Linn,KS,20107,33,25,0,0,8,0,0,0,0,0,33,25,0,8
1999,Logan,KS,20109,12,11,0,0,1,0,0,0,0,0,12,11,0,1
1999,Lyon,KS,20111,142,110,1,0,31,3,1,1,0,1,139,109,0,30
1999,McPherson,KS,20113,142,131,0,0,11,4,4,0,0,0,138,127,0,11
1999,Marion,KS,20115,32,29,0,0,3,0,0,0,0,0,32,29,0,3
1999,Marshall,KS,20117,41,28,0,1,12,1,0,0,1,0,40,28,0,12
1999,Meade,KS,20119,12,10,0,0,2,0,0,0,0,0,12,10,0,2
1999,Miami,KS,20121,108,86,0,0,22,0,0,0,0,0,108,86,0,22
1999,Mitchell,KS,20123,16,15,0,0,1,0,0,0,0,0,16,15,0,1
1999,Montgomery,KS,20125,210,195,1,0,14,2,1,1,0,0,208,194,0,14
1999,Morris,KS,20127,27,19,1,0,7,1,0,1,0,0,26,19,0,7
1999,Morton,KS,20129,8,6,0,0,2,0,0,0,0,0,8,6,0,2
1999,Nemaha,KS,20131,28,15,0,0,13,0,0,0,0,0,28,15,0,13
1999,Neosho,KS,20133,63,60,0,0,3,1,1,0,0,0,62,59,0,3
1999,Ness,KS,20135,14,13,0,1,0,1,0,0,1,0,13,13,0,0
1999,Norton,KS,20137,15,14,0,0,1,0,0,0,0,0,15,14,0,1
1999,Osage,KS,20139,114,54,0,0,60,1,1,0,0,0,113,53,0,60
1999,Osborne,KS,20141,8,7,0,0,1,0,0,0,0,0,8,7,0,1
1999,Ottawa,KS,20143,18,16,0,0,2,0,0,0,0,0,18,16,0,2
1999,Pawnee,KS,20145,20,17,0,0,3,0,0,0,0,0,20,17,0,3
1999,Phillips,KS,20147,11,11,0,0,0,1,1,0,0,0,10,10,0,0
1999,Pottawatomie,KS,20149,202,164,0,0,38,3,2,0,0,1,199,162,0,37
1999,Pratt,KS,20151,36,33,0,0,3,3,3,0,0,0,33,30,0,3
1999,Rawlins,KS,20153,6,5,0,0,1,0,0,0,0,0,6,5,0,1
1999,Reno,KS,20155,324,285,0,0,39,2,2,0,0,0,322,283,0,39
1999,Republic,KS,20157,8,8,0,0,0,0,0,0,0,0,8,8,0,0
1999,Rice,KS,20159,46,41,0,1,4,2,1,0,1,0,44,40,0,4
1999,Riley,KS,20161,23,21,0,0,2,1,1,0,0,0,22,20,0,2
1999,Rooks,KS,20163,18,16,0,1,1,2,1,0,1,0,16,15,0,1
1999,Rush,KS,20165,9,8,1,0,0,1,0,1,0,0,8,8,0,0
1999,Russell,KS,20167,29,28,0,0,1,0,0,0,0,0,29,28,0,1
1999,Saline,KS,20169,210,186,0,0,24,4,4,0,0,0,206,182,0,24
1999,Scott,KS,20171,13,12,0,0,1,0,0,0,0,0,13,12,0,1
1999,Sedgwick,KS,20173,2381,2113,11,0,257,42,27,10,0,5,2339,2086,1,252
1999,Seward,KS,20175,69,62,0,1,6,3,2,0,1,0,66,60,0,6
1999,Shawnee,KS,20177,1236,604,3,0,629,5,1,3,0,1,1231,603,0,628
1999,Sheridan,KS,20179,4,3,0,0,1,0,0,0,0,0,4,3,0,1
1999,Sherman,KS,20181,19,15,0,0,4,1,1,0,0,0,18,14,0,4
1999,Smith,KS,20183,11,10,0,0,1,1,1,0,0,0,10,9,0,1
1999,Stafford,KS,20185,13,12,0,0,1,0,0,0,0,0,13,12,0,1
1999,Stanton,KS,20187,6,3,0,3,0,4,1,0,3,0,2,2,0,0
1999,Stevens,KS,20189,17,14,0,0,3,0,0,0,0,0,17,14,0,3
1999,Sumner,KS,20191,96,82,1,1,12,6,3,1,1,1,90,79,0,11
1999,Thomas,KS,20193,19,17,0,0,2,0,0,0,0,0,19,17,0,2
1999,Trego,KS,20195,5,5,0,0,0,0,0,0,0,0,5,5,0,0
1999,Wabaunsee,KS,20197,26,13,0,1,12,1,0,0,1,0,25,13,0,12
1999,Wallace,KS,20199,3,3,0,0,0,0,0,0,0,0,3,3,0,0
1999,Washington,KS,20201,9,6,0,0,3,0,0,0,0,0,9,6,0,3
1999,Wichita,KS,20203,3,2,0,0,1,0,0,0,0,0,3,2,0,1
1999,Wilson,KS,20205,33,25,0,0,8,0,0,0,0,0,33,25,0,8
1999,Woodson,KS,20207,13,13,0,0,0,0,0,0,0,0,13,13,0,0
1999,Wyandotte,KS,20209,932,693,1,0,238,3,2,1,0,0,929,691,0,238
1999,Adair,KY,21001,66,63,0,0,3,1,1,0,0,0,65,62,0,3
1999,Allen,KY,21003,103,97,0,0,6,0,0,0,0,0,103,97,0,6
1999,Anderson,KY,21005,95,83,0,0,12,1,1,0,0,0,94,82,0,12
1999,Ballard,KY,21007,21,19,0,0,2,0,0,0,0,0,21,19,0,2
1999,Barren,KY,21009,239,215,2,4,18,6,0,2,4,0,233,215,0,18
1999,Bath,KY,21011,43,39,0,0,4,0,0,0,0,0,43,39,0,4
1999,Bell,KY,21013,120,110,1,0,9,2,0,1,0,1,118,110,0,8
1999,Boone,KY,21015,443,393,0,0,50,11,10,0,0,1,432,383,0,49
1999,Bourbon,KY,21017,116,103,0,0,13,0,0,0,0,0,116,103,0,13
1999,Boyd,KY,21019,257,169,3,0,85,5,1,3,0,1,252,168,0,84
1999,Boyle,KY,21021,102,88,2,0,12,3,1,2,0,0,99,87,0,12
1999,Bracken,KY,21023,48,41,1,0,6,1,0,1,0,0,47,41,0,6
1999,Breathitt,KY,21025,47,36,0,0,11,1,1,0,0,0,46,35,0,11
1999,Breckinridge,KY,21027,60,54,0,0,6,0,0,0,0,0,60,54,0,6
1999,Bullitt,KY,21029,239,175,2,0,62,6,4,2,0,0,233,171,0,62
1999,Butler,KY,21031,54,51,0,0,3,0,0,0,0,0,54,51,0,3
1999,Caldwell,KY,21033,73,65,0,0,8,1,1,0,0,0,72,64,0,8
1999,Calloway,KY,21035,102,94,2,0,6,2,0,2,0,0,100,94,0,6
1999,Campbell,KY,21037,386,332,2,0,52,8,4,2,0,2,378,328,0,50
1999,Carlisle,KY,21039,14,10,0,0,4,0,0,0,0,0,14,10,0,4
1999,Carroll,KY,21041,48,46,0,0,2,0,0,0,0,0,48,46,0,2
1999,Carter,KY,21043,63,45,0,0,18,0,0,0,0,0,63,45,0,18
1999,Casey,KY,21045,57,52,0,0,5,0,0,0,0,0,57,52,0,5
1999,Christian,KY,21047,509,380,1,0,128,2,1,1,0,0,507,379,0,128
1999,Clark,KY,21049,174,158,0,0,16,0,0,0,0,0,174,158,0,16
1999,Clay,KY,21051,53,46,0,0,7,2,2,0,0,0,51,44,0,7
1999,Clinton,KY,21053,23,23,0,0,0,0,0,0,0,0,23,23,0,0
1999,Crittenden,KY,21055,40,35,0,0,5,0,0,0,0,0,40,35,0,5
1999,Cumberland,KY,21057,33,26,0,0,7,0,0,0,0,0,33,26,0,7
1999,Daviess,KY,21059,436,399,2,0,35,6,4,2,0,0,430,395,0,35
1999,Edmonson,KY,21061,40,38,0,0,2,0,0,0,0,0,40,38,0,2
1999,Elliott,KY,21063,11,10,0,0,1,0,0,0,0,0,11,10,0,1
1999,Estill,KY,21065,57,48,1,0,8,1,0,1,0,0,56,48,0,8
1999,Fayette,KY,21067,1040,874,7,0,159,28,19,7,0,2,1012,855,0,157
1999,Fleming,KY,21069,63,53,3,0,7,3,0,3,0,0,60,53,0,7
1999,Floyd,KY,21071,179,152,1,0,26,5,4,1,0,0,174,148,0,26
1999,Franklin,KY,21073,271,239,1,0,31,2,1,1,0,0,269,238,0,31
1999,Fulton,KY,21075,45,40,0,0,5,1,1,0,0,0,44,39,0,5
1999,Gallatin,KY,21077,47,38,0,0,9,1,1,0,0,0,46,37,0,9
1999,Garrard,KY,21079,61,52,0,2,7,2,0,0,2,0,59,52,0,7
1999,Grant,KY,21081,150,137,0,0,13,2,1,0,0,1,148,136,0,12
1999,Graves,KY,21083,127,105,0,1,21,7,5,0,1,1,120,100,0,20
1999,Grayson,KY,21085,91,83,1,0,7,3,2,1,0,0,88,81,0,7
1999,Green,KY,21087,37,32,0,0,5,0,0,0,0,0,37,32,0,5
1999,Greenup,KY,21089,155,122,0,0,33,0,0,0,0,0,155,122,0,33
1999,Hancock,KY,21091,44,39,0,0,5,0,0,0,0,0,44,39,0,5
1999,Hardin,KY,21093,776,635,0,0,141,1,1,0,0,0,775,634,0,141
1999,Harlan,KY,21095,154,143,0,0,11,2,2,0,0,0,152,141,0,11
1999,Harrison,KY,21097,79,68,0,0,11,0,0,0,0,0,79,68,0,11
1999,Hart,KY,21099,104,96,0,1,7,2,1,0,1,0,102,95,0,7
1999,Henderson,KY,21101,315,303,1,0,11,2,2,0,0,0,313,301,1,11
1999,Henry,KY,21103,73,63,0,0,10,0,0,0,0,0,73,63,0,10
1999,Hickman,KY,21105,11,8,0,0,3,0,0,0,0,0,11,8,0,3
1999,Hopkins,KY,21107,354,322,1,1,30,4,1,1,1,1,350,321,0,29
1999,Jackson,KY,21109,40,38,0,0,2,0,0,0,0,0,40,38,0,2
1999,Jefferson,KY,21111,5139,3566,154,0,1419,194,39,154,0,1,4945,3527,0,1418
1999,Jessamine,KY,21113,181,156,0,1,24,1,0,0,1,0,180,156,0,24
1999,Johnson,KY,21115,147,132,1,0,14,4,1,1,0,2,143,131,0,12
1999,Kenton,KY,21117,975,753,135,0,87,142,7,135,0,0,833,746,0,87
1999,Knott,KY,21119,64,45,0,0,19,0,0,0,0,0,64,45,0,19
1999,Knox,KY,21121,115,104,0,0,11,0,0,0,0,0,115,104,0,11
1999,Larue,KY,21123,60,50,0,0,10,0,0,0,0,0,60,50,0,10
1999,Laurel,KY,21125,216,198,2,0,16,3,1,2,0,0,213,197,0,16
1999,Lawrence,KY,21127,58,55,0,0,3,2,2,0,0,0,56,53,0,3
1999,Lee,KY,21129,22,18,0,0,4,0,0,0,0,0,22,18,0,4
1999,Leslie,KY,21131,34,20,0,0,14,0,0,0,0,0,34,20,0,14
1999,Letcher,KY,21133,224,184,0,0,40,1,0,0,0,1,223,184,0,39
1999,Lewis,KY,21135,53,51,0,0,2,1,1,0,0,0,52,50,0,2
1999,Lincoln,KY,21137,100,85,0,0,15,0,0,0,0,0,100,85,0,15
1999,Livingston,KY,21139,41,36,0,0,5,0,0,0,0,0,41,36,0,5
1999,Logan,KY,21141,182,152,2,0,28,3,0,2,0,1,179,152,0,27
1999,Lyon,KY,21143,22,21,0,0,1,0,0,0,0,0,22,21,0,1
1999,McCracken,KY,21145,353,292,3,0,58,8,5,3,0,0,345,287,0,58
1999,McCreary,KY,21147,72,69,0,0,3,1,1,0,0,0,71,68,0,3
1999,McLean,KY,21149,40,30,0,1,9,2,1,0,1,0,38,29,0,9
1999,Madison,KY,21151,322,295,0,0,27,6,5,0,0,1,316,290,0,26
1999,Magoffin,KY,21153,53,46,0,0,7,1,0,0,0,1,52,46,0,6
1999,Marion,KY,21155,61,47,0,2,12,3,1,0,2,0,58,46,0,12
1999,Marshall,KY,21157,113,95,1,0,17,3,2,1,0,0,110,93,0,17
1999,Martin,KY,21159,60,51,0,0,9,1,1,0,0,0,59,50,0,9
1999,Mason,KY,21161,82,78,0,0,4,1,1,0,0,0,81,77,0,4
1999,Meade,KY,21163,106,84,1,0,21,1,0,1,0,0,105,84,0,21
1999,Menifee,KY,21165,37,35,0,0,2,0,0,0,0,0,37,35,0,2
1999,Mercer,KY,21167,98,80,0,2,16,2,0,0,2,0,96,80,0,16
1999,Metcalfe,KY,21169,55,50,0,0,5,0,0,0,0,0,55,50,0,5
1999,Monroe,KY,21171,44,42,0,0,2,0,0,0,0,0,44,42,0,2
1999,Montgomery,KY,21173,129,110,1,0,18,2,0,1,0,1,127,110,0,17
1999,Morgan,KY,21175,45,35,0,0,10,0,0,0,0,0,45,35,0,10
1999,Muhlenberg,KY,21177,183,173,0,0,10,3,2,0,0,1,180,171,0,9
1999,Nelson,KY,21179,182,142,0,0,40,0,0,0,0,0,182,142,0,40
1999,Nicholas,KY,21181,35,33,0,0,2,0,0,0,0,0,35,33,0,2
1999,Ohio,KY,21183,116,103,0,0,13,0,0,0,0,0,116,103,0,13
1999,Oldham,KY,21185,148,115,1,0,32,5,4,1,0,0,143,111,0,32
1999,Owen,KY,21187,52,44,0,0,8,0,0,0,0,0,52,44,0,8
1999,Owsley,KY,21189,20,13,0,0,7,0,0,0,0,0,20,13,0,7
1999,Pendleton,KY,21191,79,70,0,0,9,0,0,0,0,0,79,70,0,9
1999,Perry,KY,21193,157,103,1,0,53,8,5,1,0,2,149,98,0,51
1999,Pike,KY,21195,334,304,3,0,27,16,12,3,0,1,318,292,0,26
1999,Powell,KY,21197,82,71,0,0,11,1,1,0,0,0,81,70,0,11
1999,Pulaski,KY,21199,208,192,2,0,14,8,5,2,0,1,200,187,0,13
1999,Robertson,KY,21201,6,6,0,0,0,0,0,0,0,0,6,6,0,0
1999,Rockcastle,KY,21203,48,43,1,0,4,2,1,1,0,0,46,42,0,4
1999,Rowan,KY,21205,61,52,1,0,8,1,0,1,0,0,60,52,0,8
1999,Russell,KY,21207,74,74,0,0,0,1,1,0,0,0,73,73,0,0
1999,Scott,KY,21209,161,143,0,0,18,3,3,0,0,0,158,140,0,18
1999,Shelby,KY,21211,115,101,0,0,14,2,2,0,0,0,113,99,0,14
1999,Simpson,KY,21213,119,107,0,0,12,0,0,0,0,0,119,107,0,12
1999,Spencer,KY,21215,50,41,1,0,8,1,0,1,0,0,49,41,0,8
1999,Taylor,KY,21217,130,119,1,1,9,3,1,1,1,0,127,118,0,9
1999,Todd,KY,21219,56,45,1,1,9,2,0,1,1,0,54,45,0,9
1999,Trigg,KY,21221,73,52,1,0,20,3,2,1,0,0,70,50,0,20
1999,Trimble,KY,21223,39,37,0,0,2,0,0,0,0,0,39,37,0,2
1999,Union,KY,21225,63,57,0,0,6,1,0,0,0,1,62,57,0,5
1999,Warren,KY,21227,515,468,5,2,40,11,3,5,2,1,504,465,0,39
1999,Washington,KY,21229,26,24,0,0,2,0,0,0,0,0,26,24,0,2
1999,Wayne,KY,21231,83,75,0,1,7,2,0,0,1,1,81,75,0,6
1999,Webster,KY,21233,78,67,0,0,11,0,0,0,0,0,78,67,0,11
1999,Whitley,KY,21235,156,148,0,0,8,0,0,0,0,0,156,148,0,8
1999,Wolfe,KY,21237,29,26,0,0,3,0,0,0,0,0,29,26,0,3
1999,Woodford,KY,21239,66,56,0,0,10,0,0,0,0,0,66,56,0,10
1999,Acadia,LA,22001,234,201,0,0,33,8,8,0,0,0,226,193,0,33
1999,Allen,LA,22003,112,82,0,0,30,1,1,0,0,0,111,81,0,30
1999,Ascension,LA,22005,247,181,3,0,63,7,4,3,0,0,240,177,0,63
1999,Assumption,LA,22007,48,31,0,0,17,1,1,0,0,0,47,30,0,17
1999,Avoyelles,LA,22009,179,81,0,1,97,11,6,0,1,4,168,75,0,93
1999,Beauregard,LA,22011,173,120,0,0,53,5,3,0,0,2,168,117,0,51
1999,Bienville,LA,22013,88,23,0,0,65,3,3,0,0,0,85,20,0,65
1999,Bossier,LA,22015,788,289,2,0,497,12,6,1,0,5,776,283,1,492
1999,Caddo,LA,22017,2094,663,10,0,1421,53,26,10,0,17,2041,637,0,1404
1999,Calcasieu,LA,22019,1032,670,0,0,362,18,16,0,0,2,1014,654,0,360
1999,Caldwell,LA,22021,94,32,1,0,61,4,2,1,0,1,90,30,0,60
1999,Cameron,LA,22023,22,16,0,0,6,1,0,0,0,0,22,16,0,6
1999,Catahoula,LA,22025,67,34,0,1,32,8,6,0,1,1,59,28,0,31
1999,Claiborne,LA,22027,93,25,0,0,68,3,0,0,0,3,90,25,0,65
1999,Concordia,LA,22029,61,32,0,1,28,6,2,0,1,3,55,30,0,25
1999,De Soto,LA,22031,212,56,1,0,155,3,1,1,0,1,209,55,0,154
1999,East Baton Rouge,LA,22033,1621,1063,20,0,538,28,7,20,0,1,1593,1056,0,537
1999,East Carroll,LA,22035,32,17,0,0,15,1,1,0,0,0,31,16,0,15
1999,East Feliciana,LA,22037,97,64,0,0,33,1,1,0,0,0,96,63,0,33
1999,Evangeline,LA,22039,116,92,0,0,24,0,0,0,0,0,116,92,0,24
1999,Franklin,LA,22041,117,55,0,0,62,13,10,0,0,3,104,45,0,59
1999,Grant,LA,22043,103,48,1,0,54,9,5,1,0,3,94,43,0,51
1999,Iberia,LA,22045,460,180,4,0,276,6,1,4,0,1,454,179,0,275
1999,Iberville,LA,22047,126,80,0,0,46,0,0,0,0,0,126,80,0,46
1999,Jackson,LA,22049,110,56,0,0,54,1,1,0,0,0,109,55,0,54
1999,Jefferson,LA,22051,2070,1370,12,0,688,25,14,11,0,0,2045,1356,1,688
1999,Jefferson Davis,LA,22053,154,108,0,1,45,5,2,0,1,2,149,106,0,43
1999,Lafayette,LA,22055,869,607,9,0,253,26,16,7,0,3,843,591,2,250
1999,Lafourche,LA,22057,243,192,2,1,48,4,1,2,1,0,239,191,0,48
1999,La Salle,LA,22059,102,39,0,0,63,11,6,0,0,5,91,33,0,58
1999,Lincoln,LA,22061,193,88,0,0,105,15,13,0,0,2,178,75,0,103
1999,Livingston,LA,22063,348,269,0,0,79,3,3,0,0,0,345,266,0,79
1999,Madison,LA,22065,67,45,0,1,21,10,6,0,1,3,57,39,0,18
1999,Morehouse,LA,22067,224,88,0,0,136,6,5,0,0,1,218,83,0,135
1999,Natchitoches,LA,22069,253,86,0,2,165,10,4,0,2,4,243,82,0,161
1999,Orleans,LA,22071,2657,1409,49,0,1199,57,12,45,0,0,2600,1397,4,1199
1999,Ouachita,LA,22073,990,442,3,0,545,38,26,3,0,9,952,416,0,536
1999,Plaquemines,LA,22075,78,63,2,0,13,5,3,2,0,0,73,60,0,13
1999,Pointe Coupee,LA,22077,79,59,0,0,20,0,0,0,0,0,79,59,0,20
1999,Rapides,LA,22079,803,342,5,1,455,50,23,5,1,21,753,319,0,434
1999,Red River,LA,22081,57,13,0,0,44,2,1,0,0,1,55,12,0,43
1999,Richland,LA,22083,148,73,0,2,73,13,9,0,2,2,135,64,0,71
1999,Sabine,LA,22085,135,36,0,0,99,5,4,0,0,1,130,32,0,98
1999,St. Bernard,LA,22087,318,256,1,0,61,2,1,1,0,0,316,255,0,61
1999,St. Charles,LA,22089,159,87,3,0,69,3,0,3,0,0,156,87,0,69
1999,St. Helena,LA,22091,16,7,0,0,9,0,0,0,0,0,16,7,0,9
1999,St. James,LA,22093,43,27,1,0,15,1,0,1,0,0,42,27,0,15
1999,St. John the Baptist,LA,22095,252,120,0,0,132,0,0,0,0,0,252,120,0,132
1999,St. Landry,LA,22097,332,204,2,0,126,9,8,1,0,0,323,196,1,126
1999,St. Martin,LA,22099,251,94,1,0,156,5,2,1,0,2,246,92,0,154
1999,St. Mary,LA,22101,281,153,1,0,127,5,3,1,0,1,276,150,0,126
1999,St. Tammany,LA,22103,740,568,14,0,158,27,13,14,0,0,713,555,0,158
1999,Tangipahoa,LA,22105,449,294,3,1,151,7,3,3,1,0,442,291,0,151
1999,Tensas,LA,22107,31,22,0,2,7,5,3,0,2,0,26,19,0,7
1999,Terrebonne,LA,22109,452,355,1,0,96,5,4,1,0,0,447,351,0,96
1999,Union,LA,22111,134,59,0,0,75,8,7,0,0,1,126,52,0,74
1999,Vermilion,LA,22113,208,136,0,1,71,5,3,0,1,1,203,133,0,70
1999,Vernon,LA,22115,387,191,5,0,191,22,12,5,0,5,365,179,0,186
1999,Washington,LA,22117,169,130,0,1,38,1,0,0,1,0,168,130,0,38
1999,Webster,LA,22119,375,105,1,1,268,7,3,1,1,2,368,102,0,266
1999,West Baton Rouge,LA,22121,104,80,0,0,24,0,0,0,0,0,104,80,0,24
1999,West Carroll,LA,22123,49,28,0,1,20,4,1,0,1,2,45,27,0,18
1999,West Feliciana,LA,22125,29,24,0,0,5,0,0,0,0,0,29,24,0,5
1999,Winn,LA,22127,83,40,0,0,43,7,2,0,0,5,76,38,0,38
1999,Androscoggin,ME,23001,411,375,0,0,36,19,14,0,0,5,392,361,0,31
1999,Aroostook,ME,23003,0,0,0,0,0,,,,,,,,,
1999,Cumberland,ME,23005,790,697,6,0,87,46,28,6,0,12,744,669,0,75
1999,Franklin,ME,23007,61,54,0,0,7,6,2,0,0,4,55,52,0,3
1999,Hancock,ME,23009,0,0,0,0,0,,,,,,,,,
1999,Kennebec,ME,23011,415,395,1,1,18,16,13,1,1,1,399,382,0,17
1999,Knox,ME,23013,0,0,0,0,0,,,,,,,,,
1999,Lincoln,ME,23015,0,0,0,0,0,,,,,,,,,
1999,Oxford,ME,23017,176,163,0,0,13,12,11,0,0,1,164,152,0,12
1999,Penobscot,ME,23019,507,504,0,0,3,16,15,0,0,1,491,489,0,2
1999,Piscataquis,ME,23021,64,63,0,0,1,3,2,0,0,1,61,61,0,0
1999,Sagadahoc,ME,23023,98,92,0,0,6,2,2,0,0,0,96,90,0,6
1999,Somerset,ME,23025,176,173,0,0,3,4,2,0,0,2,172,171,0,1
1999,Waldo,ME,23027,106,99,0,0,7,3,2,0,0,1,103,97,0,6
1999,Washington,ME,23029,125,123,0,0,2,2,2,0,0,0,123,121,0,2
1999,York,ME,23031,567,471,1,0,95,24,16,1,0,7,543,455,0,88
1999,Allegany,MD,24001,216,186,1,0,29,4,3,1,0,0,212,183,0,29
1999,Anne Arundel,MD,24003,2831,2173,6,0,652,85,64,6,0,15,2746,2109,0,637
1999,Baltimore,MD,24005,4504,3154,23,0,1327,103,55,21,0,27,4401,3099,2,1300
1999,Calvert,MD,24009,414,266,3,0,145,11,6,2,0,3,403,260,1,142
1999,Caroline,MD,24011,125,97,1,0,27,4,2,1,0,1,121,95,0,26
1999,Carroll,MD,24013,658,529,14,1,114,31,13,14,1,3,627,516,0,111
1999,Cecil,MD,24015,384,303,0,0,81,11,10,0,0,1,373,293,0,80
1999,Charles,MD,24017,900,585,6,0,309,31,20,6,0,5,869,565,0,304
1999,Dorchester,MD,24019,132,115,0,0,17,3,3,0,0,0,129,112,0,17
1999,Frederick,MD,24021,929,719,5,1,204,29,19,4,1,5,900,700,1,199
1999,Garrett,MD,24023,80,69,0,0,11,3,3,0,0,0,77,66,0,11
1999,Harford,MD,24025,1129,870,3,0,256,33,24,3,0,6,1096,846,0,250
1999,Howard,MD,24027,907,671,9,0,227,34,23,9,0,2,873,648,0,225
1999,Kent,MD,24029,74,59,0,0,15,2,2,0,0,0,72,57,0,15
1999,Montgomery,MD,24031,3675,2772,43,0,860,151,92,39,0,20,3524,2680,4,840
1999,Prince George's,MD,24033,8177,4855,49,0,3273,160,72,48,0,40,8017,4783,1,3233
1999,Queen Anne's,MD,24035,172,127,4,0,41,10,5,4,0,1,162,122,0,40
1999,St. Mary's,MD,24037,364,287,2,0,75,5,4,1,0,0,359,283,1,75
1999,Somerset,MD,24039,112,100,1,0,11,3,3,0,0,0,109,97,1,11
1999,Talbot,MD,24041,98,78,1,0,19,2,1,1,0,0,96,77,0,19
1999,Washington,MD,24043,632,555,3,0,74,11,8,2,0,1,621,547,1,73
1999,Wicomico,MD,24045,370,328,0,0,42,14,13,0,0,1,356,315,0,41
1999,Worcester,MD,24047,201,178,1,0,22,11,7,1,0,3,190,171,0,19
1999,Baltimore city,MD,24510,5373,3436,27,0,1910,95,55,24,0,16,5278,3381,3,1894
1999,Barnstable,MA,25001,774,661,10,0,103,25,14,10,0,1,749,647,0,102
1999,Berkshire,MA,25003,459,335,93,0,31,101,7,93,0,1,358,328,0,30
1999,Bristol,MA,25005,2143,1938,9,0,196,38,28,9,0,1,2105,1910,0,195
1999,Dukes,MA,25007,19,18,0,0,1,0,0,0,0,0,19,18,0,1
1999,Essex,MA,25009,1942,1641,18,1,282,55,35,18,1,1,1887,1606,0,281
1999,Franklin,MA,25011,206,188,0,0,18,4,3,0,0,1,202,185,0,17
1999,Hampden,MA,25013,1982,1749,8,0,225,50,28,8,0,14,1932,1721,0,211
1999,Hampshire,MA,25015,412,377,2,0,33,10,6,2,0,2,402,371,0,31
1999,Middlesex,MA,25017,3148,2755,46,0,347,126,75,46,0,5,3022,2680,0,342
1999,Nantucket,MA,25019,14,9,1,0,4,2,1,1,0,0,12,8,0,4
1999,Norfolk,MA,25021,1389,1134,16,0,239,51,32,16,0,3,1338,1102,0,236
1999,Plymouth,MA,25023,1594,1273,11,0,310,41,29,11,0,1,1553,1244,0,309
1999,Suffolk,MA,25025,1914,1574,36,0,304,64,25,36,0,3,1850,1549,0,301
1999,Worcester,MA,25027,2692,2339,18,0,335,75,48,18,0,9,2617,2291,0,326
1999,Alcona,MI,26001,41,39,0,0,2,0,0,0,0,0,41,39,0,2
1999,Alger,MI,26003,28,27,0,0,1,0,0,0,0,0,28,27,0,1
1999,Allegan,MI,26005,318,259,3,0,56,9,4,3,0,2,309,255,0,54
1999,Alpena,MI,26007,72,59,2,0,11,3,1,2,0,0,69,58,0,11
1999,Antrim,MI,26009,84,73,0,0,11,2,1,0,0,1,82,72,0,10
1999,Arenac,MI,26011,43,42,0,1,0,1,0,0,1,0,42,42,0,0
1999,Baraga,MI,26013,19,19,0,0,0,0,0,0,0,0,19,19,0,0
1999,Barry,MI,26015,171,122,2,0,47,5,3,2,0,0,166,119,0,47
1999,Bay,MI,26017,352,318,2,1,31,7,4,2,1,0,345,314,0,31
1999,Benzie,MI,26019,49,41,0,0,8,1,1,0,0,0,48,40,0,8
1999,Berrien,MI,26021,719,554,3,0,162,19,10,3,0,6,700,544,0,156
1999,Branch,MI,26023,116,102,0,0,14,2,2,0,0,0,114,100,0,14
1999,Calhoun,MI,26025,499,385,3,0,111,11,6,3,0,2,488,379,0,109
1999,Cass,MI,26027,194,173,0,1,20,3,2,0,1,0,191,171,0,20
1999,Charlevoix,MI,26029,74,66,0,0,8,0,0,0,0,0,74,66,0,8
1999,Cheboygan,MI,26031,78,74,2,0,2,2,1,1,0,0,76,73,1,2
1999,Chippewa,MI,26033,101,90,0,0,11,1,0,0,0,1,100,90,0,10
1999,Clare,MI,26035,116,111,0,0,5,2,1,0,0,1,114,110,0,4
1999,Clinton,MI,26037,193,154,0,1,38,8,6,0,1,1,185,148,0,37
1999,Crawford,MI,26039,43,41,0,0,2,2,2,0,0,0,41,39,0,2
1999,Delta,MI,26041,113,106,0,0,7,1,1,0,0,0,112,105,0,7
1999,Dickinson,MI,26043,149,143,0,0,6,0,0,0,0,0,149,143,0,6
1999,Eaton,MI,26045,334,289,0,1,44,4,2,0,1,1,330,287,0,43
1999,Emmet,MI,26047,87,79,0,0,8,2,1,0,0,1,85,78,0,7
1999,Genesee,MI,26049,1841,1359,20,0,462,27,7,20,0,0,1814,1352,0,462
1999,Gladwin,MI,26051,79,72,0,0,7,0,0,0,0,0,79,72,0,7
1999,Gogebic,MI,26053,47,46,0,0,1,0,0,0,0,0,47,46,0,1
1999,Grand Traverse,MI,26055,298,242,5,0,51,20,12,5,0,3,278,230,0,48
1999,Gratiot,MI,26057,142,132,1,0,9,3,2,0,0,1,139,130,1,8
1999,Hillsdale,MI,26059,156,149,0,0,7,1,1,0,0,0,155,148,0,7
1999,Houghton,MI,26061,59,56,2,0,1,2,0,2,0,0,57,56,0,1
1999,Huron,MI,26063,85,74,0,1,10,4,3,0,1,0,81,71,0,10
1999,Ingham,MI,26065,1010,822,5,0,183,24,17,5,0,2,986,805,0,181
1999,Ionia,MI,26067,176,137,1,0,38,4,3,1,0,0,172,134,0,38
1999,Iosco,MI,26069,98,89,0,0,9,2,2,0,0,0,96,87,0,9
1999,Iron,MI,26071,59,51,0,0,8,0,0,0,0,0,59,51,0,8
1999,Isabella,MI,26073,156,149,0,1,6,6,5,0,1,0,150,144,0,6
1999,Jackson,MI,26075,673,626,2,0,45,10,7,2,0,1,663,619,0,44
1999,Kalamazoo,MI,26077,848,702,0,0,146,10,7,0,0,3,838,695,0,143
1999,Kalkaska,MI,26079,64,58,1,0,5,2,1,1,0,0,62,57,0,5
1999,Kent,MI,26081,2139,1108,8,0,1023,55,36,8,0,11,2084,1072,0,1012
1999,Keweenaw,MI,26083,8,8,0,0,0,0,0,0,0,0,8,8,0,0
1999,Lake,MI,26085,31,25,0,0,6,2,0,0,0,2,29,25,0,4
1999,Lapeer,MI,26087,328,250,2,0,76,6,4,2,0,0,322,246,0,76
1999,Leelanau,MI,26089,33,25,0,0,8,1,1,0,0,0,32,24,0,8
1999,Lenawee,MI,26091,352,324,1,1,26,2,0,1,1,0,350,324,0,26
1999,Livingston,MI,26093,332,277,2,0,53,7,4,2,0,1,325,273,0,52
1999,Luce,MI,26095,17,16,0,0,1,0,0,0,0,0,17,16,0,1
1999,Mackinac,MI,26097,31,29,0,0,2,0,0,0,0,0,31,29,0,2
1999,Macomb,MI,26099,2760,2130,20,0,610,44,23,20,0,1,2716,2107,0,609
1999,Manistee,MI,26101,70,61,0,0,9,1,1,0,0,0,69,60,0,9
1999,Marquette,MI,26103,187,175,2,0,10,3,1,2,0,0,184,174,0,10
1999,Mason,MI,26105,72,66,0,0,6,3,2,0,0,1,69,64,0,5
1999,Mecosta,MI,26107,106,78,2,0,26,8,4,2,0,2,98,74,0,24
1999,Menominee,MI,26109,58,52,0,0,6,0,0,0,0,0,58,52,0,6
1999,Midland,MI,26111,221,197,1,1,22,7,4,1,1,1,214,193,0,21
1999,Missaukee,MI,26113,37,32,1,0,4,2,1,1,0,0,35,31,0,4
1999,Monroe,MI,26115,514,463,1,0,50,3,2,1,0,0,511,461,0,50
1999,Montcalm,MI,26117,249,172,1,3,73,9,2,1,3,3,240,170,0,70
1999,Montmorency,MI,26119,27,22,1,0,4,3,1,1,0,1,24,21,0,3
1999,Muskegon,MI,26121,740,362,6,0,372,13,4,6,0,3,727,358,0,369
1999,Newaygo,MI,26123,151,85,1,1,64,5,3,1,1,0,146,82,0,64
1999,Oakland,MI,26125,3619,2597,58,0,964,105,47,55,0,3,3514,2550,3,961
1999,Oceana,MI,26127,77,49,0,0,28,0,0,0,0,0,77,49,0,28
1999,Ogemaw,MI,26129,58,52,0,0,6,2,1,0,0,1,56,51,0,5
1999,Ontonagon,MI,26131,22,21,0,0,1,2,2,0,0,0,20,19,0,1
1999,Osceola,MI,26133,56,48,1,0,7,2,1,1,0,0,54,47,0,7
1999,Oscoda,MI,26135,39,35,0,0,4,0,0,0,0,0,39,35,0,4
1999,Otsego,MI,26137,97,87,1,0,9,3,2,1,0,0,94,85,0,9
1999,Ottawa,MI,26139,661,480,6,0,175,30,14,6,0,10,631,466,0,165
1999,Presque Isle,MI,26141,24,21,1,1,1,2,0,1,1,0,22,21,0,1
1999,Roscommon,MI,26143,91,82,1,0,8,4,3,1,0,0,87,79,0,8
1999,Saginaw,MI,26145,809,686,5,0,118,6,1,4,0,1,803,685,1,117
1999,St. Clair,MI,26147,542,478,2,0,62,4,3,1,0,0,538,475,1,62
1999,St. Joseph,MI,26149,259,224,1,0,34,3,2,1,0,0,256,222,0,34
1999,Sanilac,MI,26151,123,112,0,1,10,2,1,0,1,0,121,111,0,10
1999,Schoolcraft,MI,26153,29,28,1,0,0,1,0,1,0,0,28,28,0,0
1999,Shiawassee,MI,26155,256,216,0,0,40,3,3,0,0,0,253,213,0,40
1999,Tuscola,MI,26157,181,150,0,0,31,3,2,0,0,1,178,148,0,30
1999,Van Buren,MI,26159,341,297,0,2,42,9,4,0,2,3,332,293,0,39
1999,Washtenaw,MI,26161,894,726,3,0,165,14,10,3,0,1,880,716,0,164
1999,Wayne,MI,26163,10770,6372,29,0,4369,79,45,29,0,5,10691,6327,0,4364
1999,Wexford,MI,26165,130,110,1,0,19,2,1,1,0,0,128,109,0,19
1999,Aitkin,MN,27001,44,40,0,0,4,3,3,0,0,0,41,37,0,4
1999,Anoka,MN,27003,1259,984,3,0,272,119,95,3,0,21,1140,889,0,251
1999,Becker,MN,27005,69,63,0,0,6,7,5,0,0,2,62,58,0,4
1999,Beltrami,MN,27007,81,71,0,0,10,4,3,0,0,1,77,68,0,9
1999,Benton,MN,27009,80,61,0,0,19,5,4,0,0,1,75,57,0,18
1999,Big Stone,MN,27011,8,8,0,0,0,3,3,0,0,0,5,5,0,0
1999,Blue Earth,MN,27013,161,148,1,0,12,11,10,1,0,0,150,138,0,12
1999,Brown,MN,27015,64,62,0,0,2,9,9,0,0,0,55,53,0,2
1999,Carlton,MN,27017,100,86,0,0,14,4,4,0,0,0,96,82,0,14
1999,Carver,MN,27019,158,126,0,0,32,18,11,0,0,7,140,115,0,25
1999,Cass,MN,27021,56,46,0,0,10,2,1,0,0,1,54,45,0,9
1999,Chippewa,MN,27023,38,31,0,1,6,9,7,0,1,1,29,24,0,5
1999,Chisago,MN,27025,131,100,0,1,30,13,7,0,1,5,118,93,0,25
1999,Clay,MN,27027,117,110,0,0,7,10,8,0,0,2,107,102,0,5
1999,Clearwater,MN,27029,10,9,0,0,1,2,2,0,0,0,8,7,0,1
1999,Cook,MN,27031,9,8,0,0,1,0,0,0,0,0,9,8,0,1
1999,Cottonwood,MN,27033,33,32,0,0,1,5,5,0,0,0,28,27,0,1
1999,Crow Wing,MN,27035,167,142,0,0,25,10,5,0,0,5,157,137,0,20
1999,Dakota,MN,27037,1315,1047,2,0,266,107,89,2,0,16,1208,958,0,250
1999,Dodge,MN,27039,40,32,0,2,6,12,10,0,2,0,28,22,0,6
1999,Douglas,MN,27041,76,69,0,0,7,10,10,0,0,0,66,59,0,7
1999,Faribault,MN,27043,36,34,0,0,2,8,7,0,0,1,28,27,0,1
1999,Fillmore,MN,27045,34,33,0,0,1,6,6,0,0,0,28,27,0,1
1999,Freeborn,MN,27047,76,69,0,0,7,11,11,0,0,0,65,58,0,7
1999,Goodhue,MN,27049,143,109,0,0,34,9,7,0,0,2,134,102,0,32
1999,Grant,MN,27051,17,16,0,0,1,3,3,0,0,0,14,13,0,1
1999,Hennepin,MN,27053,4377,3135,32,0,1210,484,344,32,0,108,3893,2791,0,1102
1999,Houston,MN,27055,36,36,0,0,0,2,2,0,0,0,34,34,0,0
1999,Hubbard,MN,27057,47,43,0,0,4,5,4,0,0,1,42,39,0,3
1999,Isanti,MN,27059,139,110,0,0,29,20,17,0,0,3,119,93,0,26
1999,Itasca,MN,27061,119,109,0,0,10,8,7,0,0,1,111,102,0,9
1999,Jackson,MN,27063,26,24,0,0,2,9,8,0,0,1,17,16,0,1
1999,Kanabec,MN,27065,63,53,0,0,10,1,1,0,0,0,62,52,0,10
1999,Kandiyohi,MN,27067,101,83,0,2,16,20,16,0,2,2,81,67,0,14
1999,Kittson,MN,27069,5,4,0,1,0,2,1,0,1,0,3,3,0,0
1999,Koochiching,MN,27071,40,39,0,0,1,2,2,0,0,0,38,37,0,1
1999,Lac qui Parle,MN,27073,12,10,1,0,1,6,5,1,0,0,6,5,0,1
1999,Lake,MN,27075,34,29,0,0,5,3,1,0,0,2,31,28,0,3
1999,Lake of the Woods,MN,27077,9,8,0,1,0,3,2,0,1,0,6,6,0,0
1999,Le Sueur,MN,27079,69,56,0,0,13,12,12,0,0,0,57,44,0,13
1999,Lincoln,MN,27081,11,8,0,1,2,4,3,0,1,0,7,5,0,2
1999,Lyon,MN,27083,47,43,0,1,3,9,8,0,1,0,38,35,0,3
1999,McLeod,MN,27085,101,82,1,0,18,13,9,1,0,3,88,73,0,15
1999,Mahnomen,MN,27087,10,7,0,0,3,4,2,0,0,2,6,5,0,1
1999,Marshall,MN,27089,32,29,0,1,2,8,7,0,1,0,24,22,0,2
1999,Martin,MN,27091,48,43,0,1,4,5,3,0,1,1,43,40,0,3
1999,Meeker,MN,27093,50,39,0,0,11,5,4,0,0,1,45,35,0,10
1999,Mille Lacs,MN,27095,97,71,0,0,26,14,12,0,0,2,83,59,0,24
1999,Morrison,MN,27097,60,48,0,0,12,7,5,0,0,2,53,43,0,10
1999,Mower,MN,27099,99,76,0,1,22,15,13,0,1,1,84,63,0,21
1999,Murray,MN,27101,13,12,0,0,1,4,4,0,0,0,9,8,0,1
1999,Nicollet,MN,27103,30,26,0,1,3,5,4,0,1,0,25,22,0,3
1999,Nobles,MN,27105,38,37,0,0,1,9,9,0,0,0,29,28,0,1
1999,Norman,MN,27107,14,12,0,0,2,2,2,0,0,0,12,10,0,2
1999,Olmsted,MN,27109,240,211,0,0,29,16,15,0,0,1,224,196,0,28
1999,Otter Tail,MN,27111,96,86,0,0,10,11,9,0,0,2,85,77,0,8
1999,Pennington,MN,27113,39,36,0,0,3,4,4,0,0,0,35,32,0,3
1999,Pine,MN,27115,101,82,0,0,19,4,4,0,0,0,97,78,0,19
1999,Pipestone,MN,27117,13,13,0,0,0,3,3,0,0,0,10,10,0,0
1999,Polk,MN,27119,73,66,1,2,4,11,8,1,2,0,62,58,0,4
1999,Pope,MN,27121,19,16,0,1,2,4,3,0,1,0,15,13,0,2
1999,Ramsey,MN,27123,2083,1564,3,0,516,133,105,3,0,25,1950,1459,0,491
1999,Red Lake,MN,27125,11,11,0,0,0,0,0,0,0,0,11,11,0,0
1999,Redwood,MN,27127,32,27,0,0,5,4,4,0,0,0,28,23,0,5
1999,Renville,MN,27129,40,29,1,2,8,11,7,1,2,1,29,22,0,7
1999,Rice,MN,27131,163,123,0,0,40,16,11,0,0,5,147,112,0,35
1999,Rock,MN,27133,19,19,0,0,0,1,1,0,0,0,18,18,0,0
1999,Roseau,MN,27135,48,45,0,0,3,2,2,0,0,0,46,43,0,3
1999,St. Louis,MN,27137,652,567,2,0,83,42,29,2,0,11,610,538,0,72
1999,Scott,MN,27139,256,190,1,0,65,28,20,1,0,7,228,170,0,58
1999,Sherburne,MN,27141,237,180,0,0,57,27,21,0,0,6,210,159,0,51
1999,Sibley,MN,27143,31,26,0,0,5,3,3,0,0,0,28,23,0,5
1999,Stearns,MN,27145,315,251,1,2,61,40,27,1,2,10,275,224,0,51
1999,Steele,MN,27147,83,64,0,0,19,9,7,0,0,2,74,57,0,17
1999,Stevens,MN,27149,11,11,0,0,0,2,2,0,0,0,9,9,0,0
1999,Swift,MN,27151,25,21,0,1,3,4,3,0,1,0,21,18,0,3
1999,Todd,MN,27153,57,55,0,0,2,4,4,0,0,0,53,51,0,2
1999,Traverse,MN,27155,11,11,0,0,0,3,3,0,0,0,8,8,0,0
1999,Wabasha,MN,27157,36,29,0,0,7,4,4,0,0,0,32,25,0,7
1999,Wadena,MN,27159,29,27,0,1,1,5,4,0,1,0,24,23,0,1
1999,Waseca,MN,27161,53,46,0,0,7,1,1,0,0,0,52,45,0,7
1999,Washington,MN,27163,617,475,2,0,140,56,42,2,0,12,561,433,0,128
1999,Watonwan,MN,27165,27,24,0,0,3,7,7,0,0,0,20,17,0,3
1999,Wilkin,MN,27167,20,20,0,0,0,2,2,0,0,0,18,18,0,0
1999,Winona,MN,27169,88,85,0,0,3,9,9,0,0,0,79,76,0,3
1999,Wright,MN,27171,268,227,2,0,39,43,35,2,0,6,225,192,0,33
1999,Yellow Medicine,MN,27173,18,15,0,0,3,3,3,0,0,0,15,12,0,3
1999,Adams,MS,28001,203,140,0,0,63,3,3,0,0,0,200,137,0,63
1999,Alcorn,MS,28003,218,181,2,0,35,10,7,2,0,1,208,174,0,34
1999,Amite,MS,28005,63,34,0,0,29,0,0,0,0,0,63,34,0,29
1999,Attala,MS,28007,109,47,0,0,62,0,0,0,0,0,109,47,0,62
1999,Benton,MS,28009,66,19,0,1,46,1,0,0,1,0,65,19,0,46
1999,Bolivar,MS,28011,209,105,3,5,96,12,2,3,5,2,197,103,0,94
1999,Calhoun,MS,28013,101,62,2,1,36,3,0,2,1,0,98,62,0,36
1999,Carroll,MS,28015,46,28,0,0,18,0,0,0,0,0,46,28,0,18
1999,Chickasaw,MS,28017,126,83,1,2,40,6,3,1,2,0,120,80,0,40
1999,Choctaw,MS,28019,59,21,0,0,38,1,0,0,0,1,58,21,0,37
1999,Claiborne,MS,28021,66,37,1,0,28,1,0,1,0,0,65,37,0,28
1999,Clarke,MS,28023,115,53,0,0,62,0,0,0,0,0,115,53,0,62
1999,Clay,MS,28025,136,64,0,0,72,0,0,0,0,0,136,64,0,72
1999,Coahoma,MS,28027,242,111,1,0,130,4,2,1,0,1,238,109,0,129
1999,Copiah,MS,28029,283,138,1,0,144,1,0,1,0,0,282,138,0,144
1999,Covington,MS,28031,138,55,0,0,83,0,0,0,0,0,138,55,0,83
1999,De Soto,MS,28033,963,496,2,0,465,11,9,1,0,1,952,487,1,464
1999,Forrest,MS,28035,430,270,4,0,156,8,4,4,0,0,422,266,0,156
1999,Franklin,MS,28037,39,22,0,0,17,0,0,0,0,0,39,22,0,17
1999,George,MS,28039,116,63,0,0,53,0,0,0,0,0,116,63,0,53
1999,Greene,MS,28041,43,35,0,0,8,0,0,0,0,0,43,35,0,8
1999,Grenada,MS,28043,173,109,0,2,62,3,1,0,2,0,170,108,0,62
1999,Hancock,MS,28045,202,143,1,0,58,2,1,0,0,1,200,142,1,57
1999,Harrison,MS,28047,1298,950,20,0,328,18,3,15,0,0,1280,947,5,328
1999,Hinds,MS,28049,2348,1153,19,0,1176,32,13,19,0,0,2316,1140,0,1176
1999,Holmes,MS,28051,165,55,0,0,110,1,1,0,0,0,164,54,0,110
1999,Humphreys,MS,28053,61,27,4,1,29,5,0,4,1,0,56,27,0,29
1999,Issaquena,MS,28055,4,4,0,0,0,0,0,0,0,0,4,4,0,0
1999,Itawamba,MS,28057,132,105,0,0,27,4,4,0,0,0,128,101,0,27
1999,Jackson,MS,28059,845,582,3,0,260,4,2,2,0,0,841,580,1,260
1999,Jasper,MS,28061,97,40,0,0,57,0,0,0,0,0,97,40,0,57
1999,Jefferson,MS,28063,37,21,0,0,16,0,0,0,0,0,37,21,0,16
1999,Jefferson Davis,MS,28065,83,29,0,0,54,0,0,0,0,0,83,29,0,54
1999,Jones,MS,28067,301,166,0,0,135,0,0,0,0,0,301,166,0,135
1999,Kemper,MS,28069,35,8,0,0,27,0,0,0,0,0,35,8,0,27
1999,Lafayette,MS,28071,167,81,1,0,85,1,0,1,0,0,166,81,0,85
1999,Lamar,MS,28073,198,134,0,0,64,0,0,0,0,0,198,134,0,64
1999,Lauderdale,MS,28075,505,267,6,0,232,6,1,5,0,0,499,266,1,232
1999,Lawrence,MS,28077,103,62,0,0,41,0,0,0,0,0,103,62,0,41
1999,Leake,MS,28079,147,76,0,1,70,1,0,0,1,0,146,76,0,70
1999,Lee,MS,28081,498,360,4,0,134,19,12,4,0,3,479,348,0,131
1999,Leflore,MS,28083,207,118,3,0,86,6,3,3,0,0,201,115,0,86
1999,Lincoln,MS,28085,219,144,0,0,75,0,0,0,0,0,219,144,0,75
1999,Lowndes,MS,28087,386,203,0,0,183,5,2,0,0,3,381,201,0,180
1999,Madison,MS,28089,388,228,3,0,157,4,1,3,0,0,384,227,0,157
1999,Marion,MS,28091,159,99,0,0,60,1,1,0,0,0,158,98,0,60
1999,Marshall,MS,28093,348,100,0,4,244,4,0,0,4,0,344,100,0,244
1999,Monroe,MS,28095,262,151,0,0,111,1,1,0,0,0,261,150,0,111
1999,Montgomery,MS,28097,79,32,0,0,47,0,0,0,0,0,79,32,0,47
1999,Neshoba,MS,28099,128,87,0,0,41,1,1,0,0,0,127,86,0,41
1999,Newton,MS,28101,143,73,0,0,70,0,0,0,0,0,143,73,0,70
1999,Noxubee,MS,28103,74,30,1,0,43,1,0,1,0,0,73,30,0,43
1999,Oktibbeha,MS,28105,185,80,0,0,105,2,2,0,0,0,183,78,0,105
1999,Panola,MS,28107,306,124,1,1,180,6,3,1,1,1,300,121,0,179
1999,Pearl River,MS,28109,246,156,0,0,90,2,2,0,0,0,244,154,0,90
1999,Perry,MS,28111,79,47,0,0,32,1,1,0,0,0,78,46,0,32
1999,Pike,MS,28113,308,180,0,0,128,0,0,0,0,0,308,180,0,128
1999,Pontotoc,MS,28115,137,89,2,0,46,5,2,2,0,1,132,87,0,45
1999,Prentiss,MS,28117,136,106,1,0,29,3,1,1,0,1,133,105,0,28
1999,Quitman,MS,28119,68,30,0,0,38,0,0,0,0,0,68,30,0,38
1999,Rankin,MS,28121,827,537,3,0,287,9,6,3,0,0,818,531,0,287
1999,Scott,MS,28123,217,100,0,0,117,0,0,0,0,0,217,100,0,117
1999,Sharkey,MS,28125,25,17,0,2,6,2,0,0,2,0,23,17,0,6
1999,Simpson,MS,28127,189,101,1,0,87,1,0,1,0,0,188,101,0,87
1999,Smith,MS,28129,82,36,0,0,46,0,0,0,0,0,82,36,0,46
1999,Stone,MS,28131,77,59,1,0,17,0,0,0,0,0,77,59,1,17
1999,Sunflower,MS,28133,154,79,1,1,73,3,0,1,1,1,151,79,0,72
1999,Tallahatchie,MS,28135,101,41,0,2,58,2,0,0,2,0,99,41,0,58
1999,Tate,MS,28137,183,89,0,0,94,3,3,0,0,0,180,86,0,94
1999,Tippah,MS,28139,111,83,0,1,27,1,0,0,1,0,110,83,0,27
1999,Tishomingo,MS,28141,116,101,0,0,15,1,1,0,0,0,115,100,0,15
1999,Tunica,MS,28143,65,29,0,0,36,0,0,0,0,0,65,29,0,36
1999,Union,MS,28145,144,110,0,0,34,2,2,0,0,0,142,108,0,34
1999,Walthall,MS,28147,86,55,0,0,31,0,0,0,0,0,86,55,0,31
1999,Warren,MS,28149,414,262,2,0,150,4,2,2,0,0,410,260,0,150
1999,Washington,MS,28151,549,362,3,3,181,11,4,2,3,2,538,358,1,179
1999,Wayne,MS,28153,101,43,0,0,58,0,0,0,0,0,101,43,0,58
1999,Webster,MS,28155,68,42,0,0,26,2,2,0,0,0,66,40,0,26
1999,Wilkinson,MS,28157,47,34,0,0,13,0,0,0,0,0,47,34,0,13
1999,Winston,MS,28159,94,51,2,0,41,4,1,2,0,1,90,50,0,40
1999,Yalobusha,MS,28161,92,52,1,0,39,2,1,1,0,0,90,51,0,39
1999,Yazoo,MS,28163,177,92,0,0,85,1,0,0,0,1,176,92,0,84
1999,Adair,MO,29001,57,53,0,0,4,4,4,0,0,0,53,49,0,4
1999,Andrew,MO,29003,32,31,0,0,1,0,0,0,0,0,32,31,0,1
1999,Atchison,MO,29005,18,18,0,0,0,0,0,0,0,0,18,18,0,0
1999,Audrain,MO,29007,94,85,0,0,9,1,1,0,0,0,93,84,0,9
1999,Barry,MO,29009,96,90,0,1,5,1,0,0,1,0,95,90,0,5
1999,Barton,MO,29011,25,24,0,0,1,0,0,0,0,0,25,24,0,1
1999,Bates,MO,29013,43,35,1,0,7,1,0,1,0,0,42,35,0,7
1999,Benton,MO,29015,56,54,0,0,2,1,1,0,0,0,55,53,0,2
1999,Bollinger,MO,29017,29,27,0,0,2,2,2,0,0,0,27,25,0,2
1999,Boone,MO,29019,421,380,2,0,39,4,2,2,0,0,417,378,0,39
1999,Buchanan,MO,29021,326,290,5,0,31,7,1,5,0,1,319,289,0,30
1999,Butler,MO,29023,217,210,0,0,7,8,8,0,0,0,209,202,0,7
1999,Caldwell,MO,29025,39,30,0,2,7,3,1,0,2,0,36,29,0,7
1999,Callaway,MO,29027,164,149,0,0,15,1,1,0,0,0,163,148,0,15
1999,Camden,MO,29029,120,113,2,0,5,2,0,2,0,0,118,113,0,5
1999,Cape Girardeau,MO,29031,219,204,0,0,15,4,4,0,0,0,215,200,0,15
1999,Carroll,MO,29033,14,14,0,0,0,0,0,0,0,0,14,14,0,0
1999,Carter,MO,29035,16,15,0,0,1,0,0,0,0,0,16,15,0,1
1999,Cass,MO,29037,339,290,0,0,49,3,3,0,0,0,336,287,0,49
1999,Cedar,MO,29039,55,48,0,0,7,0,0,0,0,0,55,48,0,7
1999,Chariton,MO,29041,13,12,0,0,1,0,0,0,0,0,13,12,0,1
1999,Christian,MO,29043,256,228,1,0,27,4,3,1,0,0,252,225,0,27
1999,Clark,MO,29045,18,13,0,0,5,0,0,0,0,0,18,13,0,5
1999,Clay,MO,29047,798,636,1,0,161,8,6,1,0,1,790,630,0,160
1999,Clinton,MO,29049,70,59,0,0,11,0,0,0,0,0,70,59,0,11
1999,Cole,MO,29051,259,240,0,0,19,3,2,0,0,1,256,238,0,18
1999,Cooper,MO,29053,54,46,0,1,7,1,0,0,1,0,53,46,0,7
1999,Crawford,MO,29055,73,59,0,0,14,0,0,0,0,0,73,59,0,14
1999,Dade,MO,29057,18,14,1,0,3,1,0,1,0,0,17,14,0,3
1999,Dallas,MO,29059,29,26,1,0,2,1,0,1,0,0,28,26,0,2
1999,Daviess,MO,29061,17,14,0,0,3,3,2,0,0,1,14,12,0,2
1999,DeKalb,MO,29063,29,27,0,0,2,0,0,0,0,0,29,27,0,2
1999,Dent,MO,29065,53,49,0,0,4,1,1,0,0,0,52,48,0,4
1999,Douglas,MO,29067,31,29,0,0,2,0,0,0,0,0,31,29,0,2
1999,Dunklin,MO,29069,151,150,0,0,1,8,8,0,0,0,143,142,0,1
1999,Franklin,MO,29071,394,280,0,0,114,1,1,0,0,0,393,279,0,114
1999,Gasconade,MO,29073,40,34,0,0,6,1,1,0,0,0,39,33,0,6
1999,Gentry,MO,29075,23,22,0,0,1,1,1,0,0,0,22,21,0,1
1999,Greene,MO,29077,1006,903,9,0,94,17,7,9,0,1,989,896,0,93
1999,Grundy,MO,29079,25,22,0,0,3,1,1,0,0,0,24,21,0,3
1999,Harrison,MO,29081,25,23,0,1,1,1,0,0,1,0,24,23,0,1
1999,Henry,MO,29083,59,57,0,0,2,0,0,0,0,0,59,57,0,2
1999,Hickory,MO,29085,25,23,0,0,2,0,0,0,0,0,25,23,0,2
1999,Holt,MO,29087,17,16,0,0,1,0,0,0,0,0,17,16,0,1
1999,Howard,MO,29089,26,24,0,0,2,0,0,0,0,0,26,24,0,2
1999,Howell,MO,29091,103,88,3,0,12,3,0,2,0,1,100,88,1,11
1999,Iron,MO,29093,37,32,0,0,5,0,0,0,0,0,37,32,0,5
1999,Jackson,MO,29095,3344,2368,15,0,961,39,20,15,0,4,3305,2348,0,957
1999,Jasper,MO,29097,431,396,4,1,30,8,2,4,1,1,423,394,0,29
1999,Jefferson,MO,29099,1293,860,1,0,432,11,7,1,0,3,1282,853,0,429
1999,Johnson,MO,29101,156,139,0,0,17,3,3,0,0,0,153,136,0,17
1999,Knox,MO,29103,9,6,0,1,2,2,0,0,1,1,7,6,0,1
1999,Laclede,MO,29105,138,127,0,0,11,0,0,0,0,0,138,127,0,11
1999,Lafayette,MO,29107,110,94,0,1,15,4,0,0,1,3,106,94,0,12
1999,Lawrence,MO,29109,139,129,0,0,10,1,0,0,0,1,138,129,0,9
1999,Lewis,MO,29111,24,24,0,0,0,0,0,0,0,0,24,24,0,0
1999,Lincoln,MO,29113,164,103,0,0,61,2,2,0,0,0,162,101,0,61
1999,Linn,MO,29115,30,26,0,0,4,0,0,0,0,0,30,26,0,4
1999,Livingston,MO,29117,44,38,0,0,6,0,0,0,0,0,44,38,0,6
1999,Macon,MO,29119,52,50,1,0,1,2,1,1,0,0,50,49,0,1
1999,Madison,MO,29121,37,35,1,0,1,1,0,1,0,0,36,35,0,1
1999,Maries,MO,29123,75,71,0,0,4,2,1,0,0,1,73,70,0,3
1999,Marion,MO,29125,15,14,0,0,1,0,0,0,0,0,15,14,0,1
1999,McDonald,MO,29127,126,115,0,1,10,3,2,0,1,0,123,113,0,10
1999,Mercer,MO,29129,0,0,0,0,0,,,,,,,,,
1999,Miller,MO,29131,98,95,0,0,3,0,0,0,0,0,98,95,0,3
1999,Mississippi,MO,29133,58,56,0,0,2,2,2,0,0,0,56,54,0,2
1999,Moniteau,MO,29135,49,48,0,0,1,0,0,0,0,0,49,48,0,1
1999,Monroe,MO,29137,27,23,0,0,4,2,0,0,0,2,25,23,0,2
1999,Montgomery,MO,29139,27,19,0,0,8,0,0,0,0,0,27,19,0,8
1999,Morgan,MO,29141,62,62,0,0,0,0,0,0,0,0,62,62,0,0
1999,New Madrid,MO,29143,80,79,0,1,0,5,4,0,1,0,75,75,0,0
1999,Newton,MO,29145,192,184,0,0,8,1,1,0,0,0,191,183,0,8
1999,Nodaway,MO,29147,41,38,0,1,2,2,1,0,1,0,39,37,0,2
1999,Oregon,MO,29149,29,26,0,0,3,1,1,0,0,0,28,25,0,3
1999,Osage,MO,29151,24,22,0,0,2,1,1,0,0,0,23,21,0,2
1999,Ozark,MO,29153,33,30,0,0,3,0,0,0,0,0,33,30,0,3
1999,Pemiscot,MO,29155,104,100,1,0,3,8,7,1,0,0,96,93,0,3
1999,Perry,MO,29157,61,48,0,1,12,2,0,0,1,1,59,48,0,11
1999,Pettis,MO,29159,138,129,0,1,8,1,0,0,1,0,137,129,0,8
1999,Phelps,MO,29161,131,120,0,0,11,3,3,0,0,0,128,117,0,11
1999,Pike,MO,29163,74,65,0,0,9,1,1,0,0,0,73,64,0,9
1999,Platte,MO,29165,259,217,0,0,42,4,4,0,0,0,255,213,0,42
1999,Polk,MO,29167,78,71,0,0,7,1,1,0,0,0,77,70,0,7
1999,Pulaski,MO,29169,112,102,1,0,9,3,1,1,0,1,109,101,0,8
1999,Putnam,MO,29171,7,6,1,0,0,1,0,1,0,0,6,6,0,0
1999,Ralls,MO,29173,22,19,0,0,3,0,0,0,0,0,22,19,0,3
1999,Randolph,MO,29175,88,73,0,0,15,0,0,0,0,0,88,73,0,15
1999,Ray,MO,29177,84,76,0,0,8,1,1,0,0,0,83,75,0,8
1999,Reynolds,MO,29179,9,8,0,0,1,1,1,0,0,0,8,7,0,1
1999,Ripley,MO,29181,67,65,1,0,1,4,3,0,0,1,63,62,1,0
1999,Saline,MO,29183,1369,864,1,0,504,12,12,0,0,0,1357,852,1,504
1999,Schuyler,MO,29185,11,10,0,0,1,0,0,0,0,0,11,10,0,1
1999,Scotland,MO,29186,47,20,1,0,26,1,0,1,0,0,46,20,0,26
1999,Scott,MO,29187,261,212,0,0,49,1,0,0,0,1,260,212,0,48
1999,Shannon,MO,29189,6618,3505,20,0,3093,77,40,19,0,18,6541,3465,1,3075
1999,Shelby,MO,29195,88,86,0,0,2,2,2,0,0,0,86,84,0,2
1999,St. Charles,MO,29197,15,13,0,1,1,1,0,0,1,0,14,13,0,1
1999,St. Clair,MO,29199,13,11,0,0,2,1,1,0,0,0,12,10,0,2
1999,St. Francois,MO,29201,201,182,0,0,19,6,6,0,0,0,195,176,0,19
1999,St. Louis city,MO,29203,11,10,0,0,1,1,0,0,0,1,10,10,0,0
1999,St. Louis,MO,29205,35,30,0,1,4,2,1,0,1,0,33,29,0,4
1999,Ste. Genevieve,MO,29207,177,173,1,0,3,10,9,1,0,0,167,164,0,3
1999,Stoddard,MO,29209,89,72,1,1,15,5,2,1,1,1,84,70,0,14
1999,Stone,MO,29211,7,7,0,0,0,0,0,0,0,0,7,7,0,0
1999,Sullivan,MO,29213,164,144,7,0,13,9,2,7,0,0,155,142,0,13
1999,Taney,MO,29215,52,50,0,0,2,0,0,0,0,0,52,50,0,2
1999,Texas,MO,29217,67,61,0,0,6,1,1,0,0,0,66,60,0,6
1999,Vernon,MO,29219,105,72,0,0,33,1,1,0,0,0,104,71,0,33
1999,Warren,MO,29221,87,69,0,0,18,0,0,0,0,0,87,69,0,18
1999,Washington,MO,29223,46,46,0,0,0,0,0,0,0,0,46,46,0,0
1999,Wayne,MO,29225,111,97,1,0,13,1,0,1,0,0,110,97,0,13
1999,Webster,MO,29227,10,9,0,0,1,0,0,0,0,0,10,9,0,1
1999,Worth,MO,29229,81,79,1,0,1,2,1,1,0,0,79,78,0,1
1999,Wright,MO,29510,3065,1704,15,0,1346,23,4,15,0,4,3042,1700,0,1342
1999,Beaverhead,MT,30001,30,28,0,0,2,0,0,0,0,0,30,28,0,2
1999,Big Horn,MT,30003,16,10,0,0,6,0,0,0,0,0,16,10,0,6
1999,Blaine,MT,30005,7,6,0,0,1,1,1,0,0,0,6,5,0,1
1999,Broadwater,MT,30007,20,19,0,0,1,1,1,0,0,0,19,18,0,1
1999,Carbon,MT,30009,32,22,0,0,10,1,1,0,0,0,31,21,0,10
1999,Carter,MT,30011,2,1,0,0,1,0,0,0,0,0,2,1,0,1
1999,Cascade,MT,30013,400,328,5,0,67,9,3,5,0,1,391,325,0,66
1999,Chouteau,MT,30015,12,11,0,0,1,1,1,0,0,0,11,10,0,1
1999,Custer,MT,30017,45,35,0,0,10,3,2,0,0,1,42,33,0,9
1999,Daniels,MT,30019,6,5,0,0,1,1,1,0,0,0,5,4,0,1
1999,Dawson,MT,30021,18,14,0,0,4,0,0,0,0,0,18,14,0,4
1999,Deer Lodge,MT,30023,41,41,0,0,0,0,0,0,0,0,41,41,0,0
1999,Fallon,MT,30025,11,11,0,0,0,0,0,0,0,0,11,11,0,0
1999,Fergus,MT,30027,32,29,0,2,1,2,0,0,2,0,30,29,0,1
1999,Flathead,MT,30029,321,260,2,0,59,11,7,2,0,2,310,253,0,57
1999,Gallatin,MT,30031,234,227,1,0,6,9,8,1,0,0,225,219,0,6
1999,Garfield,MT,30033,1,0,0,0,1,0,0,0,0,0,1,0,0,1
1999,Glacier,MT,30035,19,17,0,0,2,0,0,0,0,0,19,17,0,2
1999,Golden Valley,MT,30037,0,0,0,0,0,,,,,,,,,
1999,Granite,MT,30039,9,7,0,0,2,0,0,0,0,0,9,7,0,2
1999,Hill,MT,30041,41,32,0,1,8,4,3,0,1,0,37,29,0,8
1999,Jefferson,MT,30043,28,24,0,0,4,0,0,0,0,0,28,24,0,4
1999,Judith Basin,MT,30045,6,5,0,0,1,0,0,0,0,0,6,5,0,1
1999,Lake,MT,30047,78,69,0,0,9,6,5,0,0,1,72,64,0,8
1999,Lewis and Clark,MT,30049,206,193,1,1,11,7,5,1,1,0,199,188,0,11
1999,Liberty,MT,30051,3,3,0,0,0,0,0,0,0,0,3,3,0,0
1999,Lincoln,MT,30053,64,57,0,0,7,4,3,0,0,1,60,54,0,6
1999,McCone,MT,30055,3,2,0,1,0,1,0,0,1,0,2,2,0,0
1999,Madison,MT,30057,18,18,0,0,0,3,3,0,0,0,15,15,0,0
1999,Meagher,MT,30059,6,6,0,0,0,0,0,0,0,0,6,6,0,0
1999,Mineral,MT,30061,18,12,0,0,6,1,1,0,0,0,17,11,0,6
1999,Missoula,MT,30063,411,363,4,0,44,13,8,4,0,1,398,355,0,43
1999,Musselshell,MT,30065,21,20,0,0,1,0,0,0,0,0,21,20,0,1
1999,Park,MT,30067,69,66,0,0,3,7,6,0,0,1,62,60,0,2
1999,Petroleum,MT,30069,0,0,0,0,0,,,,,,,,,
1999,Phillips,MT,30071,7,5,0,0,2,0,0,0,0,0,7,5,0,2
1999,Pondera,MT,30073,19,13,0,1,5,1,0,0,1,0,18,13,0,5
1999,Powder River,MT,30075,6,5,0,1,0,2,1,0,1,0,4,4,0,0
1999,Powell,MT,30077,22,21,0,0,1,1,1,0,0,0,21,20,0,1
1999,Prairie,MT,30079,0,0,0,0,0,,,,,,,,,
1999,Ravalli,MT,30081,160,139,1,0,20,9,9,0,0,0,151,130,1,20
1999,Richland,MT,30083,30,27,0,0,3,0,0,0,0,0,30,27,0,3
1999,Roosevelt,MT,30085,4,4,0,0,0,0,0,0,0,0,4,4,0,0
1999,Rosebud,MT,30087,18,15,0,0,3,1,1,0,0,0,17,14,0,3
1999,Sanders,MT,30089,35,28,1,1,5,2,1,0,1,0,33,27,1,5
1999,Sheridan,MT,30091,11,11,0,0,0,1,1,0,0,0,10,10,0,0
1999,Silver Bow,MT,30093,117,114,0,0,3,3,2,0,0,1,114,112,0,2
1999,Stillwater,MT,30095,27,19,0,1,7,1,0,0,1,0,26,19,0,7
1999,Sweet Grass,MT,30097,9,9,0,0,0,1,1,0,0,0,8,8,0,0
1999,Teton,MT,30099,19,14,1,0,4,1,0,1,0,0,18,14,0,4
1999,Toole,MT,30101,22,19,0,0,3,2,2,0,0,0,20,17,0,3
1999,Treasure,MT,30103,1,1,0,0,0,0,0,0,0,0,1,1,0,0
1999,Valley,MT,30105,19,14,0,0,5,1,1,0,0,0,18,13,0,5
1999,Wheatland,MT,30107,6,5,0,0,1,0,0,0,0,0,6,5,0,1
1999,Wibaux,MT,30109,3,2,0,0,1,1,0,0,0,1,2,2,0,0
1999,Yellowstone,MT,30111,594,466,2,0,126,14,12,2,0,0,580,454,0,126
1999,Adams,NE,31001,88,83,0,2,3,2,0,0,2,0,86,83,0,3
1999,Antelope,NE,31003,10,9,0,1,0,1,0,0,1,0,9,9,0,0
1999,Arthur,NE,31005,0,0,0,0,0,,,,,,,,,
1999,Banner,NE,31007,1,1,0,0,0,0,0,0,0,0,1,1,0,0
1999,Blaine,NE,31009,0,0,0,0,0,,,,,,,,,
1999,Boone,NE,31011,10,7,1,2,0,3,0,1,2,0,7,7,0,0
1999,Box Butte,NE,31013,54,49,0,0,5,0,0,0,0,0,54,49,0,5
1999,Boyd,NE,31015,2,1,0,1,0,1,0,0,1,0,1,1,0,0
1999,Brown,NE,31017,17,12,0,2,3,2,0,0,2,0,15,12,0,3
1999,Buffalo,NE,31019,124,116,0,4,4,5,1,0,4,0,119,115,0,4
1999,Burt,NE,31021,30,21,0,1,8,1,0,0,1,0,29,21,0,8
1999,Butler,NE,31023,18,12,0,0,6,0,0,0,0,0,18,12,0,6
1999,Cass,NE,31025,77,69,0,0,8,0,0,0,0,0,77,69,0,8
1999,Cedar,NE,31027,6,6,0,0,0,0,0,0,0,0,6,6,0,0
1999,Chase,NE,31029,10,8,0,0,2,0,0,0,0,0,10,8,0,2
1999,Cherry,NE,31031,14,11,0,2,1,2,0,0,2,0,12,11,0,1
1999,Cheyenne,NE,31033,29,23,0,1,5,1,0,0,1,0,28,23,0,5
1999,Clay,NE,31035,16,13,0,2,1,2,0,0,2,0,14,13,0,1
1999,Colfax,NE,31037,13,10,0,0,3,0,0,0,0,0,13,10,0,3
1999,Cuming,NE,31039,15,11,0,3,1,3,0,0,3,0,12,11,0,1
1999,Custer,NE,31041,32,24,0,5,3,6,0,0,5,1,26,24,0,2
1999,Dakota,NE,31043,66,66,0,0,0,1,1,0,0,0,65,65,0,0
1999,Dawes,NE,31045,15,15,0,0,0,0,0,0,0,0,15,15,0,0
1999,Dawson,NE,31047,83,79,0,2,2,2,0,0,2,0,81,79,0,2
1999,Deuel,NE,31049,7,6,0,0,1,1,0,0,0,1,6,6,0,0
1999,Dixon,NE,31051,22,21,0,0,1,0,0,0,0,0,22,21,0,1
1999,Dodge,NE,31053,147,119,2,0,26,3,1,2,0,0,144,118,0,26
1999,Douglas,NE,31055,1800,1393,8,1,398,22,13,8,1,0,1778,1380,0,398
1999,Dundy,NE,31057,3,2,1,0,0,0,0,0,0,0,3,2,1,0
1999,Fillmore,NE,31059,26,22,0,2,2,3,0,0,2,1,23,22,0,1
1999,Franklin,NE,31061,5,4,0,0,1,0,0,0,0,0,5,4,0,1
1999,Frontier,NE,31063,10,9,0,1,0,2,1,0,1,0,8,8,0,0
1999,Furnas,NE,31065,24,21,0,0,3,1,1,0,0,0,23,20,0,3
1999,Gage,NE,31067,110,95,0,1,14,2,0,0,1,1,108,95,0,13
1999,Garden,NE,31069,4,3,0,0,1,0,0,0,0,0,4,3,0,1
1999,Garfield,NE,31071,9,8,0,0,1,1,1,0,0,0,8,7,0,1
1999,Gosper,NE,31073,9,5,0,4,0,4,0,0,4,0,5,5,0,0
1999,Grant,NE,31075,0,0,0,0,0,,,,,,,,,
1999,Greeley,NE,31077,4,0,0,4,0,4,0,0,4,0,0,0,0,0
1999,Hall,NE,31079,216,201,3,4,8,7,1,2,4,0,209,200,1,8
1999,Hamilton,NE,31081,26,22,0,2,2,2,0,0,2,0,24,22,0,2
1999,Harlan,NE,31083,15,12,2,0,1,3,0,2,0,1,12,12,0,0
1999,Hayes,NE,31085,0,0,0,0,0,,,,,,,,,
1999,Hitchcock,NE,31087,6,4,0,2,0,2,0,0,2,0,4,4,0,0
1999,Holt,NE,31089,23,17,0,3,3,7,4,0,3,0,16,13,0,3
1999,Hooker,NE,31091,0,0,0,0,0,,,,,,,,,
1999,Howard,NE,31093,29,25,4,0,0,4,0,4,0,0,25,25,0,0
1999,Jefferson,NE,31095,28,25,0,1,2,2,0,0,1,1,26,25,0,1
1999,Johnson,NE,31097,15,15,0,0,0,0,0,0,0,0,15,15,0,0
1999,Kearney,NE,31099,21,20,0,0,1,0,0,0,0,0,21,20,0,1
1999,Keith,NE,31101,25,20,2,0,3,2,0,2,0,0,23,20,0,3
1999,Keya Paha,NE,31103,2,2,0,0,0,0,0,0,0,0,2,2,0,0
1999,Kimball,NE,31105,9,8,0,0,1,0,0,0,0,0,9,8,0,1
1999,Knox,NE,31107,20,13,0,6,1,6,0,0,6,0,14,13,0,1
1999,Lancaster,NE,31109,760,671,5,0,84,8,3,4,0,1,752,668,1,83
1999,Lincoln,NE,31111,132,112,1,1,18,2,0,1,1,0,130,112,0,18
1999,Logan,NE,31113,0,0,0,0,0,,,,,,,,,
1999,Loup,NE,31115,0,0,0,0,0,,,,,,,,,
1999,McPherson,NE,31117,0,0,0,0,0,,,,,,,,,
1999,Madison,NE,31119,105,103,1,0,1,1,0,1,0,0,104,103,0,1
1999,Merrick,NE,31121,28,26,0,1,1,1,0,0,1,0,27,26,0,1
1999,Morrill,NE,31123,22,17,1,3,1,4,1,0,3,0,18,16,1,1
1999,Nance,NE,31125,16,11,0,2,3,2,0,0,2,0,14,11,0,3
1999,Nemaha,NE,31127,25,20,0,1,4,1,0,0,1,0,24,20,0,4
1999,Nuckolls,NE,31129,6,6,0,0,0,0,0,0,0,0,6,6,0,0
1999,Otoe,NE,31131,43,38,0,0,5,0,0,0,0,0,43,38,0,5
1999,Pawnee,NE,31133,10,6,0,0,4,1,0,0,0,1,9,6,0,3
1999,Perkins,NE,31135,5,5,0,0,0,0,0,0,0,0,5,5,0,0
1999,Phelps,NE,31137,43,38,1,3,1,3,0,0,3,0,40,38,1,1
1999,Pierce,NE,31139,11,10,0,0,1,0,0,0,0,0,11,10,0,1
1999,Platte,NE,31141,76,61,0,1,14,2,0,0,1,1,74,61,0,13
1999,Polk,NE,31143,8,7,0,1,0,1,0,0,1,0,7,7,0,0
1999,Red Willow,NE,31145,40,37,0,1,2,2,1,0,1,0,38,36,0,2
1999,Richardson,NE,31147,42,38,0,0,4,0,0,0,0,0,42,38,0,4
1999,Rock,NE,31149,7,6,0,0,1,0,0,0,0,0,7,6,0,1
1999,Saline,NE,31151,42,40,1,0,1,2,1,1,0,0,40,39,0,1
1999,Sarpy,NE,31153,346,278,0,1,67,1,0,0,1,0,345,278,0,67
1999,Saunders,NE,31155,37,32,0,0,5,0,0,0,0,0,37,32,0,5
1999,Scotts Bluff,NE,31157,156,145,1,2,8,5,3,0,2,0,151,142,1,8
1999,Seward,NE,31159,38,29,0,3,6,4,1,0,3,0,34,28,0,6
1999,Sheridan,NE,31161,9,9,0,0,0,0,0,0,0,0,9,9,0,0
1999,Sherman,NE,31163,9,9,0,0,0,0,0,0,0,0,9,9,0,0
1999,Sioux,NE,31165,0,0,0,0,0,,,,,,,,,
1999,Stanton,NE,31167,19,19,0,0,0,0,0,0,0,0,19,19,0,0
1999,Thayer,NE,31169,23,19,0,0,4,0,0,0,0,0,23,19,0,4
1999,Thomas,NE,31171,2,2,0,0,0,0,0,0,0,0,2,2,0,0
1999,Thurston,NE,31173,13,12,0,0,1,0,0,0,0,0,13,12,0,1
1999,Valley,NE,31175,15,12,0,3,0,3,0,0,3,0,12,12,0,0
1999,Washington,NE,31177,59,43,0,0,16,1,1,0,0,0,58,42,0,16
1999,Wayne,NE,31179,17,14,0,0,3,0,0,0,0,0,17,14,0,3
1999,Webster,NE,31181,12,11,0,0,1,0,0,0,0,0,12,11,0,1
1999,Wheeler,NE,31183,2,2,0,0,0,0,0,0,0,0,2,2,0,0
1999,York,NE,31185,46,40,0,1,5,2,0,0,1,1,44,40,0,4
1999,Churchill,NV,32001,154,136,1,0,17,5,3,0,0,2,149,133,1,15
1999,Clark,NV,32003,10449,7135,84,0,3230,159,61,81,0,17,10290,7074,3,3213
1999,Douglas,NV,32005,190,166,1,0,23,4,3,1,0,0,186,163,0,23
1999,Elko,NV,32007,319,302,2,1,14,8,4,2,1,1,311,298,0,13
1999,Esmeralda,NV,32009,9,9,0,0,0,0,0,0,0,0,9,9,0,0
1999,Eureka,NV,32011,3,3,0,0,0,0,0,0,0,0,3,3,0,0
1999,Humboldt,NV,32013,141,135,0,1,5,2,1,0,1,0,139,134,0,5
1999,Lander,NV,32015,52,48,0,0,4,0,0,0,0,0,52,48,0,4
1999,Lincoln,NV,32017,14,11,0,1,2,1,0,0,1,0,13,11,0,2
1999,Lyon,NV,32019,245,201,4,0,40,8,4,4,0,0,237,197,0,40
1999,Mineral,NV,32021,29,25,0,0,4,1,0,0,0,1,28,25,0,3
1999,Nye,NV,32023,232,166,2,1,63,6,2,2,1,1,226,164,0,62
1999,Pershing,NV,32027,28,21,2,0,5,2,0,1,0,1,26,21,1,4
1999,Storey,NV,32029,5,4,0,0,1,0,0,0,0,0,5,4,0,1
1999,Washoe,NV,32031,2336,1937,15,0,384,86,57,13,0,16,2250,1880,2,368
1999,White Pine,NV,32033,59,58,0,1,0,2,1,0,1,0,57,57,0,0
1999,Carson City,NV,32510,394,333,5,0,56,19,13,3,0,3,375,320,2,53
1999,Belknap,NH,33001,216,195,0,0,21,11,9,0,0,2,205,186,0,19
1999,Carroll,NH,33003,123,111,4,0,8,16,10,4,0,2,107,101,0,6
1999,Cheshire,NH,33005,252,224,3,0,25,27,20,3,0,4,225,204,0,21
1999,Coos,NH,33007,113,104,0,0,9,11,11,0,0,0,102,93,0,9
1999,Grafton,NH,33009,269,242,0,1,26,24,20,0,1,3,245,222,0,23
1999,Hillsborough,NH,33011,1336,1249,15,0,72,112,93,15,0,3,1225,1156,0,69
1999,Merrimack,NH,33013,488,449,1,0,38,40,38,1,0,1,448,411,0,37
1999,Rockingham,NH,33015,869,790,9,0,70,74,62,9,0,3,795,728,0,67
1999,Strafford,NH,33017,291,278,0,0,13,24,23,0,0,1,267,255,0,12
1999,Sullivan,NH,33019,129,120,0,0,9,9,8,0,0,1,120,112,0,8
1999,Atlantic,NJ,34001,2192,1502,14,0,676,34,21,13,0,0,2158,1481,1,676
1999,Bergen,NJ,34003,2870,2297,58,0,515,96,52,44,0,0,2774,2245,14,515
1999,Burlington,NJ,34005,2807,1442,30,0,1335,39,12,27,0,0,2768,1430,3,1335
1999,Camden,NJ,34007,4169,1976,25,0,2168,59,35,23,0,0,4111,1941,2,2168
1999,Cape May,NJ,34009,608,438,5,0,165,8,3,5,0,0,600,435,0,165
1999,Cumberland,NJ,34011,1441,660,7,0,774,7,3,4,0,0,1434,657,3,774
1999,Essex,NJ,34013,3745,2480,54,0,1211,85,37,47,0,1,3660,2443,7,1210
1999,Gloucester,NJ,34015,1695,902,5,0,788,16,11,5,0,0,1679,891,0,788
1999,Hudson,NJ,34017,3133,2556,81,0,496,106,28,78,0,0,3027,2528,3,496
1999,Hunterdon,NJ,34019,306,237,9,0,60,12,4,8,0,0,294,233,1,60
1999,Mercer,NJ,34021,1656,988,23,0,645,41,18,22,0,1,1615,970,1,644
1999,Middlesex,NJ,34023,3012,2217,46,0,749,91,48,42,0,1,2921,2169,4,748
1999,Monmouth,NJ,34025,2746,1827,29,0,890,72,48,24,0,0,2674,1779,5,890
1999,Morris,NJ,34027,1164,913,29,0,222,53,26,27,0,0,1111,887,2,222
1999,Ocean,NJ,34029,2887,1957,20,0,910,42,27,15,0,0,2845,1930,5,910
1999,Passaic,NJ,34031,1962,1479,24,0,459,50,29,21,0,0,1912,1450,3,459
1999,Salem,NJ,34033,460,256,2,0,202,2,1,1,0,0,458,255,1,202
1999,Somerset,NJ,34035,644,474,13,0,157,21,11,10,0,0,623,463,3,157
1999,Sussex,NJ,34037,630,470,9,0,151,11,5,6,0,0,619,465,3,151
1999,Union,NJ,34039,2324,1658,33,0,633,63,31,31,0,1,2261,1627,2,632
1999,Warren,NJ,34041,454,318,5,1,130,16,10,5,1,0,438,308,0,130
1999,Bernalillo,NM,35001,2720,2129,202,0,389,373,139,200,0,34,2347,1990,2,355
1999,Catron,NM,35003,10,8,0,0,2,4,4,0,0,0,6,4,0,2
1999,Chaves,NM,35005,351,323,0,0,28,14,11,0,0,3,337,312,0,25
1999,Cibola,NM,35006,97,75,1,0,21,6,4,1,0,1,91,71,0,20
1999,Colfax,NM,35007,35,30,0,0,5,5,5,0,0,0,30,25,0,5
1999,Curry,NM,35009,214,183,1,0,30,19,16,1,0,2,195,167,0,28
1999,DeBaca,NM,35011,4,4,0,0,0,1,1,0,0,0,3,3,0,0
1999,Dona Ana,NM,35013,614,522,4,1,87,46,35,4,1,6,568,487,0,81
1999,Eddy,NM,35015,309,278,1,3,27,14,9,1,3,1,295,269,0,26
1999,Grant,NM,35017,105,81,0,0,24,2,2,0,0,0,103,79,0,24
1999,Guadalupe,NM,35019,11,9,0,0,2,0,0,0,0,0,11,9,0,2
1999,Harding,NM,35021,0,0,0,0,0,,,,,,,,,
1999,Hidalgo,NM,35023,26,21,0,0,5,1,1,0,0,0,25,20,0,5
1999,Lea,NM,35025,294,283,3,0,8,25,21,3,0,1,269,262,0,7
1999,Lincoln,NM,35027,65,59,1,0,5,4,4,0,0,0,61,55,1,5
1999,Los Alamos,NM,35028,17,15,0,0,2,1,0,0,0,1,16,15,0,1
1999,Luna,NM,35029,67,61,0,0,6,8,6,0,0,2,59,55,0,4
1999,McKinley,NM,35031,112,73,2,0,37,7,3,1,0,3,105,70,1,34
1999,Mora,NM,35033,9,7,0,0,2,0,0,0,0,0,9,7,0,2
1999,Otero,NM,35035,219,183,1,0,35,23,20,1,0,2,196,163,0,33
1999,Quay,NM,35037,19,16,0,0,3,1,1,0,0,0,18,15,0,3
1999,Rio Arriba,NM,35039,74,62,0,0,12,4,4,0,0,0,70,58,0,12
1999,Roosevelt,NM,35041,78,68,0,2,8,7,5,0,2,0,71,63,0,8
1999,Sandoval,NM,35043,395,333,0,0,62,28,24,0,0,4,367,309,0,58
1999,San Juan,NM,35045,420,373,2,0,45,43,38,2,0,3,377,335,0,42
1999,San Miguel,NM,35047,110,87,0,0,23,3,2,0,0,1,107,85,0,22
1999,Santa Fe,NM,35049,469,404,4,0,61,45,35,3,0,7,424,369,1,54
1999,Sierra,NM,35051,47,42,0,0,5,6,5,0,0,1,41,37,0,4
1999,Socorro,NM,35053,54,41,0,0,13,2,1,0,0,1,52,40,0,12
1999,Taos,NM,35055,66,55,1,0,10,12,8,1,0,3,54,47,0,7
1999,Torrance,NM,35057,56,45,0,0,11,4,3,0,0,1,52,42,0,10
1999,Union,NM,35059,10,8,0,1,1,1,0,0,1,0,9,8,0,1
1999,Valencia,NM,35061,359,294,1,0,64,21,18,1,0,2,338,276,0,62
1999,Albany,NY,36001,1328,925,4,0,399,26,17,3,0,6,1302,908,1,393
1999,Allegany,NY,36003,183,123,1,0,59,11,7,1,0,3,172,116,0,56
1999,Bronx,NY,36005,4240,3718,22,0,500,41,15,21,0,5,4199,3703,1,495
1999,Broome,NY,36007,728,615,6,1,106,43,27,5,1,10,685,588,1,96
1999,Cattaraugus,NY,36009,395,270,0,1,124,17,8,0,1,8,378,262,0,116
1999,Cayuga,NY,36011,339,287,0,1,51,13,8,0,1,4,326,279,0,47
1999,Chautauqua,NY,36013,676,432,8,2,234,42,14,7,2,19,634,418,1,215
1999,Chemung,NY,36015,325,287,0,0,38,15,11,0,0,4,310,276,0,34
1999,Chenango,NY,36017,199,178,0,0,21,6,2,0,0,4,193,176,0,17
1999,Clinton,NY,36019,280,259,3,0,18,7,3,3,0,1,273,256,0,17
1999,Columbia,NY,36021,216,175,2,1,38,3,1,1,1,0,213,174,1,38
1999,Cortland,NY,36023,175,146,0,1,28,9,5,0,1,3,166,141,0,25
1999,Delaware,NY,36025,132,106,2,0,24,8,4,2,0,2,124,102,0,22
1999,Dutchess,NY,36027,911,729,7,0,175,16,9,7,0,0,895,720,0,175
1999,Erie,NY,36029,4279,3044,20,0,1215,113,77,19,0,16,4167,2967,1,1199
1999,Essex,NY,36031,125,112,1,1,11,7,5,1,1,0,118,107,0,11
1999,Franklin,NY,36033,189,151,0,1,37,8,2,0,1,5,181,149,0,32
1999,Fulton,NY,36035,265,216,2,0,47,4,2,2,0,0,261,214,0,47
1999,Genesee,NY,36037,257,180,2,0,75,7,5,2,0,0,250,175,0,75
1999,Greene,NY,36039,187,154,1,0,32,6,2,0,0,4,181,152,1,28
1999,Hamilton,NY,36041,12,9,0,0,3,0,0,0,0,0,12,9,0,3
1999,Herkimer,NY,36043,330,298,0,0,32,5,3,0,0,2,325,295,0,30
1999,Jefferson,NY,36045,711,671,3,1,36,16,9,3,1,3,695,662,0,33
1999,Kings,NY,36047,6974,5786,63,0,1125,93,34,56,0,3,6881,5752,7,1122
1999,Lewis,NY,36049,89,84,0,1,4,4,3,0,1,0,85,81,0,4
1999,Livingston,NY,36051,197,167,0,0,30,14,11,0,0,3,183,156,0,27
1999,Madison,NY,36053,304,279,2,0,23,15,11,2,0,2,289,268,0,21
1999,Monroe,NY,36055,2417,1931,11,0,475,181,138,11,0,32,2236,1793,0,443
1999,Montgomery,NY,36057,246,195,1,0,50,7,4,1,0,2,239,191,0,48
1999,Nassau,NY,36059,3875,2756,93,0,1026,112,30,80,0,2,3763,2726,13,1024
1999,New York,NY,36061,4267,3720,284,0,263,391,119,265,0,6,3877,3601,19,257
1999,Niagara,NY,36063,1129,872,3,0,254,37,26,3,0,8,1092,846,0,246
1999,Oneida,NY,36065,1138,1056,1,0,81,34,30,0,0,4,1104,1026,1,77
1999,Onondaga,NY,36067,2222,1933,11,0,278,63,40,11,0,12,2159,1893,0,266
1999,Ontario,NY,36069,338,261,3,0,74,25,17,2,0,6,313,244,1,68
1999,Orange,NY,36071,1302,1117,12,0,173,23,12,11,0,0,1279,1105,1,173
1999,Orleans,NY,36073,167,132,0,0,35,6,5,0,0,1,161,127,0,34
1999,Oswego,NY,36075,724,658,2,0,64,8,6,2,0,0,716,652,0,64
1999,Otsego,NY,36077,176,155,1,1,19,3,1,1,1,0,173,154,0,19
1999,Putnam,NY,36079,237,207,4,0,26,4,0,4,0,0,233,207,0,26
1999,Queens,NY,36081,7812,6418,34,0,1360,84,52,30,0,2,7728,6366,4,1358
1999,Rensselaer,NY,36083,785,548,3,0,234,13,7,3,0,3,772,541,0,231
1999,Richmond,NY,36085,1446,1294,5,0,147,7,4,3,0,0,1439,1290,2,147
1999,Rockland,NY,36087,682,553,15,0,114,14,4,10,0,0,668,549,5,114
1999,St. Lawrence,NY,36089,549,495,1,3,50,15,8,1,3,3,534,487,0,47
1999,Saratoga,NY,36091,1047,806,4,0,237,16,10,3,0,3,1031,796,1,234
1999,Schenectady,NY,36093,742,564,2,0,176,19,11,2,0,6,723,553,0,170
1999,Schoharie,NY,36095,135,108,0,1,26,6,5,0,1,0,129,103,0,26
1999,Schuyler,NY,36097,50,45,0,0,5,5,3,0,0,2,45,42,0,3
1999,Seneca,NY,36099,96,83,1,0,12,7,3,1,0,3,89,80,0,9
1999,Steuben,NY,36101,309,270,3,0,36,16,11,2,0,3,293,259,1,33
1999,Suffolk,NY,36103,6235,4567,69,0,1599,92,28,62,0,2,6143,4539,7,1597
1999,Sullivan,NY,36105,307,269,2,0,36,7,5,2,0,0,300,264,0,36
1999,Tioga,NY,36107,169,138,0,0,31,6,2,0,0,4,163,136,0,27
1999,Tompkins,NY,36109,191,170,2,0,19,9,4,2,0,3,182,166,0,16
1999,Ulster,NY,36111,650,569,6,1,74,11,6,3,1,1,639,563,3,73
1999,Warren,NY,36113,368,307,1,0,60,10,7,1,0,2,358,300,0,58
1999,Washington,NY,36115,331,265,0,1,65,10,4,0,1,5,321,261,0,60
1999,Wayne,NY,36117,323,254,2,1,66,29,20,2,1,6,294,234,0,60
1999,Westchester,NY,36119,2355,1954,53,0,348,76,30,44,0,2,2279,1924,9,346
1999,Wyoming,NY,36121,146,111,2,1,32,8,4,2,1,1,138,107,0,31
1999,Yates,NY,36123,80,62,0,0,18,9,4,0,0,5,71,58,0,13
1999,Alamance,NC,37001,511,174,3,0,334,12,8,3,0,1,499,166,0,333
1999,Alexander,NC,37003,112,47,0,0,65,0,0,0,0,0,112,47,0,65
1999,Alleghany,NC,37005,20,16,0,0,4,0,0,0,0,0,20,16,0,4
1999,Anson,NC,37007,85,10,0,0,75,0,0,0,0,0,85,10,0,75
1999,Ashe,NC,37009,58,47,0,0,11,0,0,0,0,0,58,47,0,11
1999,Avery,NC,37011,30,24,0,0,6,0,0,0,0,0,30,24,0,6
1999,Beaufort,NC,37013,117,46,1,1,69,5,2,1,1,1,112,44,0,68
1999,Bertie,NC,37015,50,13,0,1,36,1,0,0,1,0,49,13,0,36
1999,Bladen,NC,37017,68,14,1,0,53,1,0,1,0,0,67,14,0,53
1999,Brunswick,NC,37019,166,103,1,0,62,6,4,0,0,2,160,99,1,60
1999,Buncombe,NC,37021,564,345,5,0,214,12,6,5,0,1,552,339,0,213
1999,Burke,NC,37023,212,82,0,0,130,0,0,0,0,0,212,82,0,130
1999,Cabarrus,NC,37025,276,151,2,0,123,3,1,2,0,0,273,150,0,123
1999,Caldwell,NC,37027,216,65,0,0,151,0,0,0,0,0,216,65,0,151
1999,Camden,NC,37029,16,14,0,0,2,0,0,0,0,0,16,14,0,2
1999,Carteret,NC,37031,174,130,0,0,44,1,0,0,0,1,173,130,0,43
1999,Caswell,NC,37033,91,31,0,0,60,2,2,0,0,0,89,29,0,60
1999,Catawba,NC,37035,385,152,3,0,230,3,0,3,0,0,382,152,0,230
1999,Chatham,NC,37037,166,28,1,0,137,3,2,1,0,0,163,26,0,137
1999,Cherokee,NC,37039,42,22,0,0,20,1,1,0,0,0,41,21,0,20
1999,Chowan,NC,37041,30,14,0,0,16,1,0,0,0,1,29,14,0,15
1999,Clay,NC,37043,10,6,0,0,4,0,0,0,0,0,10,6,0,4
1999,Cleveland,NC,37045,406,60,1,0,345,4,3,1,0,0,402,57,0,345
1999,Columbus,NC,37047,117,23,0,0,94,1,0,0,0,1,116,23,0,93
1999,Craven,NC,37049,352,209,2,4,137,12,5,2,4,1,340,204,0,136
1999,Cumberland,NC,37051,1610,831,5,0,774,27,16,4,0,7,1583,815,1,767
1999,Currituck,NC,37053,38,33,0,0,5,1,1,0,0,0,37,32,0,5
1999,Dare,NC,37055,66,56,0,0,10,5,4,0,0,1,61,52,0,9
1999,Davidson,NC,37057,413,177,0,0,236,2,2,0,0,0,411,175,0,236
1999,Davie,NC,37059,94,52,0,0,42,0,0,0,0,0,94,52,0,42
1999,Duplin,NC,37061,148,45,4,0,99,10,3,4,0,3,138,42,0,96
1999,Durham,NC,37063,897,183,1,0,713,8,7,1,0,0,889,176,0,713
1999,Edgecombe,NC,37065,329,59,2,0,268,5,0,1,0,4,324,59,1,264
1999,Forsyth,NC,37067,851,384,5,0,462,10,6,4,0,0,841,378,1,462
1999,Franklin,NC,37069,228,70,1,0,157,9,4,1,0,4,219,66,0,153
1999,Gaston,NC,37071,753,231,1,0,521,6,5,1,0,0,747,226,0,521
1999,Gates,NC,37073,33,22,0,0,11,0,0,0,0,0,33,22,0,11
1999,Graham,NC,37075,17,9,0,0,8,0,0,0,0,0,17,9,0,8
1999,Granville,NC,37077,274,47,1,0,226,2,1,1,0,0,272,46,0,226
1999,Greene,NC,37079,49,15,0,0,34,1,1,0,0,0,48,14,0,34
1999,Guilford,NC,37081,1450,734,7,0,709,32,25,7,0,0,1418,709,0,709
1999,Halifax,NC,37083,179,60,1,0,118,5,1,1,0,3,174,59,0,115
1999,Harnett,NC,37085,371,123,2,0,246,9,7,2,0,0,362,116,0,246
1999,Haywood,NC,37087,116,59,0,0,57,0,0,0,0,0,116,59,0,57
1999,Henderson,NC,37089,191,123,5,0,63,10,5,5,0,0,181,118,0,63
1999,Hertford,NC,37091,39,11,1,0,27,2,1,1,0,0,37,10,0,27
1999,Hoke,NC,37093,186,35,0,0,151,1,1,0,0,0,185,34,0,151
1999,Hyde,NC,37095,6,4,0,0,2,0,0,0,0,0,6,4,0,2
1999,Iredell,NC,37097,417,179,0,0,238,0,0,0,0,0,417,179,0,238
1999,Jackson,NC,37099,41,26,0,1,14,1,0,0,1,0,40,26,0,14
1999,Johnston,NC,37101,396,176,2,3,215,13,7,2,3,1,383,169,0,214
1999,Jones,NC,37103,37,16,0,0,21,2,2,0,0,0,35,14,0,21
1999,Lee,NC,37105,249,34,0,0,215,0,0,0,0,0,249,34,0,215
1999,Lenoir,NC,37107,211,69,2,0,140,5,1,2,0,2,206,68,0,138
1999,Lincoln,NC,37109,224,65,0,0,159,1,1,0,0,0,223,64,0,159
1999,McDowell,NC,37111,142,43,0,0,99,3,3,0,0,0,139,40,0,99
1999,Macon,NC,37113,44,34,0,0,10,0,0,0,0,0,44,34,0,10
1999,Madison,NC,37115,48,22,1,0,25,1,0,1,0,0,47,22,0,25
1999,Martin,NC,37117,70,30,1,0,39,2,0,1,0,1,68,30,0,38
1999,Mecklenburg,NC,37119,1709,939,9,0,761,27,17,9,0,1,1682,922,0,760
1999,Mitchell,NC,37121,37,23,0,0,14,0,0,0,0,0,37,23,0,14
1999,Montgomery,NC,37123,84,30,0,0,54,2,1,0,0,1,82,29,0,53
1999,Moore,NC,37125,266,62,0,0,204,5,4,0,0,1,261,58,0,203
1999,Nash,NC,37127,363,102,2,0,259,12,3,1,0,8,351,99,1,251
1999,New Hanover,NC,37129,382,251,5,0,126,20,10,5,0,5,362,241,0,121
1999,Northampton,NC,37131,59,12,0,0,47,0,0,0,0,0,59,12,0,47
1999,Onslow,NC,37133,600,243,1,0,356,9,3,1,0,5,591,240,0,351
1999,Orange,NC,37135,287,93,0,0,194,7,7,0,0,0,280,86,0,194
1999,Pamlico,NC,37137,23,11,0,0,12,0,0,0,0,0,23,11,0,12
1999,Pasquotank,NC,37139,96,87,1,0,8,4,3,1,0,0,92,84,0,8
1999,Pender,NC,37141,127,57,0,1,69,6,4,0,1,1,121,53,0,68
1999,Perquimans,NC,37143,20,16,0,1,3,1,0,0,1,0,19,16,0,3
1999,Person,NC,37145,184,29,0,0,155,0,0,0,0,0,184,29,0,155
1999,Pitt,NC,37147,394,150,1,0,243,10,5,1,0,4,384,145,0,239
1999,Polk,NC,37149,33,18,0,0,15,0,0,0,0,0,33,18,0,15
1999,Randolph,NC,37151,495,228,1,0,266,9,8,1,0,0,486,220,0,266
1999,Richmond,NC,37153,160,24,0,0,136,2,2,0,0,0,158,22,0,136
1999,Robeson,NC,37155,368,87,4,0,277,10,2,4,0,4,358,85,0,273
1999,Rockingham,NC,37157,373,167,1,1,204,8,6,1,1,0,365,161,0,204
1999,Rowan,NC,37159,335,160,1,0,174,3,2,1,0,0,332,158,0,174
1999,Rutherford,NC,37161,183,64,2,0,117,1,0,1,0,0,182,64,1,117
1999,Sampson,NC,37163,214,75,1,0,138,7,4,1,0,2,207,71,0,136
1999,Scotland,NC,37165,182,30,3,0,149,4,0,3,0,1,178,30,0,148
1999,Stanly,NC,37167,151,66,2,0,83,2,0,2,0,0,149,66,0,83
1999,Stokes,NC,37169,135,56,0,0,79,4,4,0,0,0,131,52,0,79
1999,Surry,NC,37171,186,61,0,0,125,1,1,0,0,0,185,60,0,125
1999,Swain,NC,37173,16,9,0,0,7,1,0,0,0,1,15,9,0,6
1999,Transylvania,NC,37175,62,32,1,1,28,2,0,1,1,0,60,32,0,28
1999,Tyrrell,NC,37177,10,8,0,0,2,0,0,0,0,0,10,8,0,2
1999,Union,NC,37179,310,125,1,0,184,4,3,1,0,0,306,122,0,184
1999,Vance,NC,37181,291,22,0,0,269,6,2,0,0,4,285,20,0,265
1999,Wake,NC,37183,1688,918,10,0,760,53,37,10,0,6,1635,881,0,754
1999,Warren,NC,37185,93,11,0,0,82,0,0,0,0,0,93,11,0,82
1999,Washington,NC,37187,41,16,0,0,25,0,0,0,0,0,41,16,0,25
1999,Watauga,NC,37189,69,59,0,0,10,0,0,0,0,0,69,59,0,10
1999,Wayne,NC,37191,517,180,0,0,337,10,3,0,0,7,507,177,0,330
1999,Wilkes,NC,37193,189,117,0,0,72,1,1,0,0,0,188,116,0,72
1999,Wilson,NC,37195,305,113,1,0,191,5,2,1,0,2,300,111,0,189
1999,Yadkin,NC,37197,106,50,0,0,56,0,0,0,0,0,106,50,0,56
1999,Yancey,NC,37199,26,18,0,0,8,0,0,0,0,0,26,18,0,8
1999,Adams,ND,38001,15,13,0,1,1,1,0,0,1,0,14,13,0,1
1999,Barnes,ND,38003,30,29,0,1,0,2,1,0,1,0,28,28,0,0
1999,Benson,ND,38005,10,8,0,2,0,4,2,0,2,0,6,6,0,0
1999,Billings,ND,38007,0,0,0,0,0,,,,,,,,,
1999,Bottineau,ND,38009,19,16,0,3,0,4,1,0,3,0,15,15,0,0
1999,Bowman,ND,38011,7,7,0,0,0,0,0,0,0,0,7,7,0,0
1999,Burke,ND,38013,5,5,0,0,0,0,0,0,0,0,5,5,0,0
1999,Burleigh,ND,38015,271,259,4,1,7,13,8,4,1,0,258,251,0,7
1999,Cass,ND,38017,484,449,0,0,35,10,8,0,0,2,474,441,0,33
1999,Cavalier,ND,38019,11,11,0,0,0,0,0,0,0,0,11,11,0,0
1999,Dickey,ND,38021,9,8,0,0,1,0,0,0,0,0,9,8,0,1
1999,Divide,ND,38023,7,4,2,1,0,3,0,2,1,0,4,4,0,0
1999,Dunn,ND,38025,5,5,0,0,0,0,0,0,0,0,5,5,0,0
1999,Eddy,ND,38027,7,7,0,0,0,1,1,0,0,0,6,6,0,0
1999,Emmons,ND,38029,12,11,1,0,0,2,1,1,0,0,10,10,0,0
1999,Foster,ND,38031,5,5,0,0,0,1,1,0,0,0,4,4,0,0
1999,Golden Valley,ND,38033,1,0,0,1,0,1,0,0,1,0,0,0,0,0
1999,Grand Forks,ND,38035,269,260,1,0,8,3,2,1,0,0,266,258,0,8
1999,Grant,ND,38037,5,3,0,2,0,2,0,0,2,0,3,3,0,0
1999,Griggs,ND,38039,3,3,0,0,0,0,0,0,0,0,3,3,0,0
1999,Hettinger,ND,38041,6,5,0,1,0,2,1,0,1,0,4,4,0,0
1999,Kidder,ND,38043,9,8,0,0,1,0,0,0,0,0,9,8,0,1
1999,LaMoure,ND,38045,9,9,0,0,0,0,0,0,0,0,9,9,0,0
1999,Logan,ND,38047,2,2,0,0,0,0,0,0,0,0,2,2,0,0
1999,McHenry,ND,38049,12,11,0,0,1,0,0,0,0,0,12,11,0,1
1999,McIntosh,ND,38051,5,4,0,0,1,0,0,0,0,0,5,4,0,1
1999,McKenzie,ND,38053,7,5,0,2,0,2,0,0,2,0,5,5,0,0
1999,McLean,ND,38055,17,15,1,0,1,1,0,1,0,0,16,15,0,1
1999,Mercer,ND,38057,21,20,0,1,0,2,1,0,1,0,19,19,0,0
1999,Morton,ND,38059,117,114,1,1,1,7,5,1,1,0,110,109,0,1
1999,Mountrail,ND,38061,12,9,0,2,1,2,0,0,2,0,10,9,0,1
1999,Nelson,ND,38063,5,5,0,0,0,1,1,0,0,0,4,4,0,0
1999,Oliver,ND,38065,2,2,0,0,0,0,0,0,0,0,2,2,0,0
1999,Pembina,ND,38067,25,22,0,2,1,2,0,0,2,0,23,22,0,1
1999,Pierce,ND,38069,15,15,0,0,0,0,0,0,0,0,15,15,0,0
1999,Ramsey,ND,38071,52,48,0,1,3,4,3,0,1,0,48,45,0,3
1999,Ransom,ND,38073,20,18,0,0,2,1,1,0,0,0,19,17,0,2
1999,Renville,ND,38075,10,10,0,0,0,0,0,0,0,0,10,10,0,0
1999,Richland,ND,38077,48,44,0,1,3,2,0,0,1,1,46,44,0,2
1999,Rolette,ND,38079,23,23,0,0,0,0,0,0,0,0,23,23,0,0
1999,Sargent,ND,38081,7,7,0,0,0,0,0,0,0,0,7,7,0,0
1999,Sheridan,ND,38083,6,4,0,2,0,3,1,0,2,0,3,3,0,0
1999,Sioux,ND,38085,8,7,0,1,0,3,2,0,1,0,5,5,0,0
1999,Slope,ND,38087,0,0,0,0,0,,,,,,,,,
1999,Stark,ND,38089,75,68,0,3,4,5,0,0,3,2,70,68,0,2
1999,Steele,ND,38091,3,3,0,0,0,1,1,0,0,0,2,2,0,0
1999,Stutsman,ND,38093,75,70,0,1,4,3,2,0,1,0,72,68,0,4
1999,Towner,ND,38095,6,6,0,0,0,2,2,0,0,0,4,4,0,0
1999,Traill,ND,38097,19,18,0,1,0,2,1,0,1,0,17,17,0,0
1999,Walsh,ND,38099,36,36,0,0,0,0,0,0,0,0,36,36,0,0
1999,Ward,ND,38101,235,219,1,2,13,11,6,1,2,2,224,213,0,11
1999,Wells,ND,38103,9,9,0,0,0,0,0,0,0,0,9,9,0,0
1999,Williams,ND,38105,84,79,2,1,2,3,0,2,1,0,81,79,0,2
1999,Adams,OH,39001,122,104,1,0,17,1,0,1,0,0,121,104,0,17
1999,Allen,OH,39003,462,437,2,0,23,14,11,2,0,1,448,426,0,22
1999,Ashland,OH,39005,209,165,0,0,44,12,9,0,0,3,197,156,0,41
1999,Ashtabula,OH,39007,521,479,0,0,42,33,28,0,0,5,488,451,0,37
1999,Athens,OH,39009,156,133,1,0,22,5,1,1,0,3,151,132,0,19
1999,Auglaize,OH,39011,124,114,1,0,9,8,6,1,0,1,116,108,0,8
1999,Belmont,OH,39013,328,310,0,0,18,7,4,0,0,3,321,306,0,15
1999,Brown,OH,39015,189,166,0,0,23,5,3,0,0,2,184,163,0,21
1999,Butler,OH,39017,1404,1237,3,0,164,18,15,3,0,0,1386,1222,0,164
1999,Carroll,OH,39019,190,154,0,0,36,16,10,0,0,6,174,144,0,30
1999,Champaign,OH,39021,199,157,1,0,41,3,2,1,0,0,196,155,0,41
1999,Clark,OH,39023,778,627,0,1,150,4,2,0,1,1,774,625,0,149
1999,Clermont,OH,39025,689,601,3,0,85,11,7,3,0,1,678,594,0,84
1999,Clinton,OH,39027,232,201,1,0,30,1,0,1,0,0,231,201,0,30
1999,Columbiana,OH,39029,660,518,1,0,141,35,23,1,0,11,625,495,0,130
1999,Coshocton,OH,39031,125,111,0,0,14,5,3,0,0,2,120,108,0,12
1999,Crawford,OH,39033,167,142,0,0,25,5,2,0,0,3,162,140,0,22
1999,Cuyahoga,OH,39035,7719,5467,34,0,2218,100,56,34,0,10,7619,5411,0,2208
1999,Darke,OH,39037,177,117,0,0,60,1,0,0,0,1,176,117,0,59
1999,Defiance,OH,39039,120,114,1,0,5,3,2,1,0,0,117,112,0,5
1999,Delaware,OH,39041,255,197,1,0,57,13,10,1,0,2,242,187,0,55
1999,Erie,OH,39043,321,301,1,0,19,6,5,1,0,0,315,296,0,19
1999,Fairfield,OH,39045,488,361,0,2,125,8,2,0,2,4,480,359,0,121
1999,Fayette,OH,39047,209,176,0,0,33,1,1,0,0,0,208,175,0,33
1999,Franklin,OH,39049,6390,4542,13,0,1835,100,59,12,0,29,6290,4483,1,1806
1999,Fulton,OH,39051,149,144,0,0,5,1,1,0,0,0,148,143,0,5
1999,Gallia,OH,39053,133,114,0,0,19,4,4,0,0,0,129,110,0,19
1999,Geauga,OH,39055,188,150,1,0,37,2,0,1,0,1,186,150,0,36
1999,Greene,OH,39057,539,354,3,0,182,6,3,3,0,0,533,351,0,182
1999,Guernsey,OH,39059,168,137,0,0,31,7,4,0,0,3,161,133,0,28
1999,Hamilton,OH,39061,4413,3545,15,0,853,77,55,15,0,7,4336,3490,0,846
1999,Hancock,OH,39063,223,204,0,0,19,6,5,0,0,1,217,199,0,18
1999,Hardin,OH,39065,104,97,0,1,6,2,0,0,1,1,102,97,0,5
1999,Harrison,OH,39067,71,64,0,1,6,2,0,0,1,1,69,64,0,5
1999,Henry,OH,39069,103,91,0,0,12,1,1,0,0,0,102,90,0,12
1999,Highland,OH,39071,184,171,0,0,13,3,3,0,0,0,181,168,0,13
1999,Hocking,OH,39073,107,85,0,0,22,4,2,0,0,2,103,83,0,20
1999,Holmes,OH,39075,61,46,2,0,13,8,5,2,0,1,53,41,0,12
1999,Huron,OH,39077,275,264,0,0,11,3,3,0,0,0,272,261,0,11
1999,Jackson,OH,39079,129,96,0,0,33,7,3,0,0,4,122,93,0,29
1999,Jefferson,OH,39081,369,354,0,0,15,1,1,0,0,0,368,353,0,15
1999,Knox,OH,39083,195,167,0,3,25,8,3,0,3,2,187,164,0,23
1999,Lake,OH,39085,917,761,3,0,153,12,5,3,0,4,905,756,0,149
1999,Lawrence,OH,39087,269,247,1,0,21,6,4,1,0,1,263,243,0,20
1999,Licking,OH,39089,623,481,2,0,140,12,7,2,0,3,611,474,0,137
1999,Logan,OH,39091,234,177,1,0,56,5,0,1,0,4,229,177,0,52
1999,Lorain,OH,39093,1230,1029,1,0,200,12,10,1,0,1,1218,1019,0,199
1999,Lucas,OH,39095,1798,1544,7,0,247,37,23,7,0,7,1761,1521,0,240
1999,Madison,OH,39097,212,149,0,2,61,6,2,0,2,2,206,147,0,59
1999,Mahoning,OH,39099,1533,1194,7,1,331,93,67,7,1,18,1440,1127,0,313
1999,Marion,OH,39101,281,266,0,0,15,12,11,0,0,1,269,255,0,14
1999,Medina,OH,39103,500,434,0,0,66,27,24,0,0,3,473,410,0,63
1999,Meigs,OH,39105,87,78,1,0,8,3,1,1,0,1,84,77,0,7
1999,Mercer,OH,39107,79,77,0,0,2,0,0,0,0,0,79,77,0,2
1999,Miami,OH,39109,410,304,2,1,103,4,1,2,1,0,406,303,0,103
1999,Monroe,OH,39111,52,50,0,0,2,1,1,0,0,0,51,49,0,2
1999,Montgomery,OH,39113,3269,2014,6,0,1249,24,16,6,0,2,3245,1998,0,1247
1999,Morgan,OH,39115,30,22,0,0,8,0,0,0,0,0,30,22,0,8
1999,Morrow,OH,39117,98,73,0,0,25,3,3,0,0,0,95,70,0,25
1999,Muskingum,OH,39119,367,302,2,0,63,15,6,2,0,7,352,296,0,56
1999,Noble,OH,39121,31,28,0,0,3,0,0,0,0,0,31,28,0,3
1999,Ottawa,OH,39123,116,107,0,0,9,3,3,0,0,0,113,104,0,9
1999,Paulding,OH,39125,76,73,0,0,3,2,2,0,0,0,74,71,0,3
1999,Perry,OH,39127,137,108,0,0,29,2,1,0,0,1,135,107,0,28
1999,Pickaway,OH,39129,224,176,0,0,48,2,2,0,0,0,222,174,0,48
1999,Pike,OH,39131,100,81,1,0,18,2,1,1,0,0,98,80,0,18
1999,Portage,OH,39133,717,634,0,0,83,21,21,0,0,0,696,613,0,83
1999,Preble,OH,39135,189,142,1,0,46,3,2,1,0,0,186,140,0,46
1999,Putnam,OH,39137,49,48,0,0,1,1,1,0,0,0,48,47,0,1
1999,Richland,OH,39139,584,485,1,0,98,26,22,1,0,3,558,463,0,95
1999,Ross,OH,39141,318,251,0,0,67,6,4,0,0,2,312,247,0,65
1999,Sandusky,OH,39143,163,154,0,0,9,4,4,0,0,0,159,150,0,9
1999,Scioto,OH,39145,367,290,0,0,77,3,0,0,0,3,364,290,0,74
1999,Seneca,OH,39147,180,170,1,0,9,9,6,1,0,2,171,164,0,7
1999,Shelby,OH,39149,154,123,0,0,31,1,0,0,0,1,153,123,0,30
1999,Stark,OH,39151,2129,1764,3,0,362,94,71,3,0,20,2035,1693,0,342
1999,Summit,OH,39153,2759,2248,2,0,509,99,80,2,0,17,2660,2168,0,492
1999,Trumbull,OH,39155,1237,1033,0,0,204,59,53,0,0,6,1178,980,0,198
1999,Tuscarawas,OH,39157,398,365,0,0,33,19,16,0,0,3,379,349,0,30
1999,Union,OH,39159,189,109,0,2,78,10,2,0,2,6,179,107,0,72
1999,Van Wert,OH,39161,95,93,0,0,2,3,3,0,0,0,92,90,0,2
1999,Vinton,OH,39163,51,45,0,0,6,0,0,0,0,0,51,45,0,6
1999,Warren,OH,39165,673,569,2,0,102,11,7,2,0,2,662,562,0,100
1999,Washington,OH,39167,210,201,0,0,9,11,10,0,0,1,199,191,0,8
1999,Wayne,OH,39169,471,399,0,0,72,17,13,0,0,4,454,386,0,68
1999,Williams,OH,39171,146,144,0,0,2,2,2,0,0,0,144,142,0,2
1999,Wood,OH,39173,380,353,0,0,27,8,5,0,0,3,372,348,0,24
1999,Wyandot,OH,39175,94,91,0,0,3,2,2,0,0,0,92,89,0,3
1999,Adair,OK,40001,78,74,0,0,4,2,2,0,0,0,76,72,0,4
1999,Alfalfa,OK,40003,26,24,1,0,1,4,2,1,0,1,22,22,0,0
1999,Atoka,OK,40005,34,33,0,0,1,2,1,0,0,1,32,32,0,0
1999,Beaver,OK,40007,10,9,0,0,1,0,0,0,0,0,10,9,0,1
1999,Beckham,OK,40009,105,97,0,0,8,5,5,0,0,0,100,92,0,8
1999,Blaine,OK,40011,42,35,0,0,7,1,0,0,0,1,41,35,0,6
1999,Bryan,OK,40013,152,140,0,0,12,1,1,0,0,0,151,139,0,12
1999,Caddo,OK,40015,127,110,0,1,16,6,4,0,1,1,121,106,0,15
1999,Canadian,OK,40017,513,420,2,0,91,18,13,2,0,3,495,407,0,88
1999,Carter,OK,40019,237,213,1,1,22,9,7,1,1,0,228,206,0,22
1999,Cherokee,OK,40021,185,173,0,1,11,6,4,0,1,1,179,169,0,10
1999,Choctaw,OK,40023,46,41,0,0,5,2,1,0,0,1,44,40,0,4
1999,Cimarron,OK,40025,0,0,0,0,0,,,,,,,,,
1999,Cleveland,OK,40027,1040,845,3,0,192,17,13,3,0,1,1023,832,0,191
1999,Coal,OK,40029,18,18,0,0,0,0,0,0,0,0,18,18,0,0
1999,Comanche,OK,40031,1027,855,4,1,167,17,11,4,1,1,1010,844,0,166
1999,Cotton,OK,40033,26,18,0,0,8,1,0,0,0,1,25,18,0,7
1999,Craig,OK,40035,66,59,0,0,7,2,1,0,0,1,64,58,0,6
1999,Creek,OK,40037,379,340,0,1,38,20,16,0,1,3,359,324,0,35
1999,Custer,OK,40039,133,115,1,0,17,2,1,1,0,0,131,114,0,17
1999,Delaware,OK,40041,92,84,0,0,8,5,4,0,0,1,87,80,0,7
1999,Dewey,OK,40043,14,13,0,0,1,1,1,0,0,0,13,12,0,1
1999,Ellis,OK,40045,21,19,0,1,1,3,2,0,1,0,18,17,0,1
1999,Garfield,OK,40047,333,317,1,0,15,1,0,1,0,0,332,317,0,15
1999,Garvin,OK,40049,168,150,1,1,16,6,4,1,1,0,162,146,0,16
1999,Grady,OK,40051,268,221,1,2,44,9,6,1,2,0,259,215,0,44
1999,Grant,OK,40053,22,20,0,0,2,1,1,0,0,0,21,19,0,2
1999,Greer,OK,40055,37,32,1,2,2,4,1,1,2,0,33,31,0,2
1999,Harmon,OK,40057,10,8,1,0,1,1,0,1,0,0,9,8,0,1
1999,Harper,OK,40059,20,17,1,1,1,3,1,1,1,0,17,16,0,1
1999,Haskell,OK,40061,79,72,0,1,6,2,1,0,1,0,77,71,0,6
1999,Hughes,OK,40063,72,65,0,0,7,1,1,0,0,0,71,64,0,7
1999,Jackson,OK,40065,29,27,0,0,2,1,1,0,0,0,28,26,0,2
1999,Jefferson,OK,40067,38,35,0,2,1,3,1,0,2,0,35,34,0,1
1999,Johnston,OK,40069,58,56,0,1,1,2,1,0,1,0,56,55,0,1
1999,Kay,OK,40071,196,188,1,0,7,4,2,1,0,1,192,186,0,6
1999,Kingfisher,OK,40073,80,64,0,1,15,2,1,0,1,0,78,63,0,15
1999,Kiowa,OK,40075,47,38,1,1,7,2,0,1,1,0,45,38,0,7
1999,Latimer,OK,40077,43,39,1,1,2,4,2,1,1,0,39,37,0,2
1999,Le Flore,OK,40079,263,256,0,0,7,4,2,0,0,2,259,254,0,5
1999,Lincoln,OK,40081,173,153,0,0,20,4,4,0,0,0,169,149,0,20
1999,Logan,OK,40083,144,116,0,1,27,2,1,0,1,0,142,115,0,27
1999,Love,OK,40085,48,47,0,1,0,1,0,0,1,0,47,47,0,0
1999,McClain,OK,40087,207,171,1,2,33,10,7,1,2,0,197,164,0,33
1999,McCurtain,OK,40089,109,102,0,0,7,6,6,0,0,0,103,96,0,7
1999,McIntosh,OK,40091,146,140,0,0,6,4,3,0,0,1,142,137,0,5
1999,Major,OK,40093,34,30,2,0,2,2,1,1,0,0,32,29,1,2
1999,Marshall,OK,40095,65,60,2,0,3,4,2,2,0,0,61,58,0,3
1999,Mayes,OK,40097,212,187,0,0,25,10,9,0,0,1,202,178,0,24
1999,Murray,OK,40099,71,68,0,0,3,2,2,0,0,0,69,66,0,3
1999,Muskogee,OK,40101,500,454,3,2,41,15,6,3,2,4,485,448,0,37
1999,Noble,OK,40103,35,34,0,0,1,0,0,0,0,0,35,34,0,1
1999,Nowata,OK,40105,51,41,0,0,10,3,0,0,0,3,48,41,0,7
1999,Okfuskee,OK,40107,46,35,0,1,10,2,0,0,1,1,44,35,0,9
1999,Oklahoma,OK,40109,5079,3951,25,0,1103,133,84,25,0,24,4946,3867,0,1079
1999,Okmulgee,OK,40111,231,188,1,0,42,7,3,1,0,3,224,185,0,39
1999,Osage,OK,40113,238,203,2,0,33,20,12,2,0,6,218,191,0,27
1999,Ottawa,OK,40115,172,164,0,0,8,6,4,0,0,2,166,160,0,6
1999,Pawnee,OK,40117,107,95,0,1,11,7,6,0,1,0,100,89,0,11
1999,Payne,OK,40119,260,245,0,1,14,13,12,0,1,0,247,233,0,14
1999,Pittsburg,OK,40121,271,249,0,0,22,5,5,0,0,0,266,244,0,22
1999,Pontotoc,OK,40123,181,169,1,0,11,3,1,1,0,1,178,168,0,10
1999,Pottawatomie,OK,40125,499,402,2,1,94,12,6,2,1,3,487,396,0,91
1999,Pushmataha,OK,40127,31,28,0,1,2,3,2,0,1,0,28,26,0,2
1999,Roger Mills,OK,40129,9,8,0,1,0,1,0,0,1,0,8,8,0,0
1999,Rogers,OK,40131,338,301,1,0,36,20,18,1,0,1,318,283,0,35
1999,Seminole,OK,40133,139,124,0,0,15,1,1,0,0,0,138,123,0,15
1999,Sequoyah,OK,40135,192,186,1,0,5,4,3,1,0,0,188,183,0,5
1999,Stephens,OK,40137,249,222,2,0,25,7,4,2,0,1,242,218,0,24
1999,Texas,OK,40139,67,60,1,1,5,6,4,0,1,1,61,56,1,4
1999,Tillman,OK,40141,35,32,1,0,2,2,1,1,0,0,33,31,0,2
1999,Tulsa,OK,40143,3116,2629,10,0,477,207,169,9,0,29,2909,2460,1,448
1999,Wagoner,OK,40145,299,258,0,3,38,13,10,0,3,0,286,248,0,38
1999,Washington,OK,40147,249,224,1,0,24,19,14,1,0,4,230,210,0,20
1999,Washita,OK,40149,57,48,1,1,7,2,0,1,1,0,55,48,0,7
1999,Woods,OK,40151,35,32,1,1,1,4,1,1,1,1,31,31,0,0
1999,Woodward,OK,40153,131,123,0,0,8,4,4,0,0,0,127,119,0,8
1999,Baker,OR,41001,76,72,0,1,3,14,11,0,1,2,62,61,0,1
1999,Benton,OR,41003,217,195,0,0,22,36,32,0,0,4,181,163,0,18
1999,Clackamas,OR,41005,1778,1418,4,0,356,307,217,3,0,87,1471,1201,1,269
1999,Clatsop,OR,41007,183,165,0,0,18,34,26,0,0,8,149,139,0,10
1999,Columbia,OR,41009,199,155,1,0,43,32,17,1,0,14,167,138,0,29
1999,Coos,OR,41011,328,289,1,1,37,49,34,1,1,13,279,255,0,24
1999,Crook,OR,41013,127,115,0,0,12,28,22,0,0,6,99,93,0,6
1999,Curry,OR,41015,103,74,0,0,29,28,18,0,0,10,75,56,0,19
1999,Deschutes,OR,41017,716,650,4,0,62,184,155,4,0,25,532,495,0,37
1999,Douglas,OR,41019,545,437,0,0,108,90,66,0,0,24,455,371,0,84
1999,Gilliam,OR,41021,8,6,0,0,2,1,1,0,0,0,7,5,0,2
1999,Grant,OR,41023,27,25,1,0,1,8,6,1,0,1,19,19,0,0
1999,Harney,OR,41025,30,30,0,0,0,3,3,0,0,0,27,27,0,0
1999,Hood River,OR,41027,62,57,0,0,5,11,11,0,0,0,51,46,0,5
1999,Jackson,OR,41029,1103,951,8,0,144,232,179,8,0,45,871,772,0,99
1999,Jefferson,OR,41031,96,87,0,0,9,18,14,0,0,4,78,73,0,5
1999,Josephine,OR,41033,371,328,1,0,42,81,63,1,0,17,290,265,0,25
1999,Klamath,OR,41035,345,312,2,0,31,56,45,2,0,9,289,267,0,22
1999,Lake,OR,41037,21,15,0,0,6,5,0,0,0,5,16,15,0,1
1999,Lane,OR,41039,1769,1445,3,0,321,302,212,3,0,87,1467,1233,0,234
1999,Lincoln,OR,41041,260,220,1,0,39,69,47,1,0,21,191,173,0,18
1999,Linn,OR,41043,641,521,1,0,119,83,59,1,0,23,558,462,0,96
1999,Malheur,OR,41045,110,79,3,4,24,12,3,3,4,2,98,76,0,22
1999,Marion,OR,41047,1879,1610,3,0,266,199,147,3,0,49,1680,1463,0,217
1999,Morrow,OR,41049,42,38,1,0,3,6,5,1,0,0,36,33,0,3
1999,Multnomah,OR,41051,3695,2882,15,0,798,530,361,15,0,154,3165,2521,0,644
1999,Polk,OR,41053,294,246,1,0,47,45,31,1,0,13,249,215,0,34
1999,Sherman,OR,41055,8,7,0,0,1,0,0,0,0,0,8,7,0,1
1999,Tillamook,OR,41057,113,108,0,0,5,21,20,0,0,1,92,88,0,4
1999,Umatilla,OR,41059,326,302,1,0,23,47,39,1,0,7,279,263,0,16
1999,Union,OR,41061,86,81,1,0,4,11,9,1,0,1,75,72,0,3
1999,Wallowa,OR,41063,25,24,0,0,1,8,7,0,0,1,17,17,0,0
1999,Wasco,OR,41065,114,88,0,0,26,17,8,0,0,9,97,80,0,17
1999,Washington,OR,41067,2103,1682,14,0,407,327,247,14,0,66,1776,1435,0,341
1999,Wheeler,OR,41069,0,0,0,0,0,,,,,,,,,
1999,Yamhill,OR,41071,467,397,0,0,70,67,49,0,0,18,400,348,0,52
1999,Adams,PA,42001,306,253,2,0,51,26,18,2,0,6,280,235,0,45
1999,Allegheny,PA,42003,4589,3644,76,0,869,166,92,69,0,5,4423,3552,7,864
1999,Armstrong,PA,42005,176,163,3,0,10,6,4,2,0,0,170,159,1,10
1999,Beaver,PA,42007,614,533,4,1,76,9,6,2,1,0,605,527,2,76
1999,Bedford,PA,42009,80,72,4,0,4,3,0,3,0,0,77,72,1,4
1999,Berks,PA,42011,1519,1246,8,0,265,26,15,7,0,4,1493,1231,1,261
1999,Blair,PA,42013,384,350,6,1,27,12,6,5,1,0,372,344,1,27
1999,Bradford,PA,42015,157,144,0,0,13,5,3,0,0,2,152,141,0,11
1999,Bucks,PA,42017,2531,1560,24,2,945,56,27,24,2,3,2475,1533,0,942
1999,Butler,PA,42019,425,385,5,0,35,15,8,5,0,2,410,377,0,33
1999,Cambria,PA,42021,469,441,5,0,23,13,10,3,0,0,456,431,2,23
1999,Cameron,PA,42023,18,17,0,0,1,0,0,0,0,0,18,17,0,1
1999,Carbon,PA,42025,254,206,0,0,48,2,1,0,0,1,252,205,0,47
1999,Centre,PA,42027,223,188,4,0,31,33,20,4,0,9,190,168,0,22
1999,Chester,PA,42029,1193,788,25,0,380,45,21,23,0,1,1148,767,2,379
1999,Clarion,PA,42031,63,59,2,0,2,3,1,2,0,0,60,58,0,2
1999,Clearfield,PA,42033,139,129,2,0,8,7,4,2,0,1,132,125,0,7
1999,Clinton,PA,42035,87,84,0,0,3,1,1,0,0,0,86,83,0,3
1999,Columbia,PA,42037,198,174,2,0,22,11,7,2,0,2,187,167,0,20
1999,Crawford,PA,42039,294,277,0,0,17,6,5,0,0,1,288,272,0,16
1999,Cumberland,PA,42041,671,498,3,0,170,69,37,3,0,29,602,461,0,141
1999,Dauphin,PA,42043,1094,787,6,0,301,92,52,6,0,34,1002,735,0,267
1999,Delaware,PA,42045,2118,1110,19,0,989,33,12,17,0,4,2085,1098,2,985
1999,Elk,PA,42047,76,73,0,0,3,2,2,0,0,0,74,71,0,3
1999,Erie,PA,42049,784,689,2,1,92,29,23,2,1,3,755,666,0,89
1999,Fayette,PA,42051,499,478,1,0,20,8,7,1,0,0,491,471,0,20
1999,Forest,PA,42053,14,10,0,2,2,2,0,0,2,0,12,10,0,2
1999,Franklin,PA,42055,370,314,2,1,53,45,34,2,1,8,325,280,0,45
1999,Fulton,PA,42057,30,20,0,0,10,3,3,0,0,0,27,17,0,10
1999,Greene,PA,42059,127,123,0,0,4,1,1,0,0,0,126,122,0,4
1999,Huntingdon,PA,42061,102,89,2,0,11,15,9,2,0,4,87,80,0,7
1999,Indiana,PA,42063,154,142,1,1,10,5,3,1,1,0,149,139,0,10
1999,Jefferson,PA,42065,116,112,0,0,4,5,5,0,0,0,111,107,0,4
1999,Juniata,PA,42067,63,51,0,0,12,1,0,0,0,1,62,51,0,11
1999,Lackawanna,PA,42069,608,526,0,0,82,12,11,0,0,1,596,515,0,81
1999,Lancaster,PA,42071,1280,1063,5,0,212,23,17,5,0,1,1257,1046,0,211
1999,Lawrence,PA,42073,285,263,2,0,20,2,2,0,0,0,283,261,2,20
1999,Lebanon,PA,42075,395,340,4,0,51,40,33,4,0,3,355,307,0,48
1999,Lehigh,PA,42077,1272,982,10,0,280,19,8,10,0,1,1253,974,0,279
1999,Luzerne,PA,42079,1122,922,10,0,190,37,21,9,0,7,1085,901,1,183
1999,Lycoming,PA,42081,328,288,0,0,40,7,5,0,0,2,321,283,0,38
1999,Mc Kean,PA,42083,113,105,0,0,8,1,1,0,0,0,112,104,0,8
1999,Mercer,PA,42085,374,359,4,1,10,12,7,4,1,0,362,352,0,10
1999,Mifflin,PA,42087,147,125,2,0,20,15,7,2,0,6,132,118,0,14
1999,Monroe,PA,42089,762,528,8,0,226,34,24,8,0,2,728,504,0,224
1999,Montgomery,PA,42091,2261,1460,24,1,776,62,37,21,1,3,2199,1423,3,773
1999,Montour,PA,42093,34,31,0,0,3,1,1,0,0,0,33,30,0,3
1999,Northampton,PA,42095,1074,810,8,1,255,13,6,6,1,0,1061,804,2,255
1999,Northumberland,PA,42097,301,266,0,0,35,19,9,0,0,10,282,257,0,25
1999,Perry,PA,42099,168,127,1,0,40,13,3,1,0,9,155,124,0,31
1999,Philadelphia,PA,42101,8380,3505,46,0,4829,90,42,44,0,4,8290,3463,2,4825
1999,Pike,PA,42103,246,182,0,0,64,3,3,0,0,0,243,179,0,64
1999,Potter,PA,42105,28,23,0,0,5,1,1,0,0,0,27,22,0,5
1999,Schuylkill,PA,42107,589,521,6,0,62,17,11,6,0,0,572,510,0,62
1999,Snyder,PA,42109,85,71,0,0,14,18,11,0,0,7,67,60,0,7
1999,Somerset,PA,42111,192,179,1,0,12,6,5,1,0,0,186,174,0,12
1999,Sullivan,PA,42113,12,7,1,0,4,1,0,1,0,0,11,7,0,4
1999,Susquehanna,PA,42115,94,83,1,0,10,3,1,1,0,1,91,82,0,9
1999,Tioga,PA,42117,113,102,0,0,11,3,2,0,0,1,110,100,0,10
1999,Union,PA,42119,64,59,0,0,5,6,5,0,0,1,58,54,0,4
1999,Venango,PA,42121,145,137,1,0,7,7,4,1,0,2,138,133,0,5
1999,Warren,PA,42123,131,121,1,0,9,5,3,1,0,1,126,118,0,8
1999,Washington,PA,42125,636,585,5,0,46,20,14,5,0,1,616,571,0,45
1999,Wayne,PA,42127,192,163,0,0,29,7,6,0,0,1,185,157,0,28
1999,Westmoreland,PA,42129,1115,1001,10,1,103,41,31,9,1,0,1074,970,1,103
1999,Wyoming,PA,42131,65,55,0,0,10,2,1,0,0,1,63,54,0,9
1999,York,PA,42133,1407,1157,7,1,242,157,113,7,1,36,1250,1044,0,206
1999,Bristol,RI,44001,174,163,1,0,10,5,4,1,0,0,169,159,0,10
1999,Kent,RI,44003,1016,956,5,0,55,16,11,5,0,0,1000,945,0,55
1999,Newport,RI,44005,282,263,3,0,16,12,8,3,0,1,270,255,0,15
1999,Providence,RI,44007,3092,2874,17,0,201,79,60,17,0,2,3013,2814,0,199
1999,Washington,RI,44009,436,402,2,0,32,12,10,2,0,0,424,392,0,32
1999,Abbeville,SC,45001,52,29,0,0,23,0,0,0,0,0,52,29,0,23
1999,Aiken,SC,45003,508,333,1,0,174,6,4,1,0,1,502,329,0,173
1999,Allendale,SC,45005,17,7,0,0,10,0,0,0,0,0,17,7,0,10
1999,Anderson,SC,45007,412,264,2,1,145,7,4,2,1,0,405,260,0,145
1999,Bamberg,SC,45009,40,12,0,0,28,0,0,0,0,0,40,12,0,28
1999,Barnwell,SC,45011,76,25,0,0,51,0,0,0,0,0,76,25,0,51
1999,Beaufort,SC,45013,284,102,4,0,178,9,4,3,0,2,275,98,1,176
1999,Berkeley,SC,45015,580,192,2,0,386,7,2,2,0,3,573,190,0,383
1999,Calhoun,SC,45017,36,14,0,0,22,0,0,0,0,0,36,14,0,22
1999,Charleston,SC,45019,906,347,7,0,552,18,11,6,0,1,888,336,1,551
1999,Cherokee,SC,45021,204,111,3,0,90,4,0,3,0,1,200,111,0,89
1999,Chester,SC,45023,71,46,0,0,25,0,0,0,0,0,71,46,0,25
1999,Chesterfield,SC,45025,117,14,0,0,103,0,0,0,0,0,117,14,0,103
1999,Clarendon,SC,45027,123,33,0,0,90,0,0,0,0,0,123,33,0,90
1999,Colleton,SC,45029,170,26,0,0,144,1,1,0,0,0,169,25,0,144
1999,Darlington,SC,45031,151,53,1,0,97,0,0,0,0,0,151,53,1,97
1999,Dillon,SC,45033,50,22,1,0,27,1,0,1,0,0,49,22,0,27
1999,Dorchester,SC,45035,349,125,3,0,221,5,1,3,0,1,344,124,0,220
1999,Edgefield,SC,45037,73,41,0,0,32,3,3,0,0,0,70,38,0,32
1999,Fairfield,SC,45039,67,25,1,0,41,2,1,1,0,0,65,24,0,41
1999,Florence,SC,45041,312,134,2,0,176,6,4,2,0,0,306,130,0,176
1999,Georgetown,SC,45043,99,47,0,0,52,1,1,0,0,0,98,46,0,52
1999,Greenville,SC,45045,996,668,22,0,306,39,21,18,0,0,957,647,4,306
1999,Greenwood,SC,45047,189,81,1,0,107,3,3,0,0,0,186,78,1,107
1999,Hampton,SC,45049,44,13,2,0,29,2,0,2,0,0,42,13,0,29
1999,Horry,SC,45051,491,370,5,2,114,22,12,5,2,3,469,358,0,111
1999,Jasper,SC,45053,32,8,1,0,23,1,0,1,0,0,31,8,0,23
1999,Kershaw,SC,45055,189,70,2,1,116,6,2,2,1,1,183,68,0,115
1999,Lancaster,SC,45057,94,53,1,0,40,1,0,1,0,0,93,53,0,40
1999,Laurens,SC,45059,228,149,3,0,76,3,1,2,0,0,225,148,1,76
1999,Lee,SC,45061,62,18,0,0,44,0,0,0,0,0,62,18,0,44
1999,Lexington,SC,45063,667,309,1,1,356,8,5,1,1,1,659,304,0,355
1999,McCormick,SC,45065,27,10,0,0,17,0,0,0,0,0,27,10,0,17
1999,Marion,SC,45067,61,27,0,0,34,1,1,0,0,0,60,26,0,34
1999,Marlboro,SC,45069,98,6,0,0,92,0,0,0,0,0,98,6,0,92
1999,Newberry,SC,45071,116,47,0,0,69,1,1,0,0,0,115,46,0,69
1999,Oconee,SC,45073,119,88,0,0,31,0,0,0,0,0,119,88,0,31
1999,Orangeburg,SC,45075,301,74,0,0,227,3,0,0,0,3,298,74,0,224
1999,Pickens,SC,45077,267,189,2,0,76,3,2,1,0,0,264,187,1,76
1999,Richland,SC,45079,981,421,6,0,554,18,11,6,0,1,963,410,0,553
1999,Saluda,SC,45081,43,16,0,0,27,1,0,0,0,1,42,16,0,26
1999,Spartanburg,SC,45083,823,522,2,0,299,6,3,2,0,1,817,519,0,298
1999,Sumter,SC,45085,526,262,0,0,264,6,1,0,0,5,520,261,0,259
1999,Union,SC,45087,122,95,0,0,27,0,0,0,0,0,122,95,0,27
1999,Williamsburg,SC,45089,96,20,0,0,76,0,0,0,0,0,96,20,0,76
1999,York,SC,45091,303,181,2,2,118,10,6,2,2,0,293,175,0,118
1999,Aurora,SD,46003,3,3,0,0,0,0,0,0,0,0,3,3,0,0
1999,Beadle,SD,46005,59,56,1,2,0,4,1,1,2,0,55,55,0,0
1999,Bennett,SD,46007,8,5,1,2,0,4,1,1,2,0,4,4,0,0
1999,Bon Homme,SD,46009,17,16,0,0,1,0,0,0,0,0,17,16,0,1
1999,Brookings,SD,46011,50,48,0,0,2,1,1,0,0,0,49,47,0,2
1999,Brown,SD,46013,110,102,2,2,4,8,3,2,2,1,102,99,0,3
1999,Brule,SD,46015,11,11,0,0,0,0,0,0,0,0,11,11,0,0
1999,Buffalo,SD,46017,0,0,0,0,0,,,,,,,,,
1999,Butte,SD,46019,46,45,0,0,1,1,1,0,0,0,45,44,0,1
1999,Campbell,SD,46021,4,4,0,0,0,1,1,0,0,0,3,3,0,0
1999,Charles Mix,SD,46023,12,9,0,1,2,3,1,0,1,1,9,8,0,1
1999,Clark,SD,46025,14,14,0,0,0,1,1,0,0,0,13,13,0,0
1999,Clay,SD,46027,27,27,0,0,0,1,1,0,0,0,26,26,0,0
1999,Codington,SD,46029,92,80,0,4,8,12,7,0,4,1,80,73,0,7
1999,Corson,SD,46031,4,3,0,1,0,1,0,0,1,0,3,3,0,0
1999,Custer,SD,46033,19,18,0,0,1,1,1,0,0,0,18,17,0,1
1999,Davison,SD,46035,52,49,0,1,2,1,0,0,1,0,51,49,0,2
1999,Day,SD,46037,18,14,0,0,4,1,1,0,0,0,17,13,0,4
1999,Deuel,SD,46039,6,5,0,1,0,1,0,0,1,0,5,5,0,0
1999,Dewey,SD,46041,10,5,0,5,0,5,0,0,5,0,5,5,0,0
1999,Douglas,SD,46043,7,7,0,0,0,0,0,0,0,0,7,7,0,0
1999,Edmunds,SD,46045,12,11,0,1,0,1,0,0,1,0,11,11,0,0
1999,Fall River,SD,46047,24,23,0,0,1,0,0,0,0,0,24,23,0,1
1999,Faulk,SD,46049,3,3,0,0,0,0,0,0,0,0,3,3,0,0
1999,Grant,SD,46051,13,13,0,0,0,0,0,0,0,0,13,13,0,0
1999,Gregory,SD,46053,6,6,0,0,0,0,0,0,0,0,6,6,0,0
1999,Haakon,SD,46055,2,2,0,0,0,0,0,0,0,0,2,2,0,0
1999,Hamlin,SD,46057,12,12,0,0,0,1,1,0,0,0,11,11,0,0
1999,Hand,SD,46059,7,7,0,0,0,2,2,0,0,0,5,5,0,0
1999,Hanson,SD,46061,1,1,0,0,0,0,0,0,0,0,1,1,0,0
1999,Harding,SD,46063,4,4,0,0,0,1,1,0,0,0,3,3,0,0
1999,Hughes,SD,46065,27,26,1,0,0,5,4,1,0,0,22,22,0,0
1999,Hutchinson,SD,46067,6,6,0,0,0,1,1,0,0,0,5,5,0,0
1999,Hyde,SD,46069,1,1,0,0,0,1,1,0,0,0,0,0,0,0
1999,Jackson,SD,46071,2,2,0,0,0,0,0,0,0,0,2,2,0,0
1999,Jerauld,SD,46073,1,1,0,0,0,0,0,0,0,0,1,1,0,0
1999,Jones,SD,46075,0,0,0,0,0,,,,,,,,,
1999,Kingsbury,SD,46077,16,15,0,0,1,3,3,0,0,0,13,12,0,1
1999,Lake,SD,46079,36,35,0,0,1,0,0,0,0,0,36,35,0,1
1999,Lawrence,SD,46081,67,66,0,1,0,1,0,0,1,0,66,66,0,0
1999,Lincoln,SD,46083,43,40,0,0,3,2,2,0,0,0,41,38,0,3
1999,Lyman,SD,46085,0,0,0,0,0,,,,,,,,,
1999,Marshall,SD,46087,14,13,0,0,1,2,2,0,0,0,12,11,0,1
1999,McCook,SD,46089,5,5,0,0,0,0,0,0,0,0,5,5,0,0
1999,McPherson,SD,46091,10,10,0,0,0,1,1,0,0,0,9,9,0,0
1999,Meade,SD,46093,78,77,0,0,1,2,2,0,0,0,76,75,0,1
1999,Mellette,SD,46095,0,0,0,0,0,,,,,,,,,
1999,Miner,SD,46097,5,5,0,0,0,0,0,0,0,0,5,5,0,0
1999,Minnehaha,SD,46099,643,620,1,1,21,22,19,1,1,1,621,601,0,20
1999,Moody,SD,46101,20,19,0,0,1,1,1,0,0,0,19,18,0,1
1999,Pennington,SD,46103,358,343,2,0,13,27,20,2,0,5,331,323,0,8
1999,Perkins,SD,46105,7,6,0,0,1,1,1,0,0,0,6,5,0,1
1999,Potter,SD,46107,10,8,0,2,0,4,2,0,2,0,6,6,0,0
1999,Roberts,SD,46109,10,9,0,0,1,2,1,0,0,1,8,8,0,0
1999,Sanborn,SD,46111,8,7,0,0,1,0,0,0,0,0,8,7,0,1
1999,Shannon,SD,46113,3,3,0,0,0,0,0,0,0,0,3,3,0,0
1999,Spink,SD,46115,19,16,1,1,1,4,1,1,1,1,15,15,0,0
1999,Stanley,SD,46117,5,5,0,0,0,2,2,0,0,0,3,3,0,0
1999,Sully,SD,46119,0,0,0,0,0,,,,,,,,,
1999,Todd,SD,46121,7,6,0,0,1,1,1,0,0,0,6,5,0,1
1999,Tripp,SD,46123,12,11,0,0,1,6,6,0,0,0,6,5,0,1
1999,Turner,SD,46125,26,24,0,1,1,2,1,0,1,0,24,23,0,1
1999,Union,SD,46127,52,51,0,0,1,4,4,0,0,0,48,47,0,1
1999,Walworth,SD,46129,13,13,0,0,0,0,0,0,0,0,13,13,0,0
1999,Yankton,SD,46135,84,80,1,0,3,7,5,1,0,1,77,75,0,2
1999,Anderson,TN,47001,376,256,0,0,120,2,2,0,0,0,374,254,0,120
1999,Bedford,TN,47003,211,61,2,0,148,3,2,1,0,0,208,59,1,148
1999,Benton,TN,47005,131,66,1,0,64,2,1,1,0,0,129,65,0,64
1999,Bledsoe,TN,47007,37,17,0,0,20,0,0,0,0,0,37,17,0,20
1999,Blount,TN,47009,741,419,3,0,319,6,2,3,0,1,735,417,0,318
1999,Bradley,TN,47011,713,307,3,0,403,8,3,3,0,2,705,304,0,401
1999,Campbell,TN,47013,218,142,0,0,76,3,1,0,0,2,215,141,0,74
1999,Cannon,TN,47015,55,23,0,0,32,2,1,0,0,1,53,22,0,31
1999,Carroll,TN,47017,267,122,3,0,142,5,2,3,0,0,262,120,0,142
1999,Carter,TN,47019,197,160,0,0,37,1,1,0,0,0,196,159,0,37
1999,Cheatham,TN,47021,198,117,0,0,81,2,1,0,0,1,196,116,0,80
1999,Chester,TN,47023,87,37,2,0,48,2,1,1,0,0,85,36,1,48
1999,Claiborne,TN,47025,148,109,3,0,36,4,0,3,0,1,144,109,0,35
1999,Clay,TN,47027,17,13,0,0,4,2,0,0,0,2,15,13,0,2
1999,Cocke,TN,47029,199,129,2,0,68,3,1,2,0,0,196,128,0,68
1999,Coffee,TN,47031,234,95,0,1,138,7,1,0,1,5,227,94,0,133
1999,Crockett,TN,47033,132,40,3,1,88,6,1,2,1,2,126,39,1,86
1999,Cumberland,TN,47035,218,179,2,0,37,5,1,2,0,2,213,178,0,35
1999,Davidson,TN,47037,3901,2134,30,0,1737,77,43,22,0,12,3824,2091,8,1725
1999,Decatur,TN,47039,72,33,1,0,38,0,0,0,0,0,72,33,1,38
1999,DeKalb,TN,47041,87,61,0,0,26,1,1,0,0,0,86,60,0,26
1999,Dickson,TN,47043,295,150,2,0,143,2,0,1,0,1,293,150,1,142
1999,Dyer,TN,47045,395,118,4,0,273,10,3,4,0,3,385,115,0,270
1999,Fayette,TN,47047,200,56,1,0,143,2,0,1,0,1,198,56,0,142
1999,Fentress,TN,47049,70,63,1,0,6,1,1,0,0,0,69,62,1,6
1999,Franklin,TN,47051,160,44,2,1,113,11,5,2,1,3,149,39,0,110
1999,Gibson,TN,47053,411,133,1,0,277,5,2,1,0,2,406,131,0,275
1999,Giles,TN,47055,152,83,0,0,69,2,1,0,0,1,150,82,0,68
1999,Grainger,TN,47057,101,56,2,0,43,4,0,2,0,2,97,56,0,41
1999,Greene,TN,47059,409,303,1,0,105,6,4,1,0,1,403,299,0,104
1999,Grundy,TN,47061,79,26,0,0,53,0,0,0,0,0,79,26,0,53
1999,Hamblen,TN,47063,391,244,4,0,143,9,4,4,0,1,382,240,0,142
1999,Hamilton,TN,47065,2423,1048,11,0,1364,47,29,10,0,8,2376,1019,1,1356
1999,Hancock,TN,47067,24,20,0,0,4,0,0,0,0,0,24,20,0,4
1999,Hardeman,TN,47069,255,59,0,0,196,2,2,0,0,0,253,57,0,196
1999,Hardin,TN,47071,169,51,2,0,116,2,0,2,0,0,167,51,0,116
1999,Hawkins,TN,47073,309,228,3,0,78,5,2,3,0,0,304,226,0,78
1999,Haywood,TN,47075,247,41,0,1,205,3,2,0,1,0,244,39,0,205
1999,Henderson,TN,47077,255,75,0,0,180,1,0,0,0,1,254,75,0,179
1999,Henry,TN,47079,214,82,1,0,131,4,3,1,0,0,210,79,0,131
1999,Hickman,TN,47081,149,72,0,0,77,1,0,0,0,1,148,72,0,76
1999,Houston,TN,47083,38,33,0,0,5,1,1,0,0,0,37,32,0,5
1999,Humphreys,TN,47085,113,62,1,0,50,5,4,1,0,0,108,58,0,50
1999,Jackson,TN,47087,39,33,0,0,6,0,0,0,0,0,39,33,0,6
1999,Jefferson,TN,47089,330,212,3,0,115,4,1,3,0,0,326,211,0,115
1999,Johnson,TN,47091,67,44,0,0,23,0,0,0,0,0,67,44,0,23
1999,Knox,TN,47093,2022,1292,17,0,713,51,24,17,0,10,1971,1268,0,703
1999,Lake,TN,47095,49,18,0,0,31,2,0,0,0,2,47,18,0,29
1999,Lauderdale,TN,47097,344,77,3,0,264,5,2,3,0,0,339,75,0,264
1999,Lawrence,TN,47099,244,134,1,1,108,4,2,0,1,1,240,132,1,107
1999,Lewis,TN,47101,67,41,2,0,24,3,2,1,0,0,64,39,1,24
1999,Lincoln,TN,47103,109,50,1,0,58,4,2,1,0,1,105,48,0,57
1999,Loudon,TN,47105,274,163,1,0,110,2,0,1,0,1,272,163,0,109
1999,McMinn,TN,47107,326,161,0,0,165,2,0,0,0,2,324,161,0,163
1999,McNairy,TN,47109,165,83,0,0,82,2,1,0,0,1,163,82,0,81
1999,Macon,TN,47111,55,28,0,0,27,1,1,0,0,0,54,27,0,27
1999,Madison,TN,47113,807,236,3,0,568,11,5,2,0,4,796,231,1,564
1999,Marion,TN,47115,185,75,0,0,110,1,0,0,0,1,184,75,0,109
1999,Marshall,TN,47117,176,92,0,0,84,0,0,0,0,0,176,92,0,84
1999,Maury,TN,47119,479,271,4,0,204,7,2,4,0,1,472,269,0,203
1999,Meigs,TN,47121,62,28,0,0,34,0,0,0,0,0,62,28,0,34
1999,Monroe,TN,47123,256,129,2,0,125,2,0,2,0,0,254,129,0,125
1999,Montgomery,TN,47125,839,603,4,1,231,14,6,3,1,4,825,597,1,227
1999,Moore,TN,47127,11,1,0,0,10,0,0,0,0,0,11,1,0,10
1999,Morgan,TN,47129,110,78,0,0,32,1,1,0,0,0,109,77,0,32
1999,Obion,TN,47131,223,104,2,0,117,3,1,2,0,0,220,103,0,117
1999,Overton,TN,47133,93,65,1,0,27,3,2,0,0,1,90,63,1,26
1999,Perry,TN,47135,44,15,0,0,29,3,2,0,0,1,41,13,0,28
1999,Pickett,TN,47137,10,10,0,0,0,0,0,0,0,0,10,10,0,0
1999,Polk,TN,47139,104,32,0,0,72,1,1,0,0,0,103,31,0,72
1999,Putnam,TN,47141,263,219,1,1,42,11,8,1,1,1,252,211,0,41
1999,Rhea,TN,47143,320,125,0,0,195,1,1,0,0,0,319,124,0,195
1999,Roane,TN,47145,310,215,2,0,93,2,0,2,0,0,308,215,0,93
1999,Robertson,TN,47147,363,203,3,1,156,6,2,1,1,2,357,201,2,154
1999,Rutherford,TN,47149,1101,652,7,0,442,14,9,3,0,2,1087,643,4,440
1999,Scott,TN,47151,111,76,1,0,34,4,1,1,0,2,107,75,0,32
1999,Sequatchie,TN,47153,48,22,1,0,25,1,0,1,0,0,47,22,0,25
1999,Sevier,TN,47155,451,308,7,0,136,14,5,7,0,2,437,303,0,134
1999,Shelby,TN,47157,13812,3192,163,0,10457,231,45,162,0,24,13581,3147,1,10433
1999,Smith,TN,47159,52,35,0,0,17,1,1,0,0,0,51,34,0,17
1999,Stewart,TN,47161,60,45,0,0,15,2,2,0,0,0,58,43,0,15
1999,Sullivan,TN,47163,868,745,3,0,120,15,12,3,0,0,853,733,0,120
1999,Sumner,TN,47165,759,427,6,0,326,16,9,4,0,3,743,418,2,323
1999,Tipton,TN,47167,541,195,0,0,346,4,4,0,0,0,537,191,0,346
1999,Trousdale,TN,47169,45,22,0,0,23,0,0,0,0,0,45,22,0,23
1999,Unicoi,TN,47171,75,54,0,0,21,1,0,0,0,1,74,54,0,20
1999,Union,TN,47173,104,62,0,0,42,1,0,0,0,1,103,62,0,41
1999,Van Buren,TN,47175,18,7,2,0,9,0,0,0,0,0,18,7,2,9
1999,Warren,TN,47177,198,96,0,1,101,3,2,0,1,0,195,94,0,101
1999,Washington,TN,47179,586,446,2,0,138,19,13,0,0,6,567,433,2,132
1999,Wayne,TN,47181,56,25,3,0,28,4,1,3,0,0,52,24,0,28
1999,Weakley,TN,47183,184,103,2,0,79,7,4,2,0,1,177,99,0,78
1999,White,TN,47185,152,73,0,0,79,2,2,0,0,0,150,71,0,79
1999,Williamson,TN,47187,380,224,41,0,115,57,19,38,0,0,323,205,3,115
1999,Wilson,TN,47189,422,249,8,0,165,12,5,6,0,1,410,244,2,164
1999,Anderson,TX,48001,206,106,0,0,100,7,5,0,0,2,199,101,0,98
1999,Andrews,TX,48003,57,46,1,0,10,3,1,1,0,1,54,45,0,9
1999,Angelina,TX,48005,235,103,0,0,132,13,5,0,0,8,222,98,0,124
1999,Aransas,TX,48007,51,22,1,0,28,6,1,1,0,4,45,21,0,24
1999,Archer,TX,48009,34,16,0,1,17,2,1,0,1,0,32,15,0,17
1999,Armstrong,TX,48011,7,5,0,0,2,0,0,0,0,0,7,5,0,2
1999,Atascosa,TX,48013,113,72,0,2,39,6,4,0,2,0,107,68,0,39
1999,Austin,TX,48015,56,39,0,0,17,0,0,0,0,0,56,39,0,17
1999,Bailey,TX,48017,24,19,0,2,3,4,2,0,2,0,20,17,0,3
1999,Bandera,TX,48019,57,41,2,0,14,2,0,2,0,0,55,41,0,14
1999,Bastrop,TX,48021,198,113,1,0,84,4,2,1,0,1,194,111,0,83
1999,Baylor,TX,48023,9,5,0,0,4,0,0,0,0,0,9,5,0,4
1999,Bee,TX,48025,88,32,1,0,55,3,1,1,0,1,85,31,0,54
1999,Bell,TX,48027,1344,705,3,0,636,3,1,2,0,0,1341,704,1,636
1999,Bexar,TX,48029,4353,2527,41,0,1785,126,77,40,0,9,4227,2450,1,1776
1999,Blanco,TX,48031,25,18,0,0,7,0,0,0,0,0,25,18,0,7
1999,Borden,TX,48033,0,0,0,0,0,,,,,,,,,
1999,Bosque,TX,48035,38,24,0,0,14,1,1,0,0,0,37,23,0,14
1999,Bowie,TX,48037,334,210,1,0,123,3,1,1,0,1,331,209,0,122
1999,Brazoria,TX,48039,580,400,7,0,173,15,9,6,0,0,565,391,1,173
1999,Brazos,TX,48041,190,158,3,0,29,9,5,3,0,1,181,153,0,28
1999,Brewster,TX,48043,9,9,0,0,0,0,0,0,0,0,9,9,0,0
1999,Briscoe,TX,48045,4,4,0,0,0,0,0,0,0,0,4,4,0,0
1999,Brooks,TX,48047,8,1,0,0,7,0,0,0,0,0,8,1,0,7
1999,Brown,TX,48049,99,70,0,1,28,5,4,0,1,0,94,66,0,28
1999,Burleson,TX,48051,25,17,0,0,8,1,1,0,0,0,24,16,0,8
1999,Burnet,TX,48053,101,74,0,0,27,1,1,0,0,0,100,73,0,27
1999,Caldwell,TX,48055,103,58,1,0,44,4,1,1,0,2,99,57,0,42
1999,Calhoun,TX,48057,43,25,0,0,18,0,0,0,0,0,43,25,0,18
1999,Callahan,TX,48059,62,31,0,0,31,2,1,0,0,1,60,30,0,30
1999,Cameron,TX,48061,981,478,13,1,489,45,15,13,1,16,936,463,0,473
1999,Camp,TX,48063,33,15,1,0,17,2,1,1,0,0,31,14,0,17
1999,Carson,TX,48065,15,12,0,0,3,1,1,0,0,0,14,11,0,3
1999,Cass,TX,48067,137,68,0,0,69,1,1,0,0,0,136,67,0,69
1999,Castro,TX,48069,19,10,1,0,8,4,2,1,0,1,15,8,0,7
1999,Chambers,TX,48071,40,21,1,0,18,6,3,1,0,2,34,18,0,16
1999,Cherokee,TX,48073,147,54,1,0,92,7,3,1,0,3,140,51,0,89
1999,Childress,TX,48075,16,8,0,0,8,2,1,0,0,1,14,7,0,7
1999,Clay,TX,48077,36,14,0,0,22,2,2,0,0,0,34,12,0,22
1999,Cochran,TX,48079,12,8,0,0,4,1,1,0,0,0,11,7,0,4
1999,Coke,TX,48081,10,7,1,0,2,3,1,1,0,1,7,6,0,1
1999,Coleman,TX,48083,19,11,0,0,8,1,1,0,0,0,18,10,0,8
1999,Collin,TX,48085,1404,814,8,1,581,49,30,8,1,10,1355,784,0,571
1999,Collingsworth,TX,48087,20,16,0,0,4,1,0,0,0,1,19,16,0,3
1999,Colorado,TX,48089,37,25,0,0,12,0,0,0,0,0,37,25,0,12
1999,Comal,TX,48091,200,141,4,0,55,9,4,4,0,1,191,137,0,54
1999,Comanche,TX,48093,23,12,0,0,11,3,2,0,0,1,20,10,0,10
1999,Concho,TX,48095,10,5,0,0,5,1,0,0,0,1,9,5,0,4
1999,Cooke,TX,48097,81,54,1,0,26,3,1,1,0,1,78,53,0,25
1999,Coryell,TX,48099,326,188,0,0,138,2,2,0,0,0,324,186,0,138
1999,Cottle,TX,48101,8,6,0,2,0,3,1,0,2,0,5,5,0,0
1999,Crane,TX,48103,9,7,0,0,2,0,0,0,0,0,9,7,0,2
1999,Crockett,TX,48105,11,4,0,0,7,0,0,0,0,0,11,4,0,7
1999,Crosby,TX,48107,22,19,0,1,2,2,1,0,1,0,20,18,0,2
1999,Culberson,TX,48109,2,1,0,0,1,1,1,0,0,0,1,0,0,1
1999,Dallam,TX,48111,19,17,0,0,2,0,0,0,0,0,19,17,0,2
1999,Dallas,TX,48113,8172,3900,162,0,4110,403,171,160,0,72,7769,3729,2,4038
1999,Dawson,TX,48115,52,31,0,0,21,2,1,0,0,1,50,30,0,20
1999,Deaf Smith,TX,48117,55,35,1,0,19,2,1,1,0,0,53,34,0,19
1999,Delta,TX,48119,7,3,0,0,4,0,0,0,0,0,7,3,0,4
1999,Denton,TX,48121,1293,694,9,1,589,53,32,9,1,11,1240,662,0,578
1999,DeWitt,TX,48123,49,25,0,0,24,1,0,0,0,1,48,25,0,23
1999,Dickens,TX,48125,9,6,1,0,2,1,0,1,0,0,8,6,0,2
1999,Dimmit,TX,48127,12,9,0,0,3,0,0,0,0,0,12,9,0,3
1999,Donley,TX,48129,10,7,0,0,3,1,1,0,0,0,9,6,0,3
1999,Duval,TX,48131,42,6,0,0,36,1,0,0,0,1,41,6,0,35
1999,Eastland,TX,48133,48,31,0,0,17,2,1,0,0,1,46,30,0,16
1999,Ector,TX,48135,421,333,2,1,85,12,9,2,1,0,409,324,0,85
1999,Edwards,TX,48137,2,2,0,0,0,0,0,0,0,0,2,2,0,0
1999,Ellis,TX,48139,407,233,4,1,169,17,8,4,1,4,390,225,0,165
1999,El Paso,TX,48141,2722,888,10,3,1821,80,32,8,3,37,2642,856,2,1784
1999,Erath,TX,48143,48,31,2,0,15,2,0,2,0,0,46,31,0,15
1999,Falls,TX,48145,47,25,0,0,22,0,0,0,0,0,47,25,0,22
1999,Fannin,TX,48147,64,47,0,0,17,2,2,0,0,0,62,45,0,17
1999,Fayette,TX,48149,39,28,0,0,11,0,0,0,0,0,39,28,0,11
1999,Fisher,TX,48151,16,5,0,1,10,1,0,0,1,0,15,5,0,10
1999,Floyd,TX,48153,21,14,0,0,7,4,4,0,0,0,17,10,0,7
1999,Foard,TX,48155,3,0,0,0,3,0,0,0,0,0,3,0,0,3
1999,Fort Bend,TX,48157,765,369,3,0,393,10,5,3,0,2,755,364,0,391
1999,Franklin,TX,48159,27,13,0,0,14,0,0,0,0,0,27,13,0,14
1999,Freestone,TX,48161,37,24,0,0,13,0,0,0,0,0,37,24,0,13
1999,Frio,TX,48163,18,12,0,0,6,1,0,0,0,1,17,12,0,5
1999,Gaines,TX,48165,42,31,0,3,8,7,4,0,3,0,35,27,0,8
1999,Galveston,TX,48167,728,497,3,1,227,12,8,3,1,0,716,489,0,227
1999,Garza,TX,48169,9,7,0,1,1,1,0,0,1,0,8,7,0,1
1999,Gillespie,TX,48171,39,32,1,0,6,3,2,1,0,0,36,30,0,6
1999,Glasscock,TX,48173,1,0,0,0,1,0,0,0,0,0,1,0,0,1
1999,Goliad,TX,48175,15,10,0,0,5,0,0,0,0,0,15,10,0,5
1999,Gonzales,TX,48177,44,30,2,1,11,6,3,2,1,0,38,27,0,11
1999,Gray,TX,48179,67,52,0,0,15,4,2,0,0,2,63,50,0,13
1999,Grayson,TX,48181,468,238,2,0,228,14,9,2,0,3,454,229,0,225
1999,Gregg,TX,48183,336,153,7,0,176,22,9,6,0,7,314,144,1,169
1999,Grimes,TX,48185,32,18,0,0,14,1,0,0,0,1,31,18,0,13
1999,Guadalupe,TX,48187,195,136,1,0,58,4,3,1,0,0,191,133,0,58
1999,Hale,TX,48189,84,47,0,0,37,7,6,0,0,1,77,41,0,36
1999,Hall,TX,48191,8,4,0,0,4,3,2,0,0,1,5,2,0,3
1999,Hamilton,TX,48193,14,11,0,0,3,0,0,0,0,0,14,11,0,3
1999,Hansford,TX,48195,6,3,0,2,1,2,0,0,2,0,4,3,0,1
1999,Hardeman,TX,48197,20,11,0,0,9,1,0,0,0,1,19,11,0,8
1999,Hardin,TX,48199,163,70,0,0,93,1,0,0,0,1,162,70,0,92
1999,Harris,TX,48201,9154,5276,238,2,3638,396,151,233,2,10,8758,5125,5,3628
1999,Harrison,TX,48203,245,88,1,0,156,10,4,1,0,5,235,84,0,151
1999,Hartley,TX,48205,5,2,0,0,3,0,0,0,0,0,5,2,0,3
1999,Haskell,TX,48207,25,14,0,5,6,6,1,0,5,0,19,13,0,6
1999,Hays,TX,48209,265,157,1,0,107,4,3,1,0,0,261,154,0,107
1999,Hemphill,TX,48211,6,4,0,0,2,4,3,0,0,1,2,1,0,1
1999,Henderson,TX,48213,356,176,0,0,180,6,5,0,0,1,350,171,0,179
1999,Hidalgo,TX,48215,1047,519,22,0,506,77,32,19,0,26,970,487,3,480
1999,Hill,TX,48217,110,68,0,0,42,2,1,0,0,1,108,67,0,41
1999,Hockley,TX,48219,96,63,0,1,32,13,11,0,1,1,83,52,0,31
1999,Hood,TX,48221,146,90,0,0,56,2,2,0,0,0,144,88,0,56
1999,Hopkins,TX,48223,101,55,1,0,45,8,6,1,0,1,93,49,0,44
1999,Houston,TX,48225,50,23,0,1,26,2,1,0,1,0,48,22,0,26
1999,Howard,TX,48227,87,77,0,0,10,4,4,0,0,0,83,73,0,10
1999,Hudspeth,TX,48229,0,0,0,0,0,,,,,,,,,
1999,Hunt,TX,48231,194,104,0,0,90,3,2,0,0,1,191,102,0,89
1999,Hutchinson,TX,48233,75,55,0,0,20,0,0,0,0,0,75,55,0,20
1999,Irion,TX,48235,3,1,0,0,2,0,0,0,0,0,3,1,0,2
1999,Jack,TX,48237,22,11,0,0,11,1,0,0,0,1,21,11,0,10
1999,Jackson,TX,48239,43,29,0,0,14,0,0,0,0,0,43,29,0,14
1999,Jasper,TX,48241,132,46,3,0,83,4,1,3,0,0,128,45,0,83
1999,Jeff Davis,TX,48243,0,0,0,0,0,,,,,,,,,
1999,Jefferson,TX,48245,813,378,4,0,431,18,9,4,0,5,795,369,0,426
1999,Jim Hogg,TX,48247,6,3,0,0,3,1,0,0,0,1,5,3,0,2
1999,Jim Wells,TX,48249,144,41,4,0,99,12,4,4,0,4,132,37,0,95
1999,Johnson,TX,48251,580,308,2,1,269,12,6,2,1,3,568,302,0,266
1999,Jones,TX,48253,54,18,0,1,35,2,0,0,1,1,52,18,0,34
1999,Karnes,TX,48255,23,15,0,0,8,0,0,0,0,0,23,15,0,8
1999,Kaufman,TX,48257,228,118,0,0,110,8,7,0,0,1,220,111,0,109
1999,Kendall,TX,48259,52,38,2,0,12,4,2,2,0,0,48,36,0,12
1999,Kenedy,TX,48261,1,1,0,0,0,0,0,0,0,0,1,1,0,0
1999,Kent,TX,48263,0,0,0,0,0,,,,,,,,,
1999,Kerr,TX,48265,120,105,2,0,13,3,1,2,0,0,117,104,0,13
1999,Kimble,TX,48267,8,6,0,0,2,0,0,0,0,0,8,6,0,2
1999,King,TX,48269,0,0,0,0,0,,,,,,,,,
1999,Kinney,TX,48271,0,0,0,0,0,,,,,,,,,
1999,Kleberg,TX,48273,88,22,0,0,66,10,2,0,0,8,78,20,0,58
1999,Knox,TX,48275,8,2,0,0,6,1,0,0,0,1,7,2,0,5
1999,Lamar,TX,48277,109,86,0,2,21,4,2,0,2,0,105,84,0,21
1999,Lamb,TX,48279,69,43,0,0,26,11,9,0,0,2,58,34,0,24
1999,Lampasas,TX,48281,71,44,0,0,27,0,0,0,0,0,71,44,0,27
1999,La Salle,TX,48283,8,4,1,0,3,1,0,1,0,0,7,4,0,3
1999,Lavaca,TX,48285,14,10,0,0,4,0,0,0,0,0,14,10,0,4
1999,Lee,TX,48287,29,16,0,0,13,0,0,0,0,0,29,16,0,13
1999,Leon,TX,48289,27,20,0,0,7,1,0,0,0,1,26,20,0,6
1999,Liberty,TX,48291,144,87,5,0,52,11,5,5,0,1,133,82,0,51
1999,Limestone,TX,48293,66,40,0,0,26,1,1,0,0,0,65,39,0,26
1999,Lipscomb,TX,48295,6,6,0,0,0,1,1,0,0,0,5,5,0,0
1999,Live Oak,TX,48297,30,12,0,0,18,2,0,0,0,2,28,12,0,16
1999,Llano,TX,48299,44,33,0,0,11,1,1,0,0,0,43,32,0,11
1999,Loving,TX,48301,0,0,0,0,0,,,,,,,,,
1999,Lubbock,TX,48303,848,564,4,0,280,34,27,4,0,3,814,537,0,277
1999,Lynn,TX,48305,22,15,0,0,7,6,5,0,0,1,16,10,0,6
1999,McCulloch,TX,48307,23,18,0,0,5,3,2,0,0,1,20,16,0,4
1999,McLennan,TX,48309,781,463,5,0,313,11,5,5,0,1,770,458,0,312
1999,McMullen,TX,48311,0,0,0,0,0,,,,,,,,,
1999,Madison,TX,48313,19,17,0,0,2,0,0,0,0,0,19,17,0,2
1999,Marion,TX,48315,38,14,0,0,24,3,1,0,0,2,35,13,0,22
1999,Martin,TX,48317,19,13,0,0,6,0,0,0,0,0,19,13,0,6
1999,Mason,TX,48319,7,5,0,0,2,1,1,0,0,0,6,4,0,2
1999,Matagorda,TX,48321,78,61,0,0,17,1,1,0,0,0,77,60,0,17
1999,Maverick,TX,48323,35,33,0,0,2,3,2,0,0,1,32,31,0,1
1999,Medina,TX,48325,85,47,0,0,38,3,3,0,0,0,82,44,0,38
1999,Menard,TX,48327,6,4,0,1,1,1,0,0,1,0,5,4,0,1
1999,Midland,TX,48329,303,237,6,0,60,15,8,6,0,1,288,229,0,59
1999,Milam,TX,48331,56,39,0,1,16,1,0,0,1,0,55,39,0,16
1999,Mills,TX,48333,10,7,0,1,2,2,1,0,1,0,8,6,0,2
1999,Mitchell,TX,48335,14,11,0,0,3,2,2,0,0,0,12,9,0,3
1999,Montague,TX,48337,68,39,0,0,29,0,0,0,0,0,68,39,0,29
1999,Montgomery,TX,48339,510,382,9,0,119,14,4,9,0,1,496,378,0,118
1999,Moore,TX,48341,60,33,0,1,26,3,2,0,1,0,57,31,0,26
1999,Morris,TX,48343,28,14,0,0,14,4,3,0,0,1,24,11,0,13
1999,Motley,TX,48345,2,2,0,0,0,1,1,0,0,0,1,1,0,0
1999,Nacogdoches,TX,48347,111,58,3,0,50,11,3,3,0,5,100,55,0,45
1999,Navarro,TX,48349,98,50,1,0,47,5,4,1,0,0,93,46,0,47
1999,Newton,TX,48351,52,16,0,0,36,1,1,0,0,0,51,15,0,36
1999,Nolan,TX,48353,49,27,0,0,22,4,1,0,0,3,45,26,0,19
1999,Nueces,TX,48355,1132,499,17,0,616,68,18,16,0,34,1064,481,1,582
1999,Ochiltree,TX,48357,30,23,0,0,7,0,0,0,0,0,30,23,0,7
1999,Oldham,TX,48359,0,0,0,0,0,,,,,,,,,
1999,Orange,TX,48361,333,152,0,0,181,4,3,0,0,1,329,149,0,180
1999,Palo Pinto,TX,48363,69,51,1,0,17,2,1,1,0,0,67,50,0,17
1999,Panola,TX,48365,68,34,0,1,33,8,2,0,1,5,60,32,0,28
1999,Parker,TX,48367,407,186,2,0,219,10,7,2,0,1,397,179,0,218
1999,Parmer,TX,48369,26,17,1,2,6,6,3,1,2,0,20,14,0,6
1999,Pecos,TX,48371,17,13,0,1,3,1,0,0,1,0,16,13,0,3
1999,Polk,TX,48373,92,47,0,0,45,4,1,0,0,3,88,46,0,42
1999,Potter,TX,48375,453,288,1,0,164,9,6,1,0,2,444,282,0,162
1999,Presidio,TX,48377,0,0,0,0,0,,,,,,,,,
1999,Rains,TX,48379,36,22,0,0,14,1,0,0,0,1,35,22,0,13
1999,Randall,TX,48381,421,300,3,0,118,23,17,3,0,3,398,283,0,115
1999,Reagan,TX,48383,9,8,0,0,1,0,0,0,0,0,9,8,0,1
1999,Real,TX,48385,3,3,0,0,0,0,0,0,0,0,3,3,0,0
1999,Red River,TX,48387,27,19,0,0,8,1,1,0,0,0,26,18,0,8
1999,Reeves,TX,48389,16,13,0,0,3,0,0,0,0,0,16,13,0,3
1999,Refugio,TX,48391,16,8,0,0,8,0,0,0,0,0,16,8,0,8
1999,Roberts,TX,48393,0,0,0,0,0,,,,,,,,,
1999,Robertson,TX,48395,14,7,0,0,7,0,0,0,0,0,14,7,0,7
1999,Rockwall,TX,48397,134,75,2,0,57,11,4,2,0,5,123,71,0,52
1999,Runnels,TX,48399,40,21,0,0,19,4,2,0,0,2,36,19,0,17
1999,Rusk,TX,48401,102,39,0,0,63,6,3,0,0,3,96,36,0,60
1999,Sabine,TX,48403,32,16,0,0,16,2,0,0,0,2,30,16,0,14
1999,San Augustine,TX,48405,17,9,0,0,8,0,0,0,0,0,17,9,0,8
1999,San Jacinto,TX,48407,33,24,0,0,9,0,0,0,0,0,33,24,0,9
1999,San Patricio,TX,48409,167,71,1,0,95,12,1,1,0,10,155,70,0,85
1999,San Saba,TX,48411,5,5,0,0,0,0,0,0,0,0,5,5,0,0
1999,Schleicher,TX,48413,11,8,0,1,2,1,0,0,1,0,10,8,0,2
1999,Scurry,TX,48415,55,43,0,0,12,3,3,0,0,0,52,40,0,12
1999,Shackelford,TX,48417,4,2,0,0,2,0,0,0,0,0,4,2,0,2
1999,Shelby,TX,48419,51,24,0,2,25,7,2,0,2,3,44,22,0,22
1999,Sherman,TX,48421,4,2,0,2,0,3,1,0,2,0,1,1,0,0
1999,Smith,TX,48423,691,332,5,1,353,22,11,5,1,5,669,321,0,348
1999,Somervell,TX,48425,7,6,0,0,1,0,0,0,0,0,7,6,0,1
1999,Starr,TX,48427,55,33,0,0,22,2,1,0,0,1,53,32,0,21
1999,Stephens,TX,48429,7,5,0,0,2,0,0,0,0,0,7,5,0,2
1999,Sterling,TX,48431,0,0,0,0,0,,,,,,,,,
1999,Stonewall,TX,48433,9,2,0,0,7,1,1,0,0,0,8,1,0,7
1999,Sutton,TX,48435,7,7,0,0,0,0,0,0,0,0,7,7,0,0
1999,Swisher,TX,48437,35,21,0,0,14,6,5,0,0,1,29,16,0,13
1999,Tarrant,TX,48439,5473,2798,35,0,2640,142,82,33,0,26,5332,2716,2,2614
1999,Taylor,TX,48441,598,233,2,0,363,22,5,2,0,15,576,228,0,348
1999,Terrell,TX,48443,2,2,0,0,0,0,0,0,0,0,2,2,0,0
1999,Terry,TX,48445,46,26,0,2,18,5,2,0,2,1,41,24,0,17
1999,Throckmorton,TX,48447,3,1,0,0,2,0,0,0,0,0,3,1,0,2
1999,Titus,TX,48449,61,20,1,1,39,4,1,1,1,1,57,19,0,38
1999,Tom Green,TX,48451,378,214,0,1,163,22,13,0,1,8,356,201,0,155
1999,Travis,TX,48453,2626,1636,29,0,961,104,66,29,0,9,2522,1570,0,952
1999,Trinity,TX,48455,26,12,0,0,14,0,0,0,0,0,26,12,0,14
1999,Tyler,TX,48457,65,24,0,0,41,1,0,0,0,1,64,24,0,40
1999,Upshur,TX,48459,104,49,1,1,53,2,0,1,1,0,102,49,0,53
1999,Upton,TX,48461,5,3,0,0,2,0,0,0,0,0,5,3,0,2
1999,Uvalde,TX,48463,27,19,0,0,8,1,1,0,0,0,26,18,0,8
1999,Val Verde,TX,48465,77,67,2,0,8,3,1,2,0,0,74,66,0,8
1999,Van Zandt,TX,48467,189,103,0,0,86,2,1,0,0,1,187,102,0,85
1999,Victoria,TX,48469,224,153,3,0,68,8,4,3,0,1,216,149,0,67
1999,Walker,TX,48471,100,76,0,0,24,1,0,0,0,1,99,76,0,23
1999,Waller,TX,48473,108,61,0,1,46,3,2,0,1,0,105,59,0,46
1999,Ward,TX,48475,13,10,0,0,3,1,0,0,0,1,12,10,0,2
1999,Washington,TX,48477,32,26,1,0,5,2,1,1,0,0,30,25,0,5
1999,Webb,TX,48479,593,347,4,0,242,15,7,4,0,4,578,340,0,238
1999,Wharton,TX,48481,74,51,0,1,22,2,1,0,1,0,72,50,0,22
1999,Wheeler,TX,48483,12,9,0,0,3,0,0,0,0,0,12,9,0,3
1999,Wichita,TX,48485,727,287,1,0,439,12,6,1,0,5,715,281,0,434
1999,Wilbarger,TX,48487,55,26,0,0,29,0,0,0,0,0,55,26,0,29
1999,Willacy,TX,48489,41,15,0,1,25,3,1,0,1,1,38,14,0,24
1999,Williamson,TX,48491,802,500,7,0,295,18,10,7,0,1,784,490,0,294
1999,Wilson,TX,48493,90,59,2,2,27,8,3,2,2,1,82,56,0,26
1999,Winkler,TX,48495,22,15,0,0,7,0,0,0,0,0,22,15,0,7
1999,Wise,TX,48497,187,84,1,0,102,4,3,0,0,1,183,81,1,101
1999,Wood,TX,48499,140,76,1,0,63,6,4,1,0,1,134,72,0,62
1999,Yoakum,TX,48501,23,11,1,1,10,3,1,1,1,0,20,10,0,10
1999,Young,TX,48503,62,33,1,0,28,1,0,1,0,0,61,33,0,28
1999,Zapata,TX,48505,16,6,0,0,10,0,0,0,0,0,16,6,0,10
1999,Zavala,TX,48507,4,1,0,0,3,1,0,0,0,1,3,1,0,2
1999,Beaver,UT,49001,19,14,0,0,5,2,2,0,0,0,17,12,0,5
1999,Box Elder,UT,49003,260,164,0,1,95,4,3,0,1,0,256,161,0,95
1999,Cache,UT,49005,322,214,2,0,106,10,6,2,0,2,312,208,0,104
1999,Carbon,UT,49007,115,78,1,0,36,7,3,1,0,3,108,75,0,33
1999,Daggett,UT,49009,3,1,0,0,2,1,0,0,0,1,2,1,0,1
1999,Davis,UT,49011,1549,983,0,0,566,27,19,0,0,8,1522,964,0,558
1999,Duchesne,UT,49013,74,46,0,0,28,1,1,0,0,0,73,45,0,28
1999,Emery,UT,49015,42,25,0,1,16,1,0,0,1,0,41,25,0,16
1999,Garfield,UT,49017,12,8,0,0,4,0,0,0,0,0,12,8,0,4
1999,Grand,UT,49019,19,16,0,0,3,0,0,0,0,0,19,16,0,3
1999,Iron,UT,49021,125,84,1,0,40,2,1,1,0,0,123,83,0,40
1999,Juab,UT,49023,37,23,0,0,14,3,2,0,0,1,34,21,0,13
1999,Kane,UT,49025,13,11,0,0,2,0,0,0,0,0,13,11,0,2
1999,Millard,UT,49027,34,29,0,1,4,3,2,0,1,0,31,27,0,4
1999,Morgan,UT,49029,14,6,1,0,7,2,1,1,0,0,12,5,0,7
1999,Piute,UT,49031,4,2,0,0,2,0,0,0,0,0,4,2,0,2
1999,Rich,UT,49033,0,0,0,0,0,,,,,,,,,
1999,Salt Lake,UT,49035,6705,3877,32,1,2795,211,114,31,1,65,6494,3763,1,2730
1999,San Juan,UT,49037,13,12,0,0,1,0,0,0,0,0,13,12,0,1
1999,Sanpete,UT,49039,90,48,0,1,41,8,3,0,1,4,82,45,0,37
1999,Sevier,UT,49041,85,56,0,0,29,7,4,0,0,3,78,52,0,26
1999,Summit,UT,49043,90,54,4,0,32,10,3,4,0,3,80,51,0,29
1999,Tooele,UT,49045,363,191,0,0,172,8,7,0,0,1,355,184,0,171
1999,Uintah,UT,49047,114,77,0,0,37,2,2,0,0,0,112,75,0,37
1999,Utah,UT,49049,1821,1228,10,1,582,107,63,10,1,33,1714,1165,0,549
1999,Wasatch,UT,49051,73,29,3,0,41,8,2,3,0,3,65,27,0,38
1999,Washington,UT,49053,450,337,0,0,113,8,8,0,0,0,442,329,0,113
1999,Wayne,UT,49055,11,8,0,0,3,0,0,0,0,0,11,8,0,3
1999,Weber,UT,49057,1621,1045,5,3,568,34,18,4,3,9,1587,1027,1,559
1999,Addison,VT,50001,108,95,0,3,10,6,2,0,3,1,102,93,0,9
1999,Bennington,VT,50003,98,94,0,0,4,5,5,0,0,0,93,89,0,4
1999,Caledonia,VT,50005,48,45,0,0,3,2,2,0,0,0,46,43,0,3
1999,Chittenden,VT,50007,464,428,2,1,33,17,13,2,1,1,447,415,0,32
1999,Essex,VT,50009,13,13,0,0,0,0,0,0,0,0,13,13,0,0
1999,Franklin,VT,50011,192,176,1,2,13,5,2,1,2,0,187,174,0,13
1999,Grand Isle,VT,50013,22,21,0,0,1,0,0,0,0,0,22,21,0,1
1999,Lamoille,VT,50015,64,60,0,2,2,5,2,0,2,1,59,58,0,1
1999,Orange,VT,50017,57,43,2,0,12,3,1,2,0,0,54,42,0,12
1999,Orleans,VT,50019,59,50,0,0,9,5,2,0,0,3,54,48,0,6
1999,Rutland,VT,50021,222,200,5,1,16,10,1,5,1,3,212,199,0,13
1999,Washington,VT,50023,166,150,1,0,15,9,7,1,0,1,157,143,0,14
1999,Windham,VT,50025,111,102,0,0,9,6,5,0,0,1,105,97,0,8
1999,Windsor,VT,50027,121,106,1,0,14,7,3,1,0,3,114,103,0,11
1999,Accomack,VA,51001,124,98,0,0,26,2,2,0,0,0,122,96,0,26
1999,Albemarle,VA,51003,234,206,1,0,27,3,2,0,0,1,231,204,1,26
1999,Alexandria city,VA,51005,79,72,0,0,7,4,3,0,0,1,75,69,0,6
1999,Alleghany,VA,51007,81,55,0,0,26,0,0,0,0,0,81,55,0,26
1999,Amelia,VA,51009,185,111,0,0,74,1,1,0,0,0,184,110,0,74
1999,Amherst,VA,51011,101,51,1,0,49,2,0,1,0,1,99,51,0,48
1999,Appomattox,VA,51013,569,501,4,0,64,10,6,4,0,0,559,495,0,64
1999,Arlington,VA,51015,266,251,0,0,15,24,22,0,0,2,242,229,0,13
1999,Augusta,VA,51017,11,11,0,0,0,1,1,0,0,0,10,10,0,0
1999,Bath,VA,51019,271,185,0,2,84,9,6,0,2,1,262,179,0,83
1999,Bedford city,VA,51021,39,35,0,0,4,1,1,0,0,0,38,34,0,4
1999,Bedford,VA,51023,139,104,0,0,35,9,7,0,0,2,130,97,0,33
1999,Bland,VA,51025,82,61,1,0,20,1,0,1,0,0,81,61,0,20
1999,Botetourt,VA,51027,98,83,0,0,15,10,9,0,0,1,88,74,0,14
1999,Bristol city,VA,51029,91,66,1,0,24,3,2,1,0,0,88,64,0,24
1999,Brunswick,VA,51031,300,172,0,0,128,4,4,0,0,0,296,168,0,128
1999,Buchanan,VA,51033,175,128,0,0,47,2,2,0,0,0,173,126,0,47
1999,Buckingham,VA,51035,111,98,0,0,13,3,3,0,0,0,108,95,0,13
1999,Buena Vista city,VA,51036,50,30,0,0,20,0,0,0,0,0,50,30,0,20
1999,Campbell,VA,51037,56,45,0,0,11,1,1,0,0,0,55,44,0,11
1999,Caroline,VA,51041,1706,1114,6,0,586,18,10,5,0,3,1688,1104,1,583
1999,Carroll,VA,51043,40,31,0,4,5,7,2,0,4,1,33,29,0,4
1999,Charles City,VA,51045,19,15,0,0,4,1,1,0,0,0,18,14,0,4
1999,Charlotte,VA,51047,190,157,0,0,33,4,3,0,0,1,186,154,0,32
1999,Charlottesville city,VA,51049,52,42,0,0,10,0,0,0,0,0,52,42,0,10
1999,Chesapeake city,VA,51051,52,40,0,0,12,5,4,0,0,1,47,36,0,11
1999,Chesterfield,VA,51053,150,105,0,0,45,0,0,0,0,0,150,105,0,45
1999,Clarke,VA,51057,44,36,0,0,8,0,0,0,0,0,44,36,0,8
1999,Colonial Heights city,VA,51061,253,207,3,1,42,4,1,1,1,1,249,206,2,41
1999,Covington city,VA,51063,39,32,0,0,7,2,2,0,0,0,37,30,0,7
1999,Craig,VA,51065,86,75,0,0,11,1,1,0,0,0,85,74,0,11
1999,Culpeper,VA,51067,286,228,1,0,57,14,13,0,0,1,272,215,1,56
1999,Cumberland,VA,51069,307,293,0,0,14,28,27,0,0,1,279,266,0,13
1999,Danville city,VA,51071,90,77,0,0,13,4,4,0,0,0,86,73,0,13
1999,Dickenson,VA,51073,197,130,1,0,66,2,1,1,0,0,195,129,0,66
1999,Dinwiddie,VA,51075,82,55,0,0,27,0,0,0,0,0,82,55,0,27
1999,Emporia city,VA,51077,65,57,0,0,8,6,6,0,0,0,59,51,0,8
1999,Essex,VA,51079,73,67,1,0,5,5,4,1,0,0,68,63,0,5
1999,Fairfax city,VA,51081,52,37,0,0,15,0,0,0,0,0,52,37,0,15
1999,Fairfax,VA,51083,194,136,0,0,58,2,2,0,0,0,192,134,0,58
1999,Falls Church city,VA,51085,334,243,1,0,90,16,15,1,0,0,318,228,0,90
1999,Fauquier,VA,51087,1709,1080,2,0,627,19,14,2,0,3,1690,1066,0,624
1999,Floyd,VA,51089,244,225,1,0,18,6,5,1,0,0,238,220,0,18
1999,Fluvanna,VA,51091,3,3,0,0,0,0,0,0,0,0,3,3,0,0
1999,Franklin city,VA,51093,202,127,0,2,73,2,0,0,2,0,200,127,0,73
1999,Franklin,VA,51095,201,141,3,0,57,3,0,3,0,0,198,141,0,57
1999,Frederick,VA,51097,38,27,0,0,11,1,1,0,0,0,37,26,0,11
1999,Fredericksburg city,VA,51099,72,53,1,0,18,1,0,1,0,0,71,53,0,18
1999,Galax city,VA,51101,85,46,0,0,39,0,0,0,0,0,85,46,0,39
1999,Giles,VA,51103,44,29,1,0,14,1,0,1,0,0,43,29,0,14
1999,Gloucester,VA,51105,99,89,1,0,9,5,4,1,0,0,94,85,0,9
1999,Goochland,VA,51107,459,405,4,0,50,6,3,2,0,1,453,402,2,49
1999,Grayson,VA,51109,123,105,2,0,16,2,0,2,0,0,121,105,0,16
1999,Greene,VA,51111,52,37,0,1,14,1,0,0,1,0,51,37,0,14
1999,Greensville,VA,51113,31,28,0,0,3,2,2,0,0,0,29,26,0,3
1999,Halifax,VA,51115,38,30,0,0,8,0,0,0,0,0,38,30,0,8
1999,Hampton city,VA,51117,173,134,0,0,39,0,0,0,0,0,173,134,0,39
1999,Hanover,VA,51119,21,14,0,0,7,0,0,0,0,0,21,14,0,7
1999,Harrisonburg city,VA,51121,272,242,2,0,28,15,11,2,0,2,257,231,0,26
1999,Henrico,VA,51125,62,44,0,0,18,1,1,0,0,0,61,43,0,18
1999,Henry,VA,51127,60,38,0,0,22,0,0,0,0,0,60,38,0,22
1999,Highland,VA,51131,43,35,0,0,8,0,0,0,0,0,43,35,0,8
1999,Hopewell city,VA,51133,36,20,1,0,15,1,0,1,0,0,35,20,0,15
1999,Isle of Wight,VA,51135,77,56,0,0,21,0,0,0,0,0,77,56,0,21
1999,James City,VA,51137,150,136,3,0,11,4,1,3,0,0,146,135,0,11
1999,King and Queen,VA,51139,122,116,1,0,5,13,10,1,0,2,109,106,0,3
1999,King George,VA,51141,31,24,0,0,7,0,0,0,0,0,31,24,0,7
1999,King William,VA,51143,264,199,0,0,65,5,4,0,0,1,259,195,0,64
1999,Lancaster,VA,51145,114,83,0,0,31,0,0,0,0,0,114,83,0,31
1999,Lee,VA,51147,89,60,0,0,29,0,0,0,0,0,89,60,0,29
1999,Lexington city,VA,51149,163,126,0,0,37,1,1,0,0,0,162,125,0,37
1999,Loudoun,VA,51153,1984,1666,10,1,307,25,14,10,1,0,1959,1652,0,307
1999,Louisa,VA,51155,215,197,0,0,18,3,2,0,0,1,212,195,0,17
1999,Lunenburg,VA,51157,32,30,0,0,2,2,2,0,0,0,30,28,0,2
1999,Lynchburg city,VA,51159,20,15,0,0,5,0,0,0,0,0,20,15,0,5
1999,Madison,VA,51161,432,334,1,0,97,24,19,1,0,4,408,315,0,93
1999,Manassas city,VA,51163,65,61,0,0,4,6,6,0,0,0,59,55,0,4
1999,Manassas Park city,VA,51165,248,239,0,0,9,15,15,0,0,0,233,224,0,9
1999,Martinsville city,VA,51167,113,90,4,0,19,12,8,4,0,0,101,82,0,19
1999,Mathews,VA,51169,108,90,2,0,16,8,5,2,0,1,100,85,0,15
1999,Mecklenburg,VA,51171,128,125,1,0,2,17,16,1,0,0,111,109,0,2
1999,Middlesex,VA,51173,154,129,2,0,23,9,6,2,0,1,145,123,0,22
1999,Montgomery,VA,51175,118,77,0,3,38,4,1,0,3,0,114,76,0,38
1999,Nelson,VA,51177,762,619,4,0,139,11,5,4,0,2,751,614,0,137
1999,New Kent,VA,51179,461,400,3,0,58,7,5,2,0,0,454,395,1,58
1999,Newport News city,VA,51181,49,35,0,0,14,0,0,0,0,0,49,35,0,14
1999,Norfolk city,VA,51183,58,43,0,0,15,1,0,0,0,1,57,43,0,14
1999,Northampton,VA,51185,249,233,2,0,14,16,14,2,0,0,233,219,0,14
1999,Northumberland,VA,51187,187,167,0,0,20,15,10,0,0,5,172,157,0,15
1999,Norton city,VA,51191,245,210,3,0,32,21,12,3,0,6,224,198,0,26
1999,Nottoway,VA,51193,76,53,0,0,23,0,0,0,0,0,76,53,0,23
1999,Orange,VA,51195,280,236,0,0,44,10,8,0,0,2,270,228,0,42
1999,Page,VA,51197,148,125,1,0,22,9,5,1,0,3,139,120,0,19
1999,Patrick,VA,51199,196,150,2,0,44,2,0,2,0,0,194,150,0,44
1999,Petersburg city,VA,51510,509,461,6,0,42,14,8,6,0,0,495,453,0,42
1999,Pittsylvania,VA,51515,145,96,1,0,48,6,1,1,0,4,139,95,0,44
1999,Poquoson city,VA,51520,68,61,1,0,6,5,4,1,0,0,63,57,0,6
1999,Portsmouth city,VA,51530,25,23,0,0,2,0,0,0,0,0,25,23,0,2
1999,Powhatan,VA,51540,161,145,2,0,14,9,5,2,0,2,152,140,0,12
1999,Prince Edward,VA,51550,1391,852,5,0,534,22,16,5,0,1,1369,836,0,533
1999,Prince George,VA,51560,9,8,0,0,1,0,0,0,0,0,9,8,0,1
1999,Prince William,VA,51570,153,121,0,0,32,3,3,0,0,0,150,118,0,32
1999,Pulaski,VA,51580,18,17,0,0,1,2,2,0,0,0,16,15,0,1
1999,Radford city,VA,51590,294,234,0,0,60,3,2,0,0,1,291,232,0,59
1999,Rappahannock,VA,51595,0,0,0,0,0,,,,,,,,,
1999,Richmond city,VA,51600,184,163,6,0,15,8,5,3,0,0,176,158,3,15
1999,Richmond,VA,51610,8,7,0,0,1,0,0,0,0,0,8,7,0,1
1999,Roanoke city,VA,51620,56,38,0,0,18,0,0,0,0,0,56,38,0,18
1999,Roanoke,VA,51630,106,90,1,0,15,4,2,1,0,1,102,88,0,14
1999,Rockbridge,VA,51640,2,2,0,0,0,0,0,0,0,0,2,2,0,0
1999,Rockingham,VA,51650,1086,644,2,0,440,12,6,2,0,4,1074,638,0,436
1999,Russell,VA,51660,22,22,0,0,0,0,0,0,0,0,22,22,0,0
1999,Salem city,VA,51670,223,168,0,0,55,0,0,0,0,0,223,168,0,55
1999,Scott,VA,51678,0,0,0,0,0,,,,,,,,,
1999,Shenandoah,VA,51680,467,293,2,0,172,10,7,2,0,1,457,286,0,171
1999,Smyth,VA,51683,24,19,0,0,5,1,1,0,0,0,23,18,0,5
1999,Southampton,VA,51685,16,13,1,0,2,0,0,0,0,0,16,13,1,2
1999,Spotsylvania,VA,51690,170,137,8,0,25,10,2,8,0,0,160,135,0,25
1999,Stafford,VA,51700,1405,948,5,0,452,14,6,5,0,3,1391,942,0,449
1999,Staunton city,VA,51710,1798,1165,8,0,625,22,15,6,0,1,1776,1150,2,624
1999,Suffolk city,VA,51720,0,0,0,0,0,,,,,,,,,
1999,Surry,VA,51730,357,220,2,0,135,4,2,2,0,0,353,218,0,135
1999,Sussex,VA,51735,0,0,0,0,0,,,,,,,,,
1999,Tazewell,VA,51740,888,565,1,0,322,5,4,1,0,0,883,561,0,322
1999,Virginia Beach city,VA,51750,65,59,0,0,6,1,0,0,0,1,64,59,0,5
1999,Warren,VA,51760,1722,1012,4,0,706,13,6,3,0,4,1709,1006,1,702
1999,Washington,VA,51770,910,711,0,0,199,33,21,0,0,12,877,690,0,187
1999,Waynesboro city,VA,51775,150,131,2,0,17,10,8,2,0,0,140,123,0,17
1999,Westmoreland,VA,51790,85,82,0,0,3,7,7,0,0,0,78,75,0,3
1999,Williamsburg city,VA,51800,517,313,2,0,202,3,0,2,0,1,514,313,0,201
1999,Winchester city,VA,51810,3353,2194,20,0,1139,42,20,18,0,4,3311,2174,2,1135
1999,Wise,VA,51820,83,80,0,0,3,4,3,0,0,1,79,77,0,2
1999,Wythe,VA,51830,54,41,2,0,11,3,1,2,0,0,51,40,0,11
1999,York,VA,51840,110,108,1,0,1,9,7,1,0,1,101,101,0,0
1999,Adams,WA,53001,84,77,0,1,6,2,1,0,1,0,82,76,0,6
1999,Asotin,WA,53003,88,74,0,0,14,2,2,0,0,0,86,72,0,14
1999,Benton,WA,53005,805,697,2,3,103,36,30,2,3,1,769,667,0,102
1999,Chelan,WA,53007,295,263,5,1,26,17,11,4,1,1,278,252,1,25
1999,Clallam,WA,53009,288,222,2,0,64,6,2,2,0,2,282,220,0,62
1999,Clark,WA,53011,2094,1693,8,0,393,17,10,7,0,0,2077,1683,1,393
1999,Columbia,WA,53013,14,14,0,0,0,0,0,0,0,0,14,14,0,0
1999,Cowlitz,WA,53015,587,487,3,0,97,4,1,3,0,0,583,486,0,97
1999,Douglas,WA,53017,149,145,0,0,4,3,3,0,0,0,146,142,0,4
1999,Ferry,WA,53019,25,23,0,0,2,1,1,0,0,0,24,22,0,2
1999,Franklin,WA,53021,275,234,3,3,35,12,6,3,3,0,263,228,0,35
1999,Garfield,WA,53023,7,6,0,0,1,0,0,0,0,0,7,6,0,1
1999,Grant,WA,53025,446,391,4,0,51,24,19,4,0,1,422,372,0,50
1999,Grays Harbor,WA,53027,376,324,0,0,52,3,2,0,0,1,373,322,0,51
1999,Island,WA,53029,240,222,0,0,18,1,1,0,0,0,239,221,0,18
1999,Jefferson,WA,53031,101,83,1,0,17,4,3,1,0,0,97,80,0,17
1999,King,WA,53033,7034,5416,77,0,1541,154,72,72,0,10,6880,5344,5,1531
1999,Kitsap,WA,53035,1157,970,4,0,183,14,10,4,0,0,1143,960,0,183
1999,Kittitas,WA,53037,114,91,0,0,23,5,4,0,0,1,109,87,0,22
1999,Klickitat,WA,53039,69,60,1,0,8,5,4,1,0,0,64,56,0,8
1999,Lewis,WA,53041,520,396,6,0,118,11,2,6,0,3,509,394,0,115
1999,Lincoln,WA,53043,47,41,0,1,5,3,2,0,1,0,44,39,0,5
1999,Mason,WA,53045,305,260,0,0,45,0,0,0,0,0,305,260,0,45
1999,Okanogan,WA,53047,143,136,1,2,4,8,5,1,2,0,135,131,0,4
1999,Pacific,WA,53049,86,72,2,0,12,3,1,2,0,0,83,71,0,12
1999,Pend Oreille,WA,53051,62,54,0,0,8,5,3,0,0,2,57,51,0,6
1999,Pierce,WA,53053,4797,3735,23,0,1039,32,12,19,0,1,4765,3723,4,1038
1999,San Juan,WA,53055,36,33,0,0,3,0,0,0,0,0,36,33,0,3
1999,Skagit,WA,53057,617,546,1,0,70,4,3,1,0,0,613,543,0,70
1999,Skamania,WA,53059,49,41,0,0,8,0,0,0,0,0,49,41,0,8
1999,Snohomish,WA,53061,3352,2550,22,0,780,58,29,22,0,7,3294,2521,0,773
1999,Spokane,WA,53063,2817,2185,18,1,613,120,87,16,1,16,2697,2098,2,597
1999,Stevens,WA,53065,175,127,1,1,46,13,9,1,1,2,162,118,0,44
1999,Thurston,WA,53067,1367,1100,3,0,264,12,8,3,0,1,1355,1092,0,263
1999,Wahkiakum,WA,53069,9,8,0,0,1,0,0,0,0,0,9,8,0,1
1999,Walla Walla,WA,53071,290,273,1,0,16,5,4,1,0,0,285,269,0,16
1999,Whatcom,WA,53073,720,620,6,0,94,15,6,6,0,3,705,614,0,91
1999,Whitman,WA,53075,78,65,1,0,12,5,3,1,0,1,73,62,0,11
1999,Yakima,WA,53077,1784,1100,5,0,679,21,13,5,0,3,1763,1087,0,676
1999,Barbour,WV,54001,61,60,0,0,1,1,0,0,0,1,60,60,0,0
1999,Berkeley,WV,54003,455,431,1,0,23,20,17,0,0,3,435,414,1,20
1999,Boone,WV,54005,117,106,3,0,8,4,1,3,0,0,113,105,0,8
1999,Braxton,WV,54007,38,33,1,0,4,2,1,1,0,0,36,32,0,4
1999,Brooke,WV,54009,117,116,0,0,1,1,1,0,0,0,116,115,0,1
1999,Cabell,WV,54011,434,404,3,0,27,12,8,3,0,1,422,396,0,26
1999,Calhoun,WV,54013,13,12,0,0,1,0,0,0,0,0,13,12,0,1
1999,Clay,WV,54015,27,27,0,0,0,0,0,0,0,0,27,27,0,0
1999,Doddridge,WV,54017,63,57,1,0,5,3,2,1,0,0,60,55,0,5
1999,Fayette,WV,54019,215,208,0,0,7,1,1,0,0,0,214,207,0,7
1999,Gilmer,WV,54021,15,14,0,0,1,0,0,0,0,0,15,14,0,1
1999,Grant,WV,54023,27,25,0,0,2,2,2,0,0,0,25,23,0,2
1999,Greenbrier,WV,54025,115,89,1,0,25,5,3,1,0,1,110,86,0,24
1999,Hampshire,WV,54027,59,57,0,0,2,3,2,0,0,1,56,55,0,1
1999,Hancock,WV,54029,180,171,1,0,8,11,7,1,0,3,169,164,0,5
1999,Hardy,WV,54031,31,29,0,0,2,0,0,0,0,0,31,29,0,2
1999,Harrison,WV,54033,400,362,3,0,35,10,7,3,0,0,390,355,0,35
1999,Jackson,WV,54035,113,104,1,0,8,4,3,1,0,0,109,101,0,8
1999,Jefferson,WV,54037,209,194,0,1,14,5,3,0,1,1,204,191,0,13
1999,Kanawha,WV,54039,857,791,6,0,60,21,14,5,0,2,836,777,1,58
1999,Lewis,WV,54041,89,87,0,0,2,0,0,0,0,0,89,87,0,2
1999,Lincoln,WV,54043,114,110,0,0,4,1,1,0,0,0,113,109,0,4
1999,Logan,WV,54045,196,181,2,0,13,3,1,2,0,0,193,180,0,13
1999,McDowell,WV,54047,94,92,0,0,2,6,6,0,0,0,88,86,0,2
1999,Marion,WV,54049,221,205,1,0,15,7,6,1,0,0,214,199,0,15
1999,Marshall,WV,54051,136,132,0,0,4,4,4,0,0,0,132,128,0,4
1999,Mason,WV,54053,89,83,1,0,5,3,2,1,0,0,86,81,0,5
1999,Mercer,WV,54055,323,318,0,0,5,4,4,0,0,0,319,314,0,5
1999,Mineral,WV,54057,61,59,0,0,2,4,4,0,0,0,57,55,0,2
1999,Mingo,WV,54059,171,150,1,0,20,7,6,1,0,0,164,144,0,20
1999,Monongalia,WV,54061,197,177,3,0,17,6,3,3,0,0,191,174,0,17
1999,Monroe,WV,54063,38,31,0,0,7,2,2,0,0,0,36,29,0,7
1999,Morgan,WV,54065,52,51,0,0,1,0,0,0,0,0,52,51,0,1
1999,Nicholas,WV,54067,136,122,4,0,10,8,2,4,0,2,128,120,0,8
1999,Ohio,WV,54069,249,228,2,0,19,17,14,2,0,1,232,214,0,18
1999,Pendleton,WV,54071,17,17,0,0,0,1,1,0,0,0,16,16,0,0
1999,Pleasants,WV,54073,33,33,0,0,0,0,0,0,0,0,33,33,0,0
1999,Pocahontas,WV,54075,32,28,0,0,4,1,1,0,0,0,31,27,0,4
1999,Preston,WV,54077,83,82,0,0,1,3,3,0,0,0,80,79,0,1
1999,Putnam,WV,54079,191,175,1,0,15,6,4,1,0,1,185,171,0,14
1999,Raleigh,WV,54081,315,303,5,0,7,12,7,4,0,1,303,296,1,6
1999,Randolph,WV,54083,125,120,1,0,4,3,2,1,0,0,122,118,0,4
1999,Ritchie,WV,54085,51,49,0,0,2,1,1,0,0,0,50,48,0,2
1999,Roane,WV,54087,48,44,0,0,4,0,0,0,0,0,48,44,0,4
1999,Summers,WV,54089,62,56,3,0,3,5,2,3,0,0,57,54,0,3
1999,Taylor,WV,54091,84,76,1,0,7,2,1,1,0,0,82,75,0,7
1999,Tucker,WV,54093,22,21,0,0,1,1,1,0,0,0,21,20,0,1
1999,Tyler,WV,54095,39,39,0,0,0,1,1,0,0,0,38,38,0,0
1999,Upshur,WV,54097,91,81,2,0,8,9,5,2,0,2,82,76,0,6
1999,Wayne,WV,54099,217,208,2,0,7,2,0,2,0,0,215,208,0,7
1999,Webster,WV,54101,26,23,0,0,3,0,0,0,0,0,26,23,0,3
1999,Wetzel,WV,54103,78,78,0,0,0,3,3,0,0,0,75,75,0,0
1999,Wirt,WV,54105,18,17,0,0,1,0,0,0,0,0,18,17,0,1
1999,Wood,WV,54107,402,390,4,0,8,12,7,4,0,1,390,383,0,7
1999,Wyoming,WV,54109,128,125,1,0,2,5,4,1,0,0,123,121,0,2
1999,Adams,WI,55001,49,44,0,0,5,8,8,0,0,0,41,36,0,5
1999,Ashland,WI,55003,42,42,0,0,0,2,2,0,0,0,40,40,0,0
1999,Barron,WI,55005,130,126,0,0,4,15,14,0,0,1,115,112,0,3
1999,Bayfield,WI,55007,29,26,1,1,1,3,2,0,1,0,26,24,1,1
1999,Brown,WI,55009,597,588,2,0,7,11,9,2,0,0,586,579,0,7
1999,Buffalo,WI,55011,26,25,0,0,1,6,6,0,0,0,20,19,0,1
1999,Burnett,WI,55013,35,35,0,0,0,4,4,0,0,0,31,31,0,0
1999,Calumet,WI,55015,33,31,0,0,2,0,0,0,0,0,33,31,0,2
1999,Chippewa,WI,55017,170,162,1,0,7,22,20,1,0,1,148,142,0,6
1999,Clark,WI,55019,44,42,0,0,2,5,4,0,0,1,39,38,0,1
1999,Columbia,WI,55021,184,164,2,0,18,15,11,2,0,2,169,153,0,16
1999,Crawford,WI,55023,45,41,0,0,4,10,7,0,0,3,35,34,0,1
1999,Dane,WI,55025,1271,1093,8,0,170,103,75,8,0,20,1168,1018,0,150
1999,Dodge,WI,55027,238,223,0,1,14,9,7,0,1,1,229,216,0,13
1999,Door,WI,55029,41,41,0,0,0,3,3,0,0,0,38,38,0,0
1999,Douglas,WI,55031,153,141,0,0,12,13,11,0,0,2,140,130,0,10
1999,Dunn,WI,55033,86,79,0,0,7,9,9,0,0,0,77,70,0,7
1999,Eau Claire,WI,55035,173,168,1,0,4,18,15,1,0,2,155,153,0,2
1999,Florence,WI,55037,34,31,0,0,3,0,0,0,0,0,34,31,0,3
1999,Fond du Lac,WI,55039,297,272,0,0,25,17,13,0,0,4,280,259,0,21
1999,Forest,WI,55041,30,30,0,0,0,1,1,0,0,0,29,29,0,0
1999,Grant,WI,55043,106,92,1,1,12,20,15,1,1,3,86,77,0,9
1999,Green,WI,55045,125,110,1,0,14,15,11,1,0,3,110,99,0,11
1999,Green Lake,WI,55047,48,44,0,0,4,3,3,0,0,0,45,41,0,4
1999,Iowa,WI,55049,53,47,0,1,5,7,5,0,1,1,46,42,0,4
1999,Iron,WI,55051,17,17,0,0,0,3,3,0,0,0,14,14,0,0
1999,Jackson,WI,55053,57,50,1,1,5,8,4,1,1,2,49,46,0,3
1999,Jefferson,WI,55055,223,197,4,0,22,13,9,4,0,0,210,188,0,22
1999,Juneau,WI,55057,74,68,0,0,6,6,6,0,0,0,68,62,0,6
1999,Kenosha,WI,55059,692,585,1,0,106,3,2,1,0,0,689,583,0,106
1999,Kewaunee,WI,55061,32,32,0,0,0,0,0,0,0,0,32,32,0,0
1999,La Crosse,WI,55063,288,284,2,0,2,33,30,2,0,1,255,254,0,1
1999,Lafayette,WI,55065,36,32,0,1,3,7,5,0,1,1,29,27,0,2
1999,Langlade,WI,55067,53,50,0,0,3,3,2,0,0,1,50,48,0,2
1999,Lincoln,WI,55069,98,93,0,1,4,11,9,0,1,1,87,84,0,3
1999,Manitowoc,WI,55071,161,152,1,0,8,3,1,1,0,1,158,151,0,7
1999,Marathon,WI,55073,240,229,0,1,10,26,24,0,1,1,214,205,0,9
1999,Marinette,WI,55075,163,156,2,0,5,3,1,2,0,0,160,155,0,5
1999,Marquette,WI,55077,62,53,0,0,9,0,0,0,0,0,62,53,0,9
1999,Menominee,WI,55078,12,10,0,0,2,0,0,0,0,0,12,10,0,2
1999,Milwaukee,WI,55079,6070,4654,15,0,1401,63,43,15,0,5,6007,4611,0,1396
1999,Monroe,WI,55081,106,97,0,1,8,20,18,0,1,1,86,79,0,7
1999,Oconto,WI,55083,110,108,0,0,2,2,2,0,0,0,108,106,0,2
1999,Oneida,WI,55085,155,146,2,0,7,19,16,2,0,1,136,130,0,6
1999,Outagamie,WI,55087,421,398,3,0,20,12,7,3,0,2,409,391,0,18
1999,Ozaukee,WI,55089,133,117,1,0,15,10,9,1,0,0,123,108,0,15
1999,Pepin,WI,55091,14,14,0,0,0,0,0,0,0,0,14,14,0,0
1999,Pierce,WI,55093,75,69,0,0,6,8,8,0,0,0,67,61,0,6
1999,Polk,WI,55095,91,79,0,2,10,14,9,0,2,3,77,70,0,7
1999,Portage,WI,55097,94,91,0,0,3,7,7,0,0,0,87,84,0,3
1999,Price,WI,55099,30,29,0,0,1,6,6,0,0,0,24,23,0,1
1999,Racine,WI,55101,877,724,0,0,153,9,9,0,0,0,868,715,0,153
1999,Richland,WI,55103,29,26,0,1,2,4,2,0,1,1,25,24,0,1
1999,Rock,WI,55105,706,609,3,0,94,42,32,3,0,7,664,577,0,87
1999,Rusk,WI,55107,45,44,0,0,1,5,5,0,0,0,40,39,0,1
1999,St. Croix,WI,55109,146,129,3,0,14,20,15,3,0,2,126,114,0,12
1999,Sauk,WI,55111,160,138,0,1,21,19,16,0,1,2,141,122,0,19
1999,Sawyer,WI,55113,52,49,0,0,3,4,4,0,0,0,48,45,0,3
1999,Shawano,WI,55115,129,117,0,0,12,3,3,0,0,0,126,114,0,12
1999,Sheboygan,WI,55117,293,260,0,0,33,5,5,0,0,0,288,255,0,33
1999,Taylor,WI,55119,35,33,0,0,2,6,5,0,0,1,29,28,0,1
1999,Trempealeau,WI,55121,65,59,1,2,3,11,6,0,2,3,54,53,1,0
1999,Vernon,WI,55123,46,43,1,1,1,10,7,1,1,1,36,36,0,0
1999,Vilas,WI,55125,38,35,0,0,3,4,2,0,0,2,34,33,0,1
1999,Walworth,WI,55127,341,308,1,0,32,11,9,1,0,1,330,299,0,31
1999,Washburn,WI,55129,33,32,0,0,1,5,5,0,0,0,28,27,0,1
1999,Washington,WI,55131,298,268,0,0,30,7,5,0,0,2,291,263,0,28
1999,Waukesha,WI,55133,831,730,1,0,100,26,22,1,0,3,805,708,0,97
1999,Waupaca,WI,55135,136,129,0,1,6,5,4,0,1,0,131,125,0,6
1999,Waushara,WI,55137,70,62,0,0,8,5,4,0,0,1,65,58,0,7
1999,Winnebago,WI,55139,469,438,0,2,29,14,10,0,2,2,455,428,0,27
1999,Wood,WI,55141,168,160,2,0,6,15,13,1,0,1,153,147,1,5
1999,Albany,WY,56001,77,66,5,1,5,9,1,5,1,2,68,65,0,3
1999,Big Horn,WY,56003,36,35,0,1,0,2,1,0,1,0,34,34,0,0
1999,Campbell,WY,56005,181,167,0,0,14,4,4,0,0,0,177,163,0,14
1999,Carbon,WY,56007,56,50,0,0,6,4,4,0,0,0,52,46,0,6
1999,Converse,WY,56009,54,52,0,0,2,0,0,0,0,0,54,52,0,2
1999,Crook,WY,56011,17,16,0,0,1,0,0,0,0,0,17,16,0,1
1999,Fremont,WY,56013,96,94,0,0,2,3,2,0,0,1,93,92,0,1
1999,Goshen,WY,56015,38,32,0,1,5,1,0,0,1,0,37,32,0,5
1999,Hot Springs,WY,56017,20,20,0,0,0,1,1,0,0,0,19,19,0,0
1999,Johnson,WY,56019,15,15,0,0,0,0,0,0,0,0,15,15,0,0
1999,Laramie,WY,56021,433,382,4,0,47,17,11,2,0,4,416,371,2,43
1999,Lincoln,WY,56023,40,33,2,2,3,5,1,2,2,0,35,32,0,3
1999,Natrona,WY,56025,306,289,1,0,16,8,6,1,0,1,298,283,0,15
1999,Niobrara,WY,56027,9,8,0,0,1,1,0,0,0,1,8,8,0,0
1999,Park,WY,56029,73,72,0,0,1,2,2,0,0,0,71,70,0,1
1999,Platte,WY,56031,31,27,1,0,3,1,0,1,0,0,30,27,0,3
1999,Sheridan,WY,56033,107,96,1,0,10,3,2,1,0,0,104,94,0,10
1999,Sublette,WY,56035,11,8,1,1,1,2,0,1,1,0,9,8,0,1
1999,Sweetwater,WY,56037,224,214,0,0,10,1,1,0,0,0,223,213,0,10
1999,Teton,WY,56039,36,34,2,0,0,4,2,2,0,0,32,32,0,0
1999,Uinta,WY,56041,96,90,1,0,5,3,2,1,0,0,93,88,0,5
1999,Washakie,WY,56043,34,34,0,0,0,1,1,0,0,0,33,33,0,0
1999,Weston,WY,56045,19,18,0,0,1,0,0,0,0,0,19,18,0,1
