YEAR,NAME,ST,FIPS,TOTAL_FILINGS,CHAP_7,CHAP_11,CHAP_12,CHAP_13,TOTAL_BUSINESS_FILINGS,BCHAP_7,BCHAP_11,BCHAP_12,BCHAP_13,TOTAL_NON_BUSINESS_FILINGS,NBCHAP_7,NBCHAP_11,NBCHAP_13
1990,Autauga,AL,1001,196,82,0,1,113,11,7,0,1,3,185,75,0,110
1990,Baldwin,AL,1003,294,246,11,3,34,17,6,7,3,1,277,240,4,33
1990,Barbour,AL,1005,92,53,5,2,32,13,4,5,2,2,79,49,0,30
1990,Bibb,AL,1007,124,38,0,0,86,9,5,0,0,4,115,33,0,82
1990,Blount,AL,1009,205,116,1,0,88,11,7,1,0,3,194,109,0,85
1990,Bullock,AL,1011,17,6,0,0,11,1,1,0,0,0,16,5,0,11
1990,Butler,AL,1013,98,47,1,0,50,3,2,1,0,0,95,45,0,50
1990,Calhoun,AL,1015,984,430,19,0,535,22,5,14,0,3,962,425,5,532
1990,Chambers,AL,1017,332,51,0,0,281,2,2,0,0,0,330,49,0,281
1990,Cherokee,AL,1019,72,53,2,0,17,3,0,2,0,1,69,53,0,16
1990,Chilton,AL,1021,200,82,2,0,116,8,4,2,0,2,192,78,0,114
1990,Choctaw,AL,1023,34,18,0,0,16,0,0,0,0,0,34,18,0,16
1990,Clarke,AL,1025,58,36,1,0,21,2,1,1,0,0,56,35,0,21
1990,Clay,AL,1027,56,19,2,1,34,3,0,2,1,0,53,19,0,34
1990,Cleburne,AL,1029,41,17,1,0,23,3,1,1,0,1,38,16,0,22
1990,Coffee,AL,1031,144,96,4,0,44,15,5,3,0,7,129,91,1,37
1990,Colbert,AL,1033,187,149,4,3,31,20,12,4,3,1,167,137,0,30
1990,Conecuh,AL,1035,28,17,1,0,10,3,2,0,0,1,25,15,1,9
1990,Coosa,AL,1037,58,16,0,0,42,1,1,0,0,0,57,15,0,42
1990,Covington,AL,1039,131,70,0,0,61,5,3,0,0,2,126,67,0,59
1990,Crenshaw,AL,1041,55,17,0,2,36,4,1,0,2,1,51,16,0,35
1990,Cullman,AL,1043,284,179,3,2,100,27,13,3,2,9,257,166,0,91
1990,Dale,AL,1045,222,141,2,0,79,13,10,2,0,1,209,131,0,78
1990,Dallas,AL,1047,110,84,1,0,25,2,1,1,0,0,108,83,0,25
1990,DeKalb,AL,1049,155,80,3,1,71,5,0,3,1,1,150,80,0,70
1990,Elmore,AL,1051,254,80,1,0,173,6,5,1,0,0,248,75,0,173
1990,Escambia,AL,1053,87,78,0,0,9,1,0,0,0,1,86,78,0,8
1990,Etowah,AL,1055,599,317,5,0,277,11,5,4,0,2,588,312,1,275
1990,Fayette,AL,1057,102,26,0,1,75,19,8,0,1,10,83,18,0,65
1990,Franklin,AL,1059,73,59,0,0,14,5,4,0,0,1,68,55,0,13
1990,Geneva,AL,1061,79,61,2,0,16,12,7,2,0,3,67,54,0,13
1990,Greene,AL,1063,102,0,0,0,102,2,0,0,0,2,100,0,0,100
1990,Hale,AL,1065,124,11,0,0,113,4,0,0,0,4,120,11,0,109
1990,Henry,AL,1067,41,32,0,0,9,2,1,0,0,1,39,31,0,8
1990,Houston,AL,1069,373,236,12,1,124,38,16,11,1,10,335,220,1,114
1990,Jackson,AL,1071,156,80,1,0,75,13,6,1,0,6,143,74,0,69
1990,Jefferson,AL,1073,7920,2587,64,0,5269,296,164,57,0,75,7624,2423,7,5194
1990,Lamar,AL,1075,76,15,1,0,60,8,2,1,0,5,68,13,0,55
1990,Lauderdale,AL,1077,191,150,4,0,37,21,13,4,0,4,170,137,0,33
1990,Lawrence,AL,1079,105,76,0,0,29,11,8,0,0,3,94,68,0,26
1990,Lee,AL,1081,342,125,2,0,215,11,7,2,0,2,331,118,0,213
1990,Limestone,AL,1083,180,145,0,0,35,16,12,0,0,4,164,133,0,31
1990,Lowndes,AL,1085,68,10,0,0,58,1,0,0,0,1,67,10,0,57
1990,Macon,AL,1087,94,25,1,0,68,4,1,1,0,2,90,24,0,66
1990,Madison,AL,1089,1126,726,29,2,369,111,61,27,2,21,1015,665,2,348
1990,Marengo,AL,1091,75,26,3,0,46,3,2,0,0,1,72,24,3,45
1990,Marion,AL,1093,93,61,2,0,30,18,13,2,0,3,75,48,0,27
1990,Marshall,AL,1095,361,245,6,0,110,12,6,5,0,1,349,239,1,109
1990,Mobile,AL,1097,1898,1430,33,0,435,44,20,22,0,2,1854,1410,11,433
1990,Monroe,AL,1099,63,55,1,0,7,4,4,0,0,0,59,51,1,7
1990,Montgomery,AL,1101,1527,403,25,0,1099,70,32,24,0,14,1457,371,1,1085
1990,Morgan,AL,1103,472,309,4,0,159,29,23,4,0,2,443,286,0,157
1990,Perry,AL,1105,27,8,0,0,19,0,0,0,0,0,27,8,0,19
1990,Pickens,AL,1107,111,17,0,2,92,5,1,0,2,2,106,16,0,90
1990,Pike,AL,1109,98,42,0,0,56,9,9,0,0,0,89,33,0,56
1990,Randolph,AL,1111,100,30,0,0,70,5,5,0,0,0,95,25,0,70
1990,Russell,AL,1113,376,147,3,0,226,14,8,3,0,3,362,139,0,223
1990,St. Clair,AL,1115,372,184,6,0,182,14,6,5,0,3,358,178,1,179
1990,Shelby,AL,1117,772,380,6,0,386,46,32,5,0,9,726,348,1,377
1990,Sumter,AL,1119,81,5,2,0,74,7,0,2,0,5,74,5,0,69
1990,Talladega,AL,1121,665,192,9,0,464,8,3,5,0,0,657,189,4,464
1990,Tallapoosa,AL,1123,302,46,1,0,255,3,1,1,0,1,299,45,0,254
1990,Tuscaloosa,AL,1125,1617,214,14,0,1389,165,37,14,0,114,1452,177,0,1275
1990,Walker,AL,1127,488,223,4,0,261,82,38,4,0,40,406,185,0,221
1990,Washington,AL,1129,24,20,1,0,3,0,0,0,0,0,24,20,1,3
1990,Wilcox,AL,1131,11,6,0,0,5,0,0,0,0,0,11,6,0,5
1990,Winston,AL,1133,62,42,1,0,19,10,6,1,0,3,52,36,0,16
1990,Anchorage Borough,AK,2020,715,576,37,0,102,81,33,32,0,16,634,543,5,86
1990,Bethel Census Area,AK,2050,3,3,0,0,0,1,1,0,0,0,2,2,0,0
1990,Bristol Bay Borough,AK,2060,2,2,0,0,0,0,0,0,0,0,2,2,0,0
1990,Dillingham Census Area,AK,2090,135,115,4,0,16,17,13,3,0,1,118,102,1,15
1990,Haines Borough,AK,2110,45,39,5,0,1,11,6,5,0,0,34,33,0,1
1990,Kenai Peninsula Borough,AK,2130,24,20,3,0,1,8,5,3,0,0,16,15,0,1
1990,Ketchikan Gateway Borough,AK,2150,7,6,1,0,0,1,0,1,0,0,6,6,0,0
1990,Lake and Peninsula Borough,AK,2170,125,104,5,0,16,23,13,5,0,5,102,91,0,11
1990,Matanuska-Susitna Borough,AK,2180,2,1,0,0,1,0,0,0,0,0,2,1,0,1
1990,Apache,AZ,4001,31,19,3,0,9,4,2,2,0,0,27,17,1,9
1990,Cochise,AZ,4003,314,274,10,0,30,64,47,9,0,8,250,227,1,22
1990,Coconino,AZ,4005,210,180,3,0,27,24,18,2,0,4,186,162,1,23
1990,Gila,AZ,4007,123,95,8,0,20,37,21,8,0,8,86,74,0,12
1990,Graham,AZ,4009,50,39,0,0,11,10,8,0,0,2,40,31,0,9
1990,Greenlee,AZ,4011,11,8,0,1,2,2,1,0,1,0,9,7,0,2
1990,La Paz,AZ,4012,12,11,1,0,0,2,1,1,0,0,10,10,0,0
1990,Maricopa,AZ,4013,12435,9032,698,3,2701,1262,535,572,3,151,11173,8497,126,2550
1990,Mohave,AZ,4015,286,227,7,0,52,23,15,3,0,5,263,212,4,47
1990,Navajo,AZ,4017,101,88,6,0,7,11,5,5,0,1,90,83,1,6
1990,Pima,AZ,4019,3581,2469,234,3,875,766,406,221,3,136,2815,2063,13,739
1990,Pinal,AZ,4021,457,313,7,2,135,58,38,6,2,12,399,275,1,123
1990,Santa Cruz,AZ,4023,37,24,6,0,7,17,9,5,0,3,20,15,1,4
1990,Yavapai,AZ,4025,287,243,13,0,31,40,24,10,0,6,247,219,3,25
1990,Yuma,AZ,4027,227,184,3,1,39,14,5,2,1,6,213,179,1,33
1990,Arkansas,AR,5001,65,18,4,0,43,10,4,4,0,2,55,14,0,41
1990,Ashley,AR,5003,45,34,0,0,11,3,3,0,0,0,42,31,0,11
1990,Baxter,AR,5005,59,52,2,0,5,4,1,2,0,1,55,51,0,4
1990,Benton,AR,5007,321,153,9,0,159,24,11,9,0,4,297,142,0,155
1990,Boone,AR,5009,56,28,1,0,27,4,3,1,0,0,52,25,0,27
1990,Bradley,AR,5011,17,6,0,0,11,0,0,0,0,0,17,6,0,11
1990,Calhoun,AR,5013,11,7,0,0,4,1,0,0,0,1,10,7,0,3
1990,Carroll,AR,5015,34,20,3,0,11,3,0,3,0,0,31,20,0,11
1990,Chicot,AR,5017,19,12,1,0,6,2,1,1,0,0,17,11,0,6
1990,Clark,AR,5019,45,23,1,0,21,2,1,1,0,0,43,22,0,21
1990,Clay,AR,5021,28,18,0,0,10,1,0,0,0,1,27,18,0,9
1990,Cleburne,AR,5023,45,30,1,0,14,2,0,1,0,1,43,30,0,13
1990,Cleveland,AR,5025,17,4,0,0,13,0,0,0,0,0,17,4,0,13
1990,Columbia,AR,5027,20,14,0,1,5,1,0,0,1,0,19,14,0,5
1990,Conway,AR,5029,40,18,0,2,20,3,0,0,2,1,37,18,0,19
1990,Craighead,AR,5031,257,192,2,1,62,20,15,2,1,2,237,177,0,60
1990,Crawford,AR,5033,191,168,3,0,20,10,7,3,0,0,181,161,0,20
1990,Crittenden,AR,5035,232,99,1,1,131,9,4,1,1,3,223,95,0,128
1990,Cross,AR,5037,37,26,0,1,10,1,0,0,1,0,36,26,0,10
1990,Dallas,AR,5039,31,9,1,0,21,5,1,1,0,3,26,8,0,18
1990,Desha,AR,5041,27,17,0,0,10,1,1,0,0,0,26,16,0,10
1990,Drew,AR,5043,25,9,0,1,15,3,1,0,1,1,22,8,0,14
1990,Faulkner,AR,5045,155,88,4,1,62,16,7,3,1,5,139,81,1,57
1990,Franklin,AR,5047,35,29,0,0,6,3,1,0,0,2,32,28,0,4
1990,Fulton,AR,5049,17,10,0,0,7,2,1,0,0,1,15,9,0,6
1990,Garland,AR,5051,241,166,5,0,70,18,9,4,0,5,223,157,1,65
1990,Grant,AR,5053,54,20,1,0,33,3,0,1,0,2,51,20,0,31
1990,Greene,AR,5055,73,54,0,0,19,1,1,0,0,0,72,53,0,19
1990,Hempstead,AR,5057,21,14,1,0,6,3,1,1,0,1,18,13,0,5
1990,Hot Spring,AR,5059,87,53,0,0,34,5,3,0,0,2,82,50,0,32
1990,Howard,AR,5061,22,13,0,3,6,4,1,0,3,0,18,12,0,6
1990,Independence,AR,5063,112,72,1,0,39,7,6,1,0,0,105,66,0,39
1990,Izard,AR,5065,26,15,1,0,10,2,1,1,0,0,24,14,0,10
1990,Jackson,AR,5067,44,33,1,0,10,3,2,1,0,0,41,31,0,10
1990,Jefferson,AR,5069,284,78,1,1,204,21,8,1,1,11,263,70,0,193
1990,Johnson,AR,5071,34,32,0,0,2,1,1,0,0,0,33,31,0,2
1990,Lafayette,AR,5073,8,6,0,1,1,1,0,0,1,0,7,6,0,1
1990,Lawrence,AR,5075,36,28,0,0,8,1,1,0,0,0,35,27,0,8
1990,Lee,AR,5077,7,2,0,0,5,0,0,0,0,0,7,2,0,5
1990,Lincoln,AR,5079,21,5,0,0,16,0,0,0,0,0,21,5,0,16
1990,Little River,AR,5081,15,12,1,0,2,1,0,1,0,0,14,12,0,2
1990,Logan,AR,5083,57,53,0,0,4,0,0,0,0,0,57,53,0,4
1990,Lonoke,AR,5085,195,84,0,0,111,11,7,0,0,4,184,77,0,107
1990,Madison,AR,5087,19,11,0,0,8,0,0,0,0,0,19,11,0,8
1990,Marion,AR,5089,13,11,0,0,2,1,1,0,0,0,12,10,0,2
1990,Miller,AR,5091,49,37,5,0,7,11,4,5,0,2,38,33,0,5
1990,Mississippi,AR,5093,135,63,0,0,72,6,3,0,0,3,129,60,0,69
1990,Monroe,AR,5095,16,5,0,0,11,4,1,0,0,3,12,4,0,8
1990,Montgomery,AR,5097,7,6,0,0,1,0,0,0,0,0,7,6,0,1
1990,Nevada,AR,5099,20,17,0,0,3,2,1,0,0,1,18,16,0,2
1990,Newton,AR,5101,7,3,0,0,4,2,2,0,0,0,5,1,0,4
1990,Ouachita,AR,5103,89,66,2,0,21,9,5,2,0,2,80,61,0,19
1990,Perry,AR,5105,16,9,2,0,5,2,0,2,0,0,14,9,0,5
1990,Phillips,AR,5107,36,13,0,0,23,1,1,0,0,0,35,12,0,23
1990,Pike,AR,5109,20,13,0,0,7,2,2,0,0,0,18,11,0,7
1990,Poinsett,AR,5111,51,39,0,0,12,2,2,0,0,0,49,37,0,12
1990,Polk,AR,5113,18,16,0,1,1,2,1,0,1,0,16,15,0,1
1990,Pope,AR,5115,125,75,1,1,48,6,3,1,1,1,119,72,0,47
1990,Prairie,AR,5117,17,5,0,0,12,1,1,0,0,0,16,4,0,12
1990,Pulaski,AR,5119,1898,706,54,0,1138,107,47,44,0,16,1791,659,10,1122
1990,Randolph,AR,5121,28,19,0,0,9,1,1,0,0,0,27,18,0,9
1990,St. Francis,AR,5123,62,34,2,2,24,9,4,2,2,1,53,30,0,23
1990,Saline,AR,5125,187,82,0,0,105,4,0,0,0,4,183,82,0,101
1990,Scott,AR,5127,31,27,2,0,2,3,1,2,0,0,28,26,0,2
1990,Searcy,AR,5129,8,3,0,1,4,1,0,0,1,0,7,3,0,4
1990,Sebastian,AR,5131,467,422,11,1,33,22,8,11,1,2,445,414,0,31
1990,Sevier,AR,5133,16,10,3,1,2,6,2,2,1,1,10,8,1,1
1990,Sharp,AR,5135,43,23,0,0,20,5,4,0,0,1,38,19,0,19
1990,Stone,AR,5137,18,12,0,0,6,1,0,0,0,1,17,12,0,5
1990,Union,AR,5139,107,76,14,0,17,20,7,12,0,1,87,69,2,16
1990,Van Buren,AR,5141,21,11,0,0,10,2,0,0,0,2,19,11,0,8
1990,Washington,AR,5143,342,222,5,3,112,20,8,5,3,4,322,214,0,108
1990,White,AR,5145,163,52,3,2,106,6,1,3,2,0,157,51,0,106
1990,Woodruff,AR,5147,22,6,0,1,15,2,1,0,1,0,20,5,0,15
1990,Yell,AR,5149,41,26,1,0,14,3,1,1,0,1,38,25,0,13
1990,Alameda,CA,6001,4081,2953,117,0,1011,309,140,102,0,67,3772,2813,15,944
1990,Amador,CA,6005,49,39,1,0,9,8,6,0,0,2,41,33,1,7
1990,Butte,CA,6007,434,396,9,0,29,54,36,9,0,9,380,360,0,20
1990,Calaveras,CA,6009,47,32,2,0,13,9,6,2,0,1,38,26,0,12
1990,Colusa,CA,6011,34,22,2,0,10,6,4,2,0,0,28,18,0,10
1990,Contra Costa,CA,6013,2422,1659,80,1,682,241,109,60,1,71,2181,1550,20,611
1990,Del Norte,CA,6015,39,27,1,0,11,7,2,1,0,4,32,25,0,7
1990,El Dorado,CA,6017,341,278,12,0,51,57,34,8,0,15,284,244,4,36
1990,Fresno,CA,6019,2201,1632,48,5,516,133,61,41,5,26,2068,1571,7,490
1990,Glenn,CA,6021,40,38,0,0,2,6,5,0,0,1,34,33,0,1
1990,Humboldt,CA,6023,293,239,8,0,46,32,18,5,0,9,261,221,3,37
1990,Imperial,CA,6025,197,173,4,2,18,18,11,4,2,1,179,162,0,17
1990,Inyo,CA,6027,45,40,1,1,3,4,1,1,1,1,41,39,0,2
1990,Kern,CA,6029,2412,2041,39,10,322,159,70,32,10,47,2253,1971,7,275
1990,Kings,CA,6031,265,215,3,1,46,13,6,2,1,4,252,209,1,42
1990,Lake,CA,6033,122,107,5,0,10,16,9,5,0,2,106,98,0,8
1990,Lassen,CA,6035,44,40,1,0,3,4,2,1,0,1,40,38,0,2
1990,Los Angeles,CA,6037,36006,29730,948,0,5328,1213,566,606,0,41,34793,29164,342,5287
1990,Madera,CA,6039,224,167,8,4,45,18,7,6,4,1,206,160,2,44
1990,Marin,CA,6041,537,429,37,0,70,101,60,32,0,9,436,369,5,62
1990,Mariposa,CA,6043,24,16,0,0,8,4,1,0,0,3,20,15,0,5
1990,Mendocino,CA,6045,159,134,7,0,18,27,13,4,0,10,132,121,3,8
1990,Merced,CA,6047,427,325,5,1,96,40,22,5,1,12,387,303,0,84
1990,Modoc,CA,6049,20,16,2,1,1,3,1,1,1,0,17,15,1,1
1990,Mono,CA,6051,19,18,1,0,0,3,3,0,0,0,16,15,1,0
1990,Monterey,CA,6053,1244,590,25,0,629,151,85,22,0,44,1093,505,3,585
1990,Napa,CA,6055,257,207,13,0,37,48,25,10,0,13,209,182,3,24
1990,Nevada,CA,6057,202,177,10,0,15,29,20,8,0,1,173,157,2,14
1990,Orange,CA,6059,9426,7391,318,0,1717,439,225,214,0,0,8987,7166,104,1717
1990,Placer,CA,6061,433,341,16,0,76,63,36,15,0,12,370,305,1,64
1990,Plumas,CA,6063,26,24,1,0,1,9,7,1,0,1,17,17,0,0
1990,Riverside,CA,6065,4864,3487,78,1,1297,732,570,70,1,90,4132,2917,8,1207
1990,Sacramento,CA,6067,3934,3076,113,0,745,339,167,109,0,63,3595,2909,4,682
1990,San Benito,CA,6069,73,48,3,0,22,10,5,3,0,2,63,43,0,20
1990,San Bernardino,CA,6071,6219,4544,88,0,1586,654,487,76,0,90,5565,4057,12,1496
1990,San Diego,CA,6073,11210,6846,254,1,4109,780,477,212,1,90,10430,6369,42,4019
1990,San Francisco,CA,6075,2372,1584,94,0,694,116,44,70,0,2,2256,1540,24,692
1990,San Joaquin,CA,6077,1526,1059,25,2,440,162,80,25,2,55,1364,979,0,385
1990,San Luis Obispo,CA,6079,545,487,22,2,34,27,10,15,2,0,518,477,7,34
1990,San Mateo,CA,6081,1607,1048,52,0,506,66,27,33,0,5,1541,1021,19,501
1990,Santa Barbara,CA,6083,840,766,31,0,43,29,11,17,0,1,811,755,14,42
1990,Santa Clara,CA,6085,4458,2883,137,3,1435,686,399,120,3,164,3772,2484,17,1271
1990,Santa Cruz,CA,6087,480,363,18,0,99,118,72,17,0,29,362,291,1,70
1990,Shasta,CA,6089,576,511,8,1,56,69,38,8,1,22,507,473,0,34
1990,Sierra,CA,6091,4,4,0,0,0,0,0,0,0,0,4,4,0,0
1990,Siskiyou,CA,6093,89,70,4,1,14,18,12,4,1,1,71,58,0,13
1990,Solano,CA,6095,1465,1144,26,1,294,112,68,23,1,20,1353,1076,3,274
1990,Sonoma,CA,6097,970,821,36,3,110,132,63,31,3,35,838,758,5,75
1990,Stanislaus,CA,6099,1409,913,24,0,472,151,71,22,0,58,1258,842,2,414
1990,Sutter,CA,6101,167,151,5,0,11,24,18,5,0,1,143,133,0,10
1990,Tehama,CA,6103,159,148,4,0,7,15,11,3,0,1,144,137,1,6
1990,Trinity,CA,6105,22,18,1,0,3,1,0,0,0,1,21,18,1,2
1990,Tulare,CA,6107,1077,873,16,4,184,61,32,15,4,10,1016,841,1,174
1990,Tuolumne,CA,6109,134,105,1,0,28,13,8,1,0,4,121,97,0,24
1990,Ventura,CA,6111,1928,1693,54,0,181,79,42,35,0,2,1849,1651,19,179
1990,Yolo,CA,6113,325,266,8,0,51,29,15,6,0,8,296,251,2,43
1990,Yuba,CA,6115,211,192,4,0,15,15,10,3,0,2,196,182,1,13
1990,Adams,CO,8001,1796,1288,6,0,502,57,48,6,0,3,1739,1240,0,499
1990,Alamosa,CO,8003,30,26,1,0,3,5,4,1,0,0,25,22,0,3
1990,Arapahoe,CO,8005,2591,1889,33,0,666,174,120,32,0,19,2417,1769,1,647
1990,Archuleta,CO,8007,7,5,0,0,1,4,2,0,0,1,3,3,0,0
1990,Baca,CO,8009,5,4,0,0,1,0,0,0,0,0,5,4,0,1
1990,Bent,CO,8011,14,13,0,0,1,0,0,0,0,0,14,13,0,1
1990,Boulder,CO,8013,1010,808,22,0,180,96,68,22,0,6,914,740,0,174
1990,Chaffee,CO,8015,23,18,1,0,4,5,3,1,0,1,18,15,0,3
1990,Cheyenne,CO,8017,4,4,0,0,0,0,0,0,0,0,4,4,0,0
1990,Clear Creek,CO,8019,17,12,0,0,5,2,1,0,0,1,15,11,0,4
1990,Conejos,CO,8021,8,6,1,0,1,2,2,0,0,0,6,4,1,1
1990,Costilla,CO,8023,7,4,1,0,2,0,0,0,0,0,7,4,1,2
1990,Crowley,CO,8025,8,7,0,1,0,2,1,0,1,0,6,6,0,0
1990,Custer,CO,8027,6,3,0,0,3,2,1,0,0,1,4,2,0,2
1990,Delta,CO,8029,39,38,0,0,1,1,1,0,0,0,38,37,0,1
1990,Denver,CO,8031,3424,2313,71,0,1039,207,120,67,0,19,3217,2193,4,1020
1990,Dolores,CO,8033,25,23,0,0,2,1,1,0,0,0,24,22,0,2
1990,Douglas,CO,8035,227,173,4,0,49,25,17,4,0,3,202,156,0,46
1990,Eagle,CO,8037,56,35,10,0,11,13,3,9,0,1,43,32,1,10
1990,Elbert,CO,8039,41,28,1,1,11,5,3,1,1,0,36,25,0,11
1990,El Paso,CO,8041,2225,1686,18,1,519,122,91,15,1,14,2103,1595,3,505
1990,Fremont,CO,8043,96,76,1,0,19,7,5,1,0,1,89,71,0,18
1990,Garfield,CO,8045,81,72,3,0,6,7,5,2,0,0,74,67,1,6
1990,Gilpin,CO,8047,12,12,0,0,0,2,2,0,0,0,10,10,0,0
1990,Grand,CO,8049,30,21,2,0,7,5,3,2,0,0,25,18,0,7
1990,Gunnison,CO,8051,16,15,0,0,1,1,1,0,0,0,15,14,0,1
1990,Hinsdale,CO,8053,1,1,0,0,0,0,0,0,0,0,1,1,0,0
1990,Huerfano,CO,8055,12,9,1,0,2,2,1,1,0,0,10,8,0,2
1990,Jackson,CO,8057,3,2,1,0,0,2,1,1,0,0,1,1,0,0
1990,Jefferson,CO,8059,1805,1348,23,2,432,98,62,21,2,13,1707,1286,2,419
1990,Kiowa,CO,8061,3,2,0,0,1,0,0,0,0,0,3,2,0,1
1990,Kit Carson,CO,8063,11,7,1,0,3,2,0,1,0,1,9,7,0,2
1990,Lake,CO,8065,17,15,0,0,2,1,1,0,0,0,16,14,0,2
1990,La Plata,CO,8067,68,63,0,0,5,8,8,0,0,0,60,55,0,5
1990,Larimer,CO,8069,747,496,11,0,240,60,45,10,0,5,687,451,1,235
1990,Las Animas,CO,8071,29,22,0,1,6,2,1,0,1,0,27,21,0,6
1990,Lincoln,CO,8073,11,7,0,0,4,1,1,0,0,0,10,6,0,4
1990,Logan,CO,8075,62,49,2,0,11,3,2,1,0,0,59,47,1,11
1990,Mesa,CO,8077,301,268,4,3,26,29,20,4,3,2,272,248,0,24
1990,Moffat,CO,8081,31,22,0,0,9,1,1,0,0,0,30,21,0,9
1990,Montezuma,CO,8083,36,35,1,0,0,2,1,1,0,0,34,34,0,0
1990,Montrose,CO,8085,63,56,2,0,5,6,5,1,0,0,57,51,1,5
1990,Morgan,CO,8087,77,64,0,1,12,6,3,0,1,2,71,61,0,10
1990,Otero,CO,8089,50,38,0,2,10,4,2,0,2,0,46,36,0,10
1990,Ouray,CO,8091,4,3,0,0,1,0,0,0,0,0,4,3,0,1
1990,Park,CO,8093,40,27,0,0,13,1,1,0,0,0,39,26,0,13
1990,Phillips,CO,8095,7,7,0,0,0,2,2,0,0,0,5,5,0,0
1990,Pitkin,CO,8097,15,11,2,0,2,4,1,2,0,1,11,10,0,1
1990,Prowers,CO,8099,35,31,1,1,2,3,1,1,1,0,32,30,0,2
1990,Pueblo,CO,8101,523,378,8,0,137,34,23,8,0,3,489,355,0,134
1990,Rio Blanco,CO,8103,27,27,0,0,0,2,2,0,0,0,25,25,0,0
1990,Rio Grande,CO,8105,14,10,0,1,3,2,1,0,1,0,12,9,0,3
1990,Routt,CO,8107,32,23,2,0,7,5,3,2,0,0,27,20,0,7
1990,Saguache,CO,8109,14,11,0,0,3,2,2,0,0,0,12,9,0,3
1990,San Miguel,CO,8113,5,4,0,0,1,1,1,0,0,0,4,3,0,1
1990,Sedgwick,CO,8115,5,4,0,1,0,1,0,0,1,0,4,4,0,0
1990,Summit,CO,8117,35,22,2,0,11,7,3,2,0,2,28,19,0,9
1990,Teller,CO,8119,59,47,1,0,11,7,5,1,0,1,52,42,0,10
1990,Washington,CO,8121,9,9,0,0,0,2,2,0,0,0,7,7,0,0
1990,Weld,CO,8123,581,421,1,8,151,40,25,1,8,6,541,396,0,145
1990,Yuma,CO,8125,16,16,0,0,0,1,1,0,0,0,15,15,0,0
1990,Fairfield,CT,9001,1388,1055,110,0,223,148,67,79,0,2,1240,988,31,221
1990,Hartford,CT,9003,1522,1283,70,0,169,130,68,59,0,3,1392,1215,11,166
1990,Litchfield,CT,9005,297,258,11,0,28,21,14,5,0,2,276,244,6,26
1990,Middlesex,CT,9007,261,227,7,0,27,19,11,5,0,3,242,216,2,24
1990,New Haven,CT,9009,1457,1213,61,1,182,104,49,52,1,2,1353,1164,9,180
1990,New London,CT,9011,396,359,14,0,23,24,12,11,0,1,372,347,3,22
1990,Tolland,CT,9013,146,128,2,0,16,5,3,1,0,1,141,125,1,15
1990,Windham,CT,9015,140,114,5,0,21,8,5,2,0,1,132,109,3,20
1990,Kent,DE,10001,234,160,6,0,68,9,5,4,0,0,225,155,2,68
1990,New Castle,DE,10003,577,416,30,0,131,36,11,23,0,2,541,405,7,129
1990,Sussex,DE,10005,194,154,8,0,32,10,3,7,0,0,184,151,1,32
1990,District of Columbia,DC,11001,5,0,4,0,1,3,0,3,0,0,2,0,1,1
1990,Alachua,FL,12001,319,264,22,3,30,45,18,18,3,6,274,246,4,24
1990,Baker,FL,12003,33,26,1,0,6,2,1,1,0,0,31,25,0,6
1990,Bay,FL,12005,294,281,5,0,8,23,17,5,0,1,271,264,0,7
1990,Bradford,FL,12007,39,32,3,0,4,5,3,2,0,0,34,29,1,4
1990,Brevard,FL,12009,1164,1091,26,0,47,63,36,22,0,5,1101,1055,4,42
1990,Broward,FL,12011,3225,2846,139,0,240,220,96,123,0,1,3005,2750,16,239
1990,Calhoun,FL,12013,11,7,1,0,3,2,1,1,0,0,9,6,0,3
1990,Charlotte,FL,12015,219,186,6,0,27,30,25,2,0,3,189,161,4,24
1990,Citrus,FL,12017,183,168,3,0,12,16,13,1,0,2,167,155,2,10
1990,Clay,FL,12019,427,370,4,0,53,28,20,4,0,4,399,350,0,49
1990,Collier,FL,12021,286,270,10,0,6,41,33,8,0,0,245,237,2,6
1990,Columbia,FL,12023,79,55,5,0,19,10,2,4,0,4,69,53,1,15
1990,Dade,FL,12025,4123,3165,229,3,726,375,176,196,3,0,3748,2989,33,726
1990,DeSoto,FL,12027,33,33,0,0,0,1,1,0,0,0,32,32,0,0
1990,Dixie,FL,12029,3,3,0,0,0,0,0,0,0,0,3,3,0,0
1990,Duval,FL,12031,2775,2202,47,0,526,137,69,41,0,27,2638,2133,6,499
1990,Escambia,FL,12033,661,605,21,0,35,35,10,19,0,6,626,595,2,29
1990,Flagler,FL,12035,48,39,6,0,3,11,6,4,0,1,37,33,2,2
1990,Franklin,FL,12037,6,3,2,0,1,2,0,2,0,0,4,3,0,1
1990,Gadsden,FL,12039,33,29,1,0,3,2,1,1,0,0,31,28,0,3
1990,Gilchrist,FL,12041,16,12,0,2,2,2,0,0,2,0,14,12,0,2
1990,Gulf,FL,12045,13,13,0,0,0,0,0,0,0,0,13,13,0,0
1990,Hamilton,FL,12047,6,4,0,0,2,0,0,0,0,0,6,4,0,2
1990,Hardee,FL,12049,20,18,0,0,2,2,2,0,0,0,18,16,0,2
1990,Hendry,FL,12051,25,22,0,1,2,3,2,0,1,0,22,20,0,2
1990,Hernando,FL,12053,345,312,4,1,28,20,15,3,1,1,325,297,1,27
1990,Highlands,FL,12055,79,63,7,0,9,10,5,5,0,0,69,58,2,9
1990,Hillsborough,FL,12057,4227,3380,130,1,716,280,146,110,1,23,3947,3234,20,693
1990,Holmes,FL,12059,19,15,0,1,3,1,0,0,1,0,18,15,0,3
1990,Indian River,FL,12061,136,123,8,0,5,9,2,7,0,0,127,121,1,5
1990,Jackson,FL,12063,57,45,1,5,6,7,1,1,5,0,50,44,0,6
1990,Jefferson,FL,12065,15,15,0,0,0,2,2,0,0,0,13,13,0,0
1990,Lafayette,FL,12067,15,5,2,2,6,4,0,2,2,0,11,5,0,6
1990,Lake,FL,12069,380,354,12,0,14,24,13,10,0,1,356,341,2,13
1990,Lee,FL,12071,831,778,16,0,37,56,40,14,0,2,775,738,2,35
1990,Leon,FL,12073,357,313,15,0,29,38,23,14,0,1,319,290,1,28
1990,Levy,FL,12075,39,36,0,1,2,4,3,0,1,0,35,33,0,2
1990,Liberty,FL,12077,6,6,0,0,0,1,1,0,0,0,5,5,0,0
1990,Madison,FL,12079,8,7,0,0,1,0,0,0,0,0,8,7,0,1
1990,Manatee,FL,12081,654,551,12,0,91,33,20,11,0,2,621,531,1,89
1990,Marion,FL,12083,497,446,23,3,25,63,34,20,3,6,434,412,3,19
1990,Martin,FL,12085,151,141,10,0,0,14,6,8,0,0,137,135,2,0
1990,Monroe,FL,12087,86,71,10,0,5,11,1,9,0,1,75,70,1,4
1990,Nassau,FL,12089,143,119,1,0,23,9,8,1,0,0,134,111,0,23
1990,Okaloosa,FL,12091,305,279,18,0,8,24,4,18,0,2,281,275,0,6
1990,Okeechobee,FL,12093,36,35,0,0,1,0,0,0,0,0,36,35,0,1
1990,Orange,FL,12095,2364,2073,60,0,231,111,52,53,0,6,2253,2021,7,225
1990,Osceola,FL,12097,310,276,9,0,25,21,10,9,0,2,289,266,0,23
1990,Palm Beach,FL,12099,1876,1694,129,0,53,213,95,118,0,0,1663,1599,11,53
1990,Pasco,FL,12101,999,905,17,0,77,57,38,13,0,6,942,867,4,71
1990,Pinellas,FL,12103,3550,3028,158,0,364,327,187,126,0,14,3223,2841,32,350
1990,Polk,FL,12105,1118,936,35,0,147,98,64,24,0,10,1020,872,11,137
1990,Putnam,FL,12107,150,130,4,0,16,13,6,4,0,3,137,124,0,13
1990,St. Johns,FL,12109,216,202,9,0,5,15,6,8,0,1,201,196,1,4
1990,St. Lucie,FL,12111,292,275,7,1,9,14,8,5,1,0,278,267,2,9
1990,Santa Rosa,FL,12113,217,203,5,1,8,15,7,5,1,2,202,196,0,6
1990,Sarasota,FL,12115,819,687,42,0,90,90,54,33,0,3,729,633,9,87
1990,Seminole,FL,12117,1099,972,26,0,101,71,44,21,0,6,1028,928,5,95
1990,Sumter,FL,12119,44,39,2,0,3,3,1,1,0,1,41,38,1,2
1990,Suwannee,FL,12121,60,42,5,4,9,14,4,4,4,2,46,38,1,7
1990,Taylor,FL,12123,27,25,0,0,2,3,2,0,0,1,24,23,0,1
1990,Union,FL,12125,24,19,2,0,3,3,0,1,0,2,21,19,1,1
1990,Volusia,FL,12127,892,825,21,0,46,79,52,20,0,7,813,773,1,39
1990,Wakulla,FL,12129,31,30,0,0,1,0,0,0,0,0,31,30,0,1
1990,Walton,FL,12131,57,35,20,1,1,23,3,19,1,0,34,32,1,1
1990,Washington,FL,12133,24,21,0,1,2,4,2,0,1,1,20,19,0,1
1990,Appling,GA,13001,64,22,2,0,40,3,1,2,0,0,61,21,0,40
1990,Atkinson,GA,13003,31,9,0,0,22,0,0,0,0,0,31,9,0,22
1990,Bacon,GA,13005,57,29,0,0,28,7,7,0,0,0,50,22,0,28
1990,Baker,GA,13007,13,8,0,0,5,0,0,0,0,0,13,8,0,5
1990,Baldwin,GA,13009,319,64,0,0,255,0,0,0,0,0,319,64,0,255
1990,Banks,GA,13011,46,21,0,0,25,3,3,0,0,0,43,18,0,25
1990,Barrow,GA,13013,223,104,0,0,119,2,2,0,0,0,221,102,0,119
1990,Bartow,GA,13015,465,219,7,0,239,53,28,7,0,18,412,191,0,221
1990,Ben Hill,GA,13017,81,47,1,0,33,2,1,1,0,0,79,46,0,33
1990,Berrien,GA,13019,74,62,0,0,12,0,0,0,0,0,74,62,0,12
1990,Bibb,GA,13021,1446,420,7,0,1019,16,7,6,0,3,1430,413,1,1016
1990,Bleckley,GA,13023,55,20,0,1,34,2,1,0,1,0,53,19,0,34
1990,Brantley,GA,13025,56,26,0,0,30,1,1,0,0,0,55,25,0,30
1990,Brooks,GA,13027,48,40,2,4,2,9,3,2,4,0,39,37,0,2
1990,Bryan,GA,13029,121,32,0,0,89,1,0,0,0,1,120,32,0,88
1990,Bulloch,GA,13031,206,56,0,0,150,0,0,0,0,0,206,56,0,150
1990,Burke,GA,13033,114,29,0,0,85,0,0,0,0,0,114,29,0,85
1990,Butts,GA,13035,77,32,1,0,44,3,2,1,0,0,74,30,0,44
1990,Calhoun,GA,13037,6,2,0,1,3,1,0,0,1,0,5,2,0,3
1990,Camden,GA,13039,155,96,4,0,55,6,2,4,0,0,149,94,0,55
1990,Candler,GA,13043,38,11,0,1,26,1,0,0,1,0,37,11,0,26
1990,Carroll,GA,13045,590,203,0,0,387,55,33,0,0,22,535,170,0,365
1990,Catoosa,GA,13047,249,96,0,0,153,10,7,0,0,3,239,89,0,150
1990,Charlton,GA,13049,35,12,0,0,23,1,0,0,0,1,34,12,0,22
1990,Chatham,GA,13051,1714,546,23,0,1145,58,23,19,0,16,1656,523,4,1129
1990,Chattahoochee,GA,13053,22,13,1,0,8,1,0,1,0,0,21,13,0,8
1990,Chattooga,GA,13055,122,40,0,0,82,9,2,0,0,7,113,38,0,75
1990,Cherokee,GA,13057,583,376,11,0,196,54,34,9,0,11,529,342,2,185
1990,Clarke,GA,13059,321,119,5,0,197,5,1,4,0,0,316,118,1,197
1990,Clay,GA,13061,3,3,0,0,0,0,0,0,0,0,3,3,0,0
1990,Clayton,GA,13063,1785,922,14,0,849,85,49,14,0,22,1700,873,0,827
1990,Clinch,GA,13065,21,17,0,0,4,2,2,0,0,0,19,15,0,4
1990,Cobb,GA,13067,3093,1813,69,0,1211,269,159,64,0,46,2824,1654,5,1165
1990,Coffee,GA,13069,193,89,0,0,104,3,3,0,0,0,190,86,0,104
1990,Colquitt,GA,13071,79,60,1,0,18,1,0,1,0,0,78,60,0,18
1990,Columbia,GA,13073,351,151,6,0,194,10,5,5,0,0,341,146,1,194
1990,Cook,GA,13075,55,40,1,0,14,2,1,1,0,0,53,39,0,14
1990,Coweta,GA,13077,569,242,5,2,320,45,28,5,2,10,524,214,0,310
1990,Crawford,GA,13079,39,12,0,0,27,0,0,0,0,0,39,12,0,27
1990,Crisp,GA,13081,83,25,2,3,53,6,0,2,3,1,77,25,0,52
1990,Dade,GA,13083,72,20,0,0,52,3,2,0,0,1,69,18,0,51
1990,Dawson,GA,13085,56,36,0,0,20,2,1,0,0,1,54,35,0,19
1990,De Kalb,GA,13087,68,42,4,1,21,4,1,2,1,0,64,41,2,21
1990,Decatur,GA,13089,4453,1621,61,1,2770,200,90,50,1,59,4253,1531,11,2711
1990,Dodge,GA,13091,81,26,0,0,55,0,0,0,0,0,81,26,0,55
1990,Dooly,GA,13093,39,15,1,4,19,5,0,1,4,0,34,15,0,19
1990,Dougherty,GA,13095,506,357,7,0,142,14,5,6,0,3,492,352,1,139
1990,Douglas,GA,13097,599,355,6,0,238,32,22,5,0,5,567,333,1,233
1990,Early,GA,13099,31,22,1,2,6,4,1,1,2,0,27,21,0,6
1990,Echols,GA,13101,7,7,0,0,0,0,0,0,0,0,7,7,0,0
1990,Effingham,GA,13103,200,54,0,1,145,3,1,0,1,1,197,53,0,144
1990,Elbert,GA,13105,69,22,0,0,47,2,2,0,0,0,67,20,0,47
1990,Emanuel,GA,13107,109,40,2,1,66,2,0,1,1,0,107,40,1,66
1990,Evans,GA,13109,48,15,0,0,33,0,0,0,0,0,48,15,0,33
1990,Fannin,GA,13111,33,21,0,0,12,1,1,0,0,0,32,20,0,12
1990,Fayette,GA,13113,276,146,9,0,121,44,24,9,0,11,232,122,0,110
1990,Floyd,GA,13115,556,265,7,0,284,72,41,7,0,24,484,224,0,260
1990,Forsyth,GA,13117,242,135,8,0,99,12,7,5,0,0,230,128,3,99
1990,Franklin,GA,13119,53,32,3,0,18,5,2,3,0,0,48,30,0,18
1990,Fulton,GA,13121,4989,1811,176,0,3002,367,137,156,0,74,4622,1674,20,2928
1990,Gilmer,GA,13123,44,28,1,0,15,3,2,1,0,0,41,26,0,15
1990,Glascock,GA,13125,13,2,0,0,11,0,0,0,0,0,13,2,0,11
1990,Glynn,GA,13127,338,157,2,0,179,9,7,2,0,0,329,150,0,179
1990,Gordon,GA,13129,198,77,2,0,119,30,10,2,0,18,168,67,0,101
1990,Grady,GA,13131,49,33,0,2,14,4,1,0,2,1,45,32,0,13
1990,Greene,GA,13133,54,18,2,0,34,1,0,1,0,0,53,18,1,34
1990,Gwinnett,GA,13135,2368,1509,43,0,816,208,141,39,0,28,2160,1368,4,788
1990,Habersham,GA,13137,106,46,2,0,58,6,3,2,0,1,100,43,0,57
1990,Hall,GA,13139,503,254,14,0,235,34,22,12,0,0,469,232,2,235
1990,Hancock,GA,13141,49,14,0,0,35,1,1,0,0,0,48,13,0,35
1990,Haralson,GA,13143,115,44,1,0,70,9,3,1,0,5,106,41,0,65
1990,Harris,GA,13145,86,45,1,0,40,5,3,1,0,1,81,42,0,39
1990,Hart,GA,13147,38,17,0,0,21,0,0,0,0,0,38,17,0,21
1990,Heard,GA,13149,89,25,0,0,64,4,0,0,0,4,85,25,0,60
1990,Henry,GA,13151,454,269,2,0,183,27,18,2,0,7,427,251,0,176
1990,Houston,GA,13153,642,357,0,0,285,12,9,0,0,3,630,348,0,282
1990,Irwin,GA,13155,29,20,0,0,9,0,0,0,0,0,29,20,0,9
1990,Jackson,GA,13157,190,69,1,0,120,1,0,1,0,0,189,69,0,120
1990,Jasper,GA,13159,64,19,0,0,45,0,0,0,0,0,64,19,0,45
1990,Jeff Davis,GA,13161,63,19,0,3,41,3,0,0,3,0,60,19,0,41
1990,Jefferson,GA,13163,91,12,0,0,79,0,0,0,0,0,91,12,0,79
1990,Jenkins,GA,13165,30,8,0,0,22,0,0,0,0,0,30,8,0,22
1990,Johnson,GA,13167,40,11,0,0,29,0,0,0,0,0,40,11,0,29
1990,Jones,GA,13169,111,43,1,0,67,5,3,1,0,1,106,40,0,66
1990,Lamar,GA,13171,102,34,1,1,66,2,0,1,1,0,100,34,0,66
1990,Lanier,GA,13173,16,14,1,0,1,2,1,1,0,0,14,13,0,1
1990,Laurens,GA,13175,276,81,2,1,192,6,3,2,1,0,270,78,0,192
1990,Lee,GA,13177,80,62,1,2,15,4,1,1,2,0,76,61,0,15
1990,Liberty,GA,13179,361,61,4,0,296,6,3,3,0,0,355,58,1,296
1990,Lincoln,GA,13181,28,7,0,0,21,0,0,0,0,0,28,7,0,21
1990,Long,GA,13183,30,7,0,0,23,0,0,0,0,0,30,7,0,23
1990,Lowndes,GA,13185,322,243,7,1,71,11,3,7,1,0,311,240,0,71
1990,Lumpkin,GA,13187,31,16,0,0,15,2,1,0,0,1,29,15,0,14
1990,McDuffie,GA,13189,144,25,0,1,118,1,0,0,1,0,143,25,0,118
1990,McIntosh,GA,13191,43,14,0,0,29,0,0,0,0,0,43,14,0,29
1990,Macon,GA,13193,30,15,0,1,14,1,0,0,1,0,29,15,0,14
1990,Madison,GA,13195,115,56,0,0,59,0,0,0,0,0,115,56,0,59
1990,Marion,GA,13197,9,4,1,0,4,1,0,1,0,0,8,4,0,4
1990,Meriwether,GA,13199,130,34,0,3,93,9,3,0,3,3,121,31,0,90
1990,Miller,GA,13201,15,13,0,1,1,3,2,0,1,0,12,11,0,1
1990,Mitchell,GA,13205,50,36,1,0,13,4,3,1,0,0,46,33,0,13
1990,Monroe,GA,13207,99,24,2,0,73,2,0,2,0,0,97,24,0,73
1990,Montgomery,GA,13209,26,8,0,2,16,3,1,0,2,0,23,7,0,16
1990,Morgan,GA,13211,51,19,1,0,31,3,2,1,0,0,48,17,0,31
1990,Murray,GA,13213,188,62,3,0,123,22,9,3,0,10,166,53,0,113
1990,Muscogee,GA,13215,1285,724,6,0,555,19,9,6,0,4,1266,715,0,551
1990,Newton,GA,13217,319,138,1,1,179,18,9,1,1,7,301,129,0,172
1990,Oconee,GA,13219,43,16,0,0,27,1,1,0,0,0,42,15,0,27
1990,Oglethorpe,GA,13221,47,15,0,0,32,1,1,0,0,0,46,14,0,32
1990,Paulding,GA,13223,297,176,2,0,119,55,33,2,0,20,242,143,0,99
1990,Peach,GA,13225,153,57,0,0,96,3,2,0,0,1,150,55,0,95
1990,Pickens,GA,13227,48,25,1,0,22,2,1,1,0,0,46,24,0,22
1990,Pierce,GA,13229,84,32,1,0,51,1,0,1,0,0,83,32,0,51
1990,Pike,GA,13231,55,18,0,0,37,2,1,0,0,1,53,17,0,36
1990,Polk,GA,13233,217,102,0,0,115,24,12,0,0,12,193,90,0,103
1990,Pulaski,GA,13235,74,18,2,0,54,2,0,2,0,0,72,18,0,54
1990,Putnam,GA,13237,95,25,2,0,68,1,0,1,0,0,94,25,1,68
1990,Quitman,GA,13239,3,3,0,0,0,0,0,0,0,0,3,3,0,0
1990,Rabun,GA,13241,24,15,2,0,7,3,1,2,0,0,21,14,0,7
1990,Randolph,GA,13243,17,8,1,2,6,3,0,1,2,0,14,8,0,6
1990,Richmond,GA,13245,1506,443,15,0,1048,20,6,14,0,0,1486,437,1,1048
1990,Rockdale,GA,13247,387,210,5,0,172,27,19,2,0,6,360,191,3,166
1990,Schley,GA,13249,12,8,0,0,4,1,1,0,0,0,11,7,0,4
1990,Screven,GA,13251,83,26,1,0,56,1,0,1,0,0,82,26,0,56
1990,Seminole,GA,13253,34,26,1,4,3,5,0,1,4,0,29,26,0,3
1990,Spalding,GA,13255,498,140,5,0,353,35,19,4,0,12,463,121,1,341
1990,Stephens,GA,13257,117,34,1,0,82,3,2,1,0,0,114,32,0,82
1990,Stewart,GA,13259,14,9,0,0,5,1,1,0,0,0,13,8,0,5
1990,Sumter,GA,13261,111,59,0,0,52,3,1,0,0,2,108,58,0,50
1990,Talbot,GA,13263,28,13,0,0,15,0,0,0,0,0,28,13,0,15
1990,Taliaferro,GA,13265,6,2,0,1,3,1,0,0,1,0,5,2,0,3
1990,Tattnall,GA,13267,58,37,0,4,17,5,1,0,4,0,53,36,0,17
1990,Taylor,GA,13269,17,5,0,0,12,0,0,0,0,0,17,5,0,12
1990,Telfair,GA,13271,38,12,1,1,24,2,0,1,1,0,36,12,0,24
1990,Terrell,GA,13273,41,28,1,4,8,6,1,1,4,0,35,27,0,8
1990,Thomas,GA,13275,108,90,1,0,17,9,8,1,0,0,99,82,0,17
1990,Tift,GA,13277,205,142,2,3,58,8,3,2,3,0,197,139,0,58
1990,Toombs,GA,13279,109,41,4,1,63,4,0,3,1,0,105,41,1,63
1990,Towns,GA,13281,20,9,0,0,11,0,0,0,0,0,20,9,0,11
1990,Treutlen,GA,13283,17,6,0,0,11,1,1,0,0,0,16,5,0,11
1990,Troup,GA,13285,462,140,8,0,314,43,18,8,0,17,419,122,0,297
1990,Turner,GA,13287,37,27,0,0,10,0,0,0,0,0,37,27,0,10
1990,Twiggs,GA,13289,51,13,0,0,38,0,0,0,0,0,51,13,0,38
1990,Union,GA,13291,31,15,1,0,15,1,0,1,0,0,30,15,0,15
1990,Upson,GA,13293,147,36,0,0,111,1,1,0,0,0,146,35,0,111
1990,Walker,GA,13295,583,192,0,0,391,10,6,0,0,4,573,186,0,387
1990,Walton,GA,13297,251,135,3,3,110,9,3,2,3,1,242,132,1,109
1990,Ware,GA,13299,245,72,1,0,172,2,1,1,0,0,243,71,0,172
1990,Warren,GA,13301,34,6,0,1,27,1,0,0,1,0,33,6,0,27
1990,Washington,GA,13303,105,31,2,0,72,4,2,2,0,0,101,29,0,72
1990,Wayne,GA,13305,156,26,0,0,130,1,1,0,0,0,155,25,0,130
1990,Webster,GA,13307,6,3,1,0,2,1,0,1,0,0,5,3,0,2
1990,Wheeler,GA,13309,16,2,0,0,14,0,0,0,0,0,16,2,0,14
1990,White,GA,13311,58,30,3,0,25,3,2,1,0,0,55,28,2,25
1990,Whitfield,GA,13313,562,210,6,0,346,75,37,6,0,32,487,173,0,314
1990,Wilcox,GA,13315,19,5,0,0,14,0,0,0,0,0,19,5,0,14
1990,Wilkes,GA,13317,27,8,0,0,19,0,0,0,0,0,27,8,0,19
1990,Wilkinson,GA,13319,79,26,1,0,52,1,0,1,0,0,78,26,0,52
1990,Worth,GA,13321,58,41,0,0,17,1,1,0,0,0,57,40,0,17
1990,Hawaii,HI,15001,88,79,4,0,5,11,6,4,0,1,77,73,0,4
1990,Honolulu,HI,15003,677,575,33,0,69,56,31,25,0,0,621,544,8,69
1990,Kauai,HI,15007,47,44,1,0,2,1,0,1,0,0,46,44,0,2
1990,Maui,HI,15009,80,71,4,0,5,10,6,4,0,0,70,65,0,5
1990,Ada,ID,16001,1087,589,18,3,477,92,44,16,3,29,995,545,2,448
1990,Adams,ID,16003,11,10,1,0,0,2,1,1,0,0,9,9,0,0
1990,Bannock,ID,16005,260,196,2,1,61,16,10,2,1,3,244,186,0,58
1990,Bear Lake,ID,16007,13,10,0,0,3,1,0,0,0,1,12,10,0,2
1990,Benewah,ID,16009,38,17,1,0,20,4,2,1,0,1,34,15,0,19
1990,Bingham,ID,16011,96,70,2,3,21,11,3,2,3,3,85,67,0,18
1990,Blaine,ID,16013,35,26,2,1,6,6,4,1,1,0,29,22,1,6
1990,Boise,ID,16015,11,5,1,0,5,1,0,1,0,0,10,5,0,5
1990,Bonner,ID,16017,77,45,3,0,29,9,4,3,0,2,68,41,0,27
1990,Bonneville,ID,16019,259,187,3,0,69,18,12,3,0,3,241,175,0,66
1990,Boundary,ID,16021,19,8,0,0,11,2,0,0,0,2,17,8,0,9
1990,Butte,ID,16023,12,7,0,0,5,0,0,0,0,0,12,7,0,5
1990,Camas,ID,16025,4,3,1,0,0,1,0,1,0,0,3,3,0,0
1990,Canyon,ID,16027,539,364,0,2,173,37,20,0,2,15,502,344,0,158
1990,Caribou,ID,16029,19,13,2,0,4,4,1,2,0,1,15,12,0,3
1990,Cassia,ID,16031,53,43,1,0,9,6,5,0,0,1,47,38,1,8
1990,Clark,ID,16033,2,1,0,0,1,1,1,0,0,0,1,0,0,1
1990,Clearwater,ID,16035,29,21,1,1,6,4,1,1,1,1,25,20,0,5
1990,Custer,ID,16037,10,7,0,0,3,2,1,0,0,1,8,6,0,2
1990,Elmore,ID,16039,83,48,1,1,33,7,3,1,1,2,76,45,0,31
1990,Franklin,ID,16041,16,11,0,0,5,1,1,0,0,0,15,10,0,5
1990,Fremont,ID,16043,30,23,3,2,2,5,0,3,2,0,25,23,0,2
1990,Gem,ID,16045,51,31,1,1,18,2,0,1,1,0,49,31,0,18
1990,Gooding,ID,16047,40,32,2,0,6,3,1,2,0,0,37,31,0,6
1990,Idaho,ID,16049,31,26,0,0,5,7,7,0,0,0,24,19,0,5
1990,Jefferson,ID,16051,46,30,0,0,16,2,1,0,0,1,44,29,0,15
1990,Jerome,ID,16053,55,46,0,0,9,1,1,0,0,0,54,45,0,9
1990,Kootenai,ID,16055,378,218,4,0,156,34,19,4,0,11,344,199,0,145
1990,Latah,ID,16057,46,34,0,0,12,5,3,0,0,2,41,31,0,10
1990,Lemhi,ID,16059,12,12,0,0,0,0,0,0,0,0,12,12,0,0
1990,Lewis,ID,16061,10,8,0,0,2,1,1,0,0,0,9,7,0,2
1990,Lincoln,ID,16063,14,12,0,2,0,2,0,0,2,0,12,12,0,0
1990,Madison,ID,16065,50,40,1,1,8,3,1,0,1,1,47,39,1,7
1990,Minidoka,ID,16067,49,37,1,1,10,7,3,1,1,2,42,34,0,8
1990,Nez Perce,ID,16069,103,70,3,1,29,12,5,3,1,3,91,65,0,26
1990,Oneida,ID,16071,9,8,0,0,1,0,0,0,0,0,9,8,0,1
1990,Owyhee,ID,16073,31,18,0,3,10,4,1,0,3,0,27,17,0,10
1990,Payette,ID,16075,62,40,2,3,17,9,1,2,3,3,53,39,0,14
1990,Power,ID,16077,25,20,1,0,4,3,2,1,0,0,22,18,0,4
1990,Shoshone,ID,16079,43,26,0,0,17,2,2,0,0,0,41,24,0,17
1990,Teton,ID,16081,11,6,1,0,4,3,1,1,0,1,8,5,0,3
1990,Twin Falls,ID,16083,227,188,0,3,36,16,10,0,3,3,211,178,0,33
1990,Valley,ID,16085,18,13,0,0,5,0,0,0,0,0,18,13,0,5
1990,Washington,ID,16087,25,17,0,0,8,1,1,0,0,0,24,16,0,8
1990,Adams,IL,17001,186,174,4,4,4,14,6,4,4,0,172,168,0,4
1990,Alexander,IL,17003,17,14,0,0,3,2,2,0,0,0,15,12,0,3
1990,Bond,IL,17005,36,27,0,0,9,6,5,0,0,1,30,22,0,8
1990,Boone,IL,17007,123,71,1,0,51,1,0,1,0,0,122,71,0,51
1990,Brown,IL,17009,12,12,0,0,0,2,2,0,0,0,10,10,0,0
1990,Bureau,IL,17011,91,81,1,0,9,1,0,1,0,0,90,81,0,9
1990,Calhoun,IL,17013,15,13,1,0,1,6,4,1,0,1,9,9,0,0
1990,Carroll,IL,17015,29,25,0,0,4,0,0,0,0,0,29,25,0,4
1990,Cass,IL,17017,40,39,0,0,1,1,1,0,0,0,39,38,0,1
1990,Champaign,IL,17019,501,448,12,0,41,21,10,11,0,0,480,438,1,41
1990,Christian,IL,17021,104,101,2,1,0,7,4,2,1,0,97,97,0,0
1990,Clark,IL,17023,60,49,2,1,8,15,10,2,1,2,45,39,0,6
1990,Clay,IL,17025,30,27,0,0,3,3,3,0,0,0,27,24,0,3
1990,Clinton,IL,17027,71,53,0,0,18,12,12,0,0,0,59,41,0,18
1990,Coles,IL,17029,155,144,1,0,10,5,3,1,0,1,150,141,0,9
1990,Cook,IL,17031,18602,12496,258,1,5847,730,428,246,1,55,17872,12068,12,5792
1990,Crawford,IL,17033,62,60,2,0,0,15,13,2,0,0,47,47,0,0
1990,Cumberland,IL,17035,38,32,3,1,2,13,8,3,1,1,25,24,0,1
1990,DeKalb,IL,17037,182,160,1,0,21,4,3,1,0,0,178,157,0,21
1990,De Witt,IL,17039,51,50,0,0,1,0,0,0,0,0,51,50,0,1
1990,Douglas,IL,17041,43,39,2,0,2,2,0,2,0,0,41,39,0,2
1990,Du Page,IL,17043,1755,1497,46,0,212,202,147,46,0,9,1553,1350,0,203
1990,Edgar,IL,17045,72,69,1,0,2,2,1,1,0,0,70,68,0,2
1990,Edwards,IL,17047,22,18,0,2,2,7,4,0,2,1,15,14,0,1
1990,Effingham,IL,17049,61,52,2,1,6,10,6,2,1,1,51,46,0,5
1990,Fayette,IL,17051,72,59,1,4,8,11,5,1,4,1,61,54,0,7
1990,Ford,IL,17053,35,33,0,0,2,1,1,0,0,0,34,32,0,2
1990,Franklin,IL,17055,152,141,2,1,8,34,27,2,1,4,118,114,0,4
1990,Fulton,IL,17057,133,111,1,0,21,3,2,1,0,0,130,109,0,21
1990,Gallatin,IL,17059,18,17,1,0,0,6,5,1,0,0,12,12,0,0
1990,Greene,IL,17061,22,22,0,0,0,0,0,0,0,0,22,22,0,0
1990,Grundy,IL,17063,107,102,0,1,4,1,0,0,1,0,106,102,0,4
1990,Hamilton,IL,17065,17,17,0,0,0,3,3,0,0,0,14,14,0,0
1990,Hancock,IL,17067,42,25,0,0,17,0,0,0,0,0,42,25,0,17
1990,Hardin,IL,17069,6,6,0,0,0,4,4,0,0,0,2,2,0,0
1990,Henderson,IL,17071,25,21,1,0,3,1,1,0,0,0,24,20,1,3
1990,Henry,IL,17073,158,119,1,1,37,5,3,1,1,0,153,116,0,37
1990,Iroquois,IL,17075,59,58,1,0,0,4,3,1,0,0,55,55,0,0
1990,Jackson,IL,17077,118,112,1,1,4,25,23,1,1,0,93,89,0,4
1990,Jasper,IL,17079,31,29,0,0,2,9,8,0,0,1,22,21,0,1
1990,Jefferson,IL,17081,118,101,2,0,15,22,18,2,0,2,96,83,0,13
1990,Jersey,IL,17083,73,57,0,2,14,12,9,0,2,1,61,48,0,13
1990,Jo Daviess,IL,17085,41,34,2,1,4,8,5,2,1,0,33,29,0,4
1990,Johnson,IL,17087,18,17,0,0,1,5,4,0,0,1,13,13,0,0
1990,Kane,IL,17089,1020,875,16,1,128,50,31,15,1,3,970,844,1,125
1990,Kankakee,IL,17091,310,302,1,0,7,6,4,1,0,1,304,298,0,6
1990,Kendall,IL,17093,81,73,3,0,5,5,2,3,0,0,76,71,0,5
1990,Knox,IL,17095,233,176,1,2,54,7,3,1,2,1,226,173,0,53
1990,Lake,IL,17097,1364,1032,27,0,305,75,42,27,0,6,1289,990,0,299
1990,La Salle,IL,17099,291,284,0,1,6,15,13,0,1,1,276,271,0,5
1990,Lawrence,IL,17101,36,33,1,0,2,8,6,1,0,1,28,27,0,1
1990,Lee,IL,17103,96,89,1,0,6,2,1,1,0,0,94,88,0,6
1990,Livingston,IL,17105,104,95,1,0,8,2,1,1,0,0,102,94,0,8
1990,Logan,IL,17107,95,93,2,0,0,3,1,2,0,0,92,92,0,0
1990,McDonough,IL,17109,75,54,2,0,19,2,0,2,0,0,73,54,0,19
1990,McHenry,IL,17111,486,399,12,0,75,26,16,10,0,0,460,383,2,75
1990,McLean,IL,17113,390,366,2,0,22,13,10,2,0,1,377,356,0,21
1990,Macon,IL,17115,542,513,4,0,25,11,6,3,0,2,531,507,1,23
1990,Macoupin,IL,17117,149,130,0,2,17,10,8,0,2,0,139,122,0,17
1990,Madison,IL,17119,875,620,17,3,235,143,92,17,3,31,732,528,0,204
1990,Marion,IL,17121,209,183,6,2,18,42,30,6,2,4,167,153,0,14
1990,Marshall,IL,17123,24,21,0,0,3,0,0,0,0,0,24,21,0,3
1990,Mason,IL,17125,63,57,1,1,4,3,0,1,1,1,60,57,0,3
1990,Massac,IL,17127,27,27,0,0,0,8,8,0,0,0,19,19,0,0
1990,Menard,IL,17129,21,21,0,0,0,0,0,0,0,0,21,21,0,0
1990,Mercer,IL,17131,55,35,1,1,18,5,3,1,1,0,50,32,0,18
1990,Monroe,IL,17133,59,43,0,0,16,12,8,0,0,4,47,35,0,12
1990,Montgomery,IL,17135,91,81,0,3,7,4,1,0,3,0,87,80,0,7
1990,Morgan,IL,17137,91,89,1,0,1,3,2,1,0,0,88,87,0,1
1990,Moultrie,IL,17139,21,19,1,0,1,2,1,1,0,0,19,18,0,1
1990,Ogle,IL,17141,116,95,1,0,20,1,0,1,0,0,115,95,0,20
1990,Peoria,IL,17143,736,624,7,0,105,18,11,7,0,0,718,613,0,105
1990,Perry,IL,17145,45,39,3,0,3,11,6,3,0,2,34,33,0,1
1990,Piatt,IL,17147,38,35,1,0,2,2,1,1,0,0,36,34,0,2
1990,Pike,IL,17149,44,40,1,0,3,4,3,1,0,0,40,37,0,3
1990,Pope,IL,17151,8,6,1,0,1,2,1,1,0,0,6,5,0,1
1990,Pulaski,IL,17153,15,13,0,0,2,4,3,0,0,1,11,10,0,1
1990,Putnam,IL,17155,16,15,0,0,1,1,1,0,0,0,15,14,0,1
1990,Randolph,IL,17157,51,36,0,2,13,5,3,0,2,0,46,33,0,13
1990,Richland,IL,17159,34,31,1,1,1,10,8,1,1,0,24,23,0,1
1990,Rock Island,IL,17161,645,440,3,2,200,7,2,3,2,0,638,438,0,200
1990,St. Clair,IL,17163,1015,668,12,1,333,120,85,12,1,21,895,583,0,312
1990,Saline,IL,17165,65,58,1,0,6,10,7,1,0,2,55,51,0,4
1990,Sangamon,IL,17167,563,538,3,1,21,12,7,3,1,1,551,531,0,20
1990,Schuyler,IL,17169,13,10,1,0,2,2,0,1,0,1,11,10,0,1
1990,Scott,IL,17171,27,26,0,1,0,2,1,0,1,0,25,25,0,0
1990,Shelby,IL,17173,57,54,1,0,2,4,3,1,0,0,53,51,0,2
1990,Stark,IL,17175,21,19,0,0,2,0,0,0,0,0,21,19,0,2
1990,Stephenson,IL,17177,119,92,3,0,24,5,2,3,0,0,114,90,0,24
1990,Tazewell,IL,17179,446,406,3,1,36,6,2,3,1,0,440,404,0,36
1990,Union,IL,17181,36,31,3,0,2,5,2,3,0,0,31,29,0,2
1990,Vermilion,IL,17183,338,308,6,0,24,9,3,6,0,0,329,305,0,24
1990,Wabash,IL,17185,39,36,0,0,3,11,10,0,0,1,28,26,0,2
1990,Warren,IL,17187,81,55,1,1,24,4,1,1,1,1,77,54,0,23
1990,Washington,IL,17189,31,26,2,0,3,8,5,2,0,1,23,21,0,2
1990,Wayne,IL,17191,27,25,0,0,2,9,8,0,0,1,18,17,0,1
1990,White,IL,17193,42,40,0,1,1,10,8,0,1,1,32,32,0,0
1990,Whiteside,IL,17195,159,130,6,0,23,6,0,6,0,0,153,130,0,23
1990,Will,IL,17197,1204,988,7,1,208,41,31,7,1,2,1163,957,0,206
1990,Williamson,IL,17199,171,160,3,0,8,35,30,3,0,2,136,130,0,6
1990,Winnebago,IL,17201,1173,668,7,0,498,14,7,7,0,0,1159,661,0,498
1990,Woodford,IL,17203,67,60,3,0,4,4,1,3,0,0,63,59,0,4
1990,Adams,IN,18001,63,55,2,0,6,7,5,2,0,0,56,50,0,6
1990,Allen,IN,18003,1141,933,19,0,189,118,91,18,0,9,1023,842,1,180
1990,Bartholomew,IN,18005,285,261,6,0,18,11,5,6,0,0,274,256,0,18
1990,Benton,IN,18007,32,26,0,0,6,2,2,0,0,0,30,24,0,6
1990,Blackford,IN,18009,47,44,2,0,1,6,4,2,0,0,41,40,0,1
1990,Boone,IN,18011,149,138,2,0,9,5,3,2,0,0,144,135,0,9
1990,Brown,IN,18013,68,62,1,0,5,3,2,1,0,0,65,60,0,5
1990,Carroll,IN,18015,62,57,0,0,5,3,2,0,0,1,59,55,0,4
1990,Cass,IN,18017,98,85,2,1,10,8,5,2,1,0,90,80,0,10
1990,Clark,IN,18019,404,362,2,0,40,3,1,2,0,0,401,361,0,40
1990,Clay,IN,18021,90,83,1,0,6,5,4,1,0,0,85,79,0,6
1990,Clinton,IN,18023,152,129,0,3,20,4,0,0,3,1,148,129,0,19
1990,Crawford,IN,18025,37,35,1,0,1,1,0,1,0,0,36,35,0,1
1990,Daviess,IN,18027,57,57,0,0,0,6,6,0,0,0,51,51,0,0
1990,De Kalb,IN,18029,109,109,0,0,0,3,3,0,0,0,106,106,0,0
1990,Dearborn,IN,18031,104,94,0,0,10,3,3,0,0,0,101,91,0,10
1990,Decatur,IN,18033,116,102,1,0,13,6,4,1,0,1,110,98,0,12
1990,Delaware,IN,18035,413,393,7,0,13,13,6,7,0,0,400,387,0,13
1990,Dubois,IN,18037,54,52,2,0,0,5,3,2,0,0,49,49,0,0
1990,Elkhart,IN,18039,732,696,16,0,20,49,33,15,0,1,683,663,1,19
1990,Fayette,IN,18041,119,111,0,3,5,3,0,0,3,0,116,111,0,5
1990,Floyd,IN,18043,228,202,4,0,22,11,4,4,0,3,217,198,0,19
1990,Fountain,IN,18045,66,60,0,0,6,1,1,0,0,0,65,59,0,6
1990,Franklin,IN,18047,57,55,1,0,1,1,0,1,0,0,56,55,0,1
1990,Fulton,IN,18049,90,85,1,2,2,5,2,1,2,0,85,83,0,2
1990,Gibson,IN,18051,88,85,2,0,1,6,4,2,0,0,82,81,0,1
1990,Grant,IN,18053,361,337,0,2,22,20,17,0,2,1,341,320,0,21
1990,Greene,IN,18055,100,90,0,0,10,3,3,0,0,0,97,87,0,10
1990,Hamilton,IN,18057,364,329,9,1,25,19,7,9,1,2,345,322,0,23
1990,Hancock,IN,18059,154,139,3,1,11,7,3,3,1,0,147,136,0,11
1990,Harrison,IN,18061,93,80,4,5,4,13,5,3,5,0,80,75,1,4
1990,Hendricks,IN,18063,248,225,3,0,20,11,7,3,0,1,237,218,0,19
1990,Henry,IN,18065,192,183,0,0,9,0,0,0,0,0,192,183,0,9
1990,Howard,IN,18067,358,318,3,0,37,7,4,3,0,0,351,314,0,37
1990,Huntington,IN,18069,107,96,1,1,9,12,10,1,1,0,95,86,0,9
1990,Jackson,IN,18071,135,125,1,0,9,3,2,1,0,0,132,123,0,9
1990,Jasper,IN,18073,80,72,0,0,8,3,3,0,0,0,77,69,0,8
1990,Jay,IN,18075,82,75,2,0,5,7,5,2,0,0,75,70,0,5
1990,Jefferson,IN,18077,102,99,0,0,3,0,0,0,0,0,102,99,0,3
1990,Jennings,IN,18079,82,81,1,0,0,3,2,1,0,0,79,79,0,0
1990,Johnson,IN,18081,463,409,5,0,49,16,10,5,0,1,447,399,0,48
1990,Knox,IN,18083,103,98,2,0,3,5,4,1,0,0,98,94,1,3
1990,Kosciusko,IN,18085,184,175,3,0,6,21,16,3,0,2,163,159,0,4
1990,La Porte,IN,18087,50,47,2,0,1,5,3,2,0,0,45,44,0,1
1990,Lagrange,IN,18089,1993,1574,28,1,390,93,53,28,1,11,1900,1521,0,379
1990,Lake,IN,18091,367,344,6,0,17,18,12,6,0,0,349,332,0,17
1990,Lawrence,IN,18093,180,157,1,0,22,5,4,1,0,0,175,153,0,22
1990,Madison,IN,18095,663,633,5,0,25,11,6,4,0,1,652,627,1,24
1990,Marion,IN,18097,6203,5438,90,0,674,171,76,86,0,8,6032,5362,4,666
1990,Marshall,IN,18099,135,128,3,0,4,8,5,3,0,0,127,123,0,4
1990,Martin,IN,18101,22,21,0,0,1,1,1,0,0,0,21,20,0,1
1990,Miami,IN,18103,99,86,2,0,11,8,5,2,0,1,91,81,0,10
1990,Monroe,IN,18105,348,272,6,0,70,10,4,6,0,0,338,268,0,70
1990,Montgomery,IN,18107,149,138,3,1,7,5,1,2,1,1,144,137,1,6
1990,Morgan,IN,18109,326,288,2,0,36,9,3,2,0,4,317,285,0,32
1990,Newton,IN,18111,64,58,0,0,6,2,1,0,0,1,62,57,0,5
1990,Noble,IN,18113,129,121,3,0,5,14,11,3,0,0,115,110,0,5
1990,Ohio,IN,18115,21,21,0,0,0,0,0,0,0,0,21,21,0,0
1990,Orange,IN,18117,61,53,1,0,7,4,3,1,0,0,57,50,0,7
1990,Owen,IN,18119,87,76,0,0,11,0,0,0,0,0,87,76,0,11
1990,Parke,IN,18121,50,45,0,1,4,2,1,0,1,0,48,44,0,4
1990,Perry,IN,18123,44,41,0,1,2,3,2,0,1,0,41,39,0,2
1990,Pike,IN,18125,28,27,0,0,1,1,1,0,0,0,27,26,0,1
1990,Porter,IN,18127,452,375,14,2,61,45,22,14,2,7,407,353,0,54
1990,Posey,IN,18129,69,62,1,2,4,6,3,1,2,0,63,59,0,4
1990,Pulaski,IN,18131,32,28,4,0,0,4,0,4,0,0,28,28,0,0
1990,Putnam,IN,18133,130,123,0,0,7,7,7,0,0,0,123,116,0,7
1990,Randolph,IN,18135,127,125,1,0,1,5,4,1,0,0,122,121,0,1
1990,Ripley,IN,18137,64,62,1,0,1,1,1,0,0,0,63,61,1,1
1990,Rush,IN,18139,95,82,2,0,11,3,2,1,0,0,92,80,1,11
1990,St. Joseph,IN,18141,910,795,6,1,108,46,35,5,1,5,864,760,1,103
1990,Scott,IN,18143,97,89,1,0,7,2,1,1,0,0,95,88,0,7
1990,Shelby,IN,18145,229,219,2,0,8,4,2,2,0,0,225,217,0,8
1990,Spencer,IN,18147,46,45,0,0,1,1,1,0,0,0,45,44,0,1
1990,Starke,IN,18149,88,80,2,2,4,10,4,2,2,2,78,76,0,2
1990,Steuben,IN,18151,101,90,3,0,8,14,10,3,0,1,87,80,0,7
1990,Sullivan,IN,18153,62,55,1,0,6,3,2,1,0,0,59,53,0,6
1990,Switzerland,IN,18155,27,26,0,0,1,0,0,0,0,0,27,26,0,1
1990,Tippecanoe,IN,18157,394,343,3,0,48,17,11,3,0,3,377,332,0,45
1990,Tipton,IN,18159,92,85,1,0,6,4,2,1,0,1,88,83,0,5
1990,Union,IN,18161,26,22,0,2,2,2,0,0,2,0,24,22,0,2
1990,Vanderburgh,IN,18163,654,625,6,0,23,33,26,5,0,2,621,599,1,21
1990,Vermillion,IN,18165,52,48,0,0,4,1,1,0,0,0,51,47,0,4
1990,Vigo,IN,18167,362,326,2,0,34,11,8,2,0,1,351,318,0,33
1990,Wabash,IN,18169,131,117,1,1,12,9,7,1,1,0,122,110,0,12
1990,Warren,IN,18171,28,25,0,0,3,1,1,0,0,0,27,24,0,3
1990,Warrick,IN,18173,119,116,0,0,3,4,4,0,0,0,115,112,0,3
1990,Washington,IN,18175,80,77,0,0,3,1,1,0,0,0,79,76,0,3
1990,Wayne,IN,18177,222,208,5,2,7,8,0,5,2,1,214,208,0,6
1990,Wells,IN,18179,58,45,2,0,11,7,5,2,0,0,51,40,0,11
1990,White,IN,18181,122,108,1,2,11,15,9,1,2,3,107,99,0,8
1990,Whitley,IN,18183,69,63,1,0,5,5,3,1,0,1,64,60,0,4
1990,Adair,IA,19001,13,13,0,0,0,3,3,0,0,0,10,10,0,0
1990,Adams,IA,19003,8,7,0,1,0,4,3,0,1,0,4,4,0,0
1990,Allamakee,IA,19005,10,9,0,1,0,5,4,0,1,0,5,5,0,0
1990,Appanoose,IA,19007,16,10,0,0,6,0,0,0,0,0,16,10,0,6
1990,Audubon,IA,19009,9,8,0,0,1,1,1,0,0,0,8,7,0,1
1990,Benton,IA,19011,26,24,0,0,2,8,7,0,0,1,18,17,0,1
1990,Black Hawk,IA,19013,251,228,3,0,20,52,42,3,0,7,199,186,0,13
1990,Boone,IA,19015,47,44,0,0,3,0,0,0,0,0,47,44,0,3
1990,Bremer,IA,19017,32,29,1,0,2,12,9,1,0,2,20,20,0,0
1990,Buchanan,IA,19019,39,37,1,0,1,13,11,1,0,1,26,26,0,0
1990,Buena Vista,IA,19021,32,32,0,0,0,10,10,0,0,0,22,22,0,0
1990,Butler,IA,19023,29,26,1,0,2,12,11,1,0,0,17,15,0,2
1990,Calhoun,IA,19025,20,19,0,1,0,12,11,0,1,0,8,8,0,0
1990,Carroll,IA,19027,18,16,0,0,2,8,7,0,0,1,10,9,0,1
1990,Cass,IA,19029,23,21,0,0,2,2,2,0,0,0,21,19,0,2
1990,Cedar,IA,19031,36,30,1,3,2,10,6,1,3,0,26,24,0,2
1990,Cerro Gordo,IA,19033,86,84,0,2,0,11,9,0,2,0,75,75,0,0
1990,Cherokee,IA,19035,10,10,0,0,0,4,4,0,0,0,6,6,0,0
1990,Chickasaw,IA,19037,23,17,2,2,2,9,3,2,2,2,14,14,0,0
1990,Clarke,IA,19039,15,15,0,0,0,2,2,0,0,0,13,13,0,0
1990,Clay,IA,19041,22,20,0,0,2,11,10,0,0,1,11,10,0,1
1990,Clayton,IA,19043,19,17,0,1,1,6,5,0,1,0,13,12,0,1
1990,Clinton,IA,19045,128,107,1,0,20,13,12,0,0,1,115,95,1,19
1990,Crawford,IA,19047,31,29,0,1,1,6,5,0,1,0,25,24,0,1
1990,Dallas,IA,19049,61,59,0,0,2,9,9,0,0,0,52,50,0,2
1990,Davis,IA,19051,22,19,0,0,3,2,2,0,0,0,20,17,0,3
1990,Decatur,IA,19053,14,14,0,0,0,3,3,0,0,0,11,11,0,0
1990,Delaware,IA,19055,13,12,0,0,1,7,6,0,0,1,6,6,0,0
1990,Des Moines,IA,19057,126,121,0,0,5,6,6,0,0,0,120,115,0,5
1990,Dickinson,IA,19059,18,17,1,0,0,7,6,1,0,0,11,11,0,0
1990,Dubuque,IA,19061,133,120,4,0,9,36,29,4,0,3,97,91,0,6
1990,Emmet,IA,19063,16,16,0,0,0,6,6,0,0,0,10,10,0,0
1990,Fayette,IA,19065,17,17,0,0,0,2,2,0,0,0,15,15,0,0
1990,Floyd,IA,19067,34,32,2,0,0,12,10,2,0,0,22,22,0,0
1990,Franklin,IA,19069,15,13,2,0,0,5,3,2,0,0,10,10,0,0
1990,Fremont,IA,19071,13,12,0,0,1,6,5,0,0,1,7,7,0,0
1990,Greene,IA,19073,22,19,1,0,2,6,4,1,0,1,16,15,0,1
1990,Grundy,IA,19075,6,6,0,0,0,2,2,0,0,0,4,4,0,0
1990,Guthrie,IA,19077,17,17,0,0,0,4,4,0,0,0,13,13,0,0
1990,Hamilton,IA,19079,30,28,0,2,0,10,8,0,2,0,20,20,0,0
1990,Hancock,IA,19081,26,23,1,1,1,7,4,1,1,1,19,19,0,0
1990,Hardin,IA,19083,31,29,0,2,0,12,10,0,2,0,19,19,0,0
1990,Harrison,IA,19085,46,43,0,1,2,6,5,0,1,0,40,38,0,2
1990,Henry,IA,19087,53,51,0,0,2,5,4,0,0,1,48,47,0,1
1990,Howard,IA,19089,8,8,0,0,0,3,3,0,0,0,5,5,0,0
1990,Humboldt,IA,19091,16,15,0,1,0,7,6,0,1,0,9,9,0,0
1990,Ida,IA,19093,10,8,0,0,2,5,3,0,0,2,5,5,0,0
1990,Iowa,IA,19095,10,8,1,0,1,2,1,1,0,0,8,7,0,1
1990,Jackson,IA,19097,44,38,1,0,5,9,7,1,0,1,35,31,0,4
1990,Jasper,IA,19099,66,63,1,0,2,8,7,1,0,0,58,56,0,2
1990,Jefferson,IA,19101,35,29,0,0,6,5,5,0,0,0,30,24,0,6
1990,Johnson,IA,19103,110,100,7,0,3,24,17,7,0,0,86,83,0,3
1990,Jones,IA,19105,31,29,0,1,1,10,9,0,1,0,21,20,0,1
1990,Keokuk,IA,19107,25,24,0,0,1,3,3,0,0,0,22,21,0,1
1990,Kossuth,IA,19109,16,16,0,0,0,5,5,0,0,0,11,11,0,0
1990,Lee,IA,19111,118,114,1,0,3,9,8,0,0,1,109,106,1,2
1990,Linn,IA,19113,390,364,5,0,21,82,71,5,0,6,308,293,0,15
1990,Louisa,IA,19115,24,21,0,0,3,5,5,0,0,0,19,16,0,3
1990,Lucas,IA,19117,8,8,0,0,0,1,1,0,0,0,7,7,0,0
1990,Lyon,IA,19119,16,15,0,0,1,5,4,0,0,1,11,11,0,0
1990,Madison,IA,19121,16,15,0,0,1,0,0,0,0,0,16,15,0,1
1990,Mahaska,IA,19123,24,23,1,0,0,6,5,1,0,0,18,18,0,0
1990,Marion,IA,19125,59,51,0,1,7,5,4,0,1,0,54,47,0,7
1990,Marshall,IA,19127,64,64,0,0,0,5,5,0,0,0,59,59,0,0
1990,Mills,IA,19129,37,30,0,0,7,5,3,0,0,2,32,27,0,5
1990,Mitchell,IA,19131,13,12,1,0,0,6,5,1,0,0,7,7,0,0
1990,Monona,IA,19133,23,21,0,1,1,7,6,0,1,0,16,15,0,1
1990,Monroe,IA,19135,7,7,0,0,0,1,1,0,0,0,6,6,0,0
1990,Montgomery,IA,19137,25,19,1,1,4,3,1,1,1,0,22,18,0,4
1990,Muscatine,IA,19139,114,95,2,0,17,6,3,2,0,1,108,92,0,16
1990,O'Brien,IA,19141,14,13,0,1,0,7,6,0,1,0,7,7,0,0
1990,Osceola,IA,19143,6,6,0,0,0,3,3,0,0,0,3,3,0,0
1990,Page,IA,19145,22,21,0,0,1,2,2,0,0,0,20,19,0,1
1990,Palo Alto,IA,19147,9,9,0,0,0,3,3,0,0,0,6,6,0,0
1990,Plymouth,IA,19149,31,29,0,2,0,11,9,0,2,0,20,20,0,0
1990,Pocahontas,IA,19151,19,19,0,0,0,8,8,0,0,0,11,11,0,0
1990,Polk,IA,19153,1060,963,10,1,86,68,54,9,1,4,992,909,1,82
1990,Pottawattamie,IA,19155,273,223,5,0,45,19,11,5,0,3,254,212,0,42
1990,Poweshiek,IA,19157,20,20,0,0,0,3,3,0,0,0,17,17,0,0
1990,Ringgold,IA,19159,4,3,0,0,1,1,1,0,0,0,3,2,0,1
1990,Sac,IA,19161,22,22,0,0,0,7,7,0,0,0,15,15,0,0
1990,Scott,IA,19163,429,290,0,0,139,20,17,0,0,3,409,273,0,136
1990,Shelby,IA,19165,16,13,0,1,2,4,3,0,1,0,12,10,0,2
1990,Sioux,IA,19167,21,19,0,0,1,9,8,0,1,0,12,11,0,1
1990,Story,IA,19169,84,80,1,1,2,10,8,1,1,0,74,72,0,2
1990,Tama,IA,19171,27,26,1,0,0,10,9,1,0,0,17,17,0,0
1990,Taylor,IA,19173,8,6,0,2,0,2,0,0,2,0,6,6,0,0
1990,Union,IA,19175,14,14,0,0,0,0,0,0,0,0,14,14,0,0
1990,Van Buren,IA,19177,12,11,0,0,1,1,1,0,0,0,11,10,0,1
1990,Wapello,IA,19179,84,51,0,0,33,3,2,0,0,1,81,49,0,32
1990,Warren,IA,19181,82,79,0,0,3,4,4,0,0,0,78,75,0,3
1990,Washington,IA,19183,19,16,0,0,3,5,4,0,0,1,14,12,0,2
1990,Wayne,IA,19185,12,10,0,1,1,1,0,0,1,0,11,10,0,1
1990,Webster,IA,19187,100,98,1,0,1,19,18,1,0,0,81,80,0,1
1990,Winnebago,IA,19189,15,15,0,0,0,3,3,0,0,0,12,12,0,0
1990,Winneshiek,IA,19191,5,3,1,1,0,3,1,1,1,0,2,2,0,0
1990,Woodbury,IA,19193,296,284,2,1,9,48,43,2,1,2,248,241,0,7
1990,Worth,IA,19195,15,14,1,0,0,7,6,1,0,0,8,8,0,0
1990,Wright,IA,19197,30,29,1,0,0,6,5,1,0,0,24,24,0,0
1990,Allen,KS,20001,29,26,1,0,2,2,1,1,0,0,27,25,0,2
1990,Anderson,KS,20003,10,8,0,0,2,2,2,0,0,0,8,6,0,2
1990,Atchison,KS,20005,37,25,0,0,12,1,1,0,0,0,36,24,0,12
1990,Barber,KS,20007,12,10,2,0,0,4,2,2,0,0,8,8,0,0
1990,Barton,KS,20009,84,82,0,0,2,6,5,0,0,1,78,77,0,1
1990,Bourbon,KS,20011,33,30,1,0,2,3,2,1,0,0,30,28,0,2
1990,Brown,KS,20013,16,10,1,0,5,2,0,1,0,1,14,10,0,4
1990,Butler,KS,20015,186,173,0,0,13,10,10,0,0,0,176,163,0,13
1990,Chase,KS,20017,12,8,0,0,4,1,0,0,0,1,11,8,0,3
1990,Chautauqua,KS,20019,15,13,1,0,1,2,0,1,0,1,13,13,0,0
1990,Cherokee,KS,20021,51,49,0,0,2,5,5,0,0,0,46,44,0,2
1990,Cheyenne,KS,20023,9,7,1,0,1,2,1,1,0,0,7,6,0,1
1990,Clark,KS,20025,4,2,1,0,1,2,0,1,0,1,2,2,0,0
1990,Clay,KS,20027,26,19,0,0,7,2,2,0,0,0,24,17,0,7
1990,Cloud,KS,20029,14,10,1,0,3,6,4,1,0,1,8,6,0,2
1990,Coffey,KS,20031,20,15,1,0,4,1,0,1,0,0,19,15,0,4
1990,Comanche,KS,20033,5,5,0,0,0,1,1,0,0,0,4,4,0,0
1990,Cowley,KS,20035,129,127,1,0,1,7,6,1,0,0,122,121,0,1
1990,Crawford,KS,20037,57,53,0,0,4,6,4,0,0,2,51,49,0,2
1990,Decatur,KS,20039,10,8,0,0,2,1,1,0,0,0,9,7,0,2
1990,Dickinson,KS,20041,67,56,2,2,7,8,3,2,2,1,59,53,0,6
1990,Doniphan,KS,20043,29,23,0,0,6,0,0,0,0,0,29,23,0,6
1990,Douglas,KS,20045,213,116,3,0,94,7,3,3,0,1,206,113,0,93
1990,Edwards,KS,20047,12,12,0,0,0,4,4,0,0,0,8,8,0,0
1990,Elk,KS,20049,11,11,0,0,0,0,0,0,0,0,11,11,0,0
1990,Ellis,KS,20051,47,46,0,0,1,3,3,0,0,0,44,43,0,1
1990,Ellsworth,KS,20053,5,5,0,0,0,0,0,0,0,0,5,5,0,0
1990,Finney,KS,20055,95,89,1,0,5,8,7,1,0,0,87,82,0,5
1990,Ford,KS,20057,87,77,1,2,7,4,1,1,2,0,83,76,0,7
1990,Franklin,KS,20059,72,53,1,0,18,7,4,1,0,2,65,49,0,16
1990,Geary,KS,20061,250,197,1,0,52,4,3,1,0,0,246,194,0,52
1990,Gove,KS,20063,6,5,1,0,0,2,1,1,0,0,4,4,0,0
1990,Graham,KS,20065,6,5,0,0,1,0,0,0,0,0,6,5,0,1
1990,Grant,KS,20067,25,24,0,0,1,1,1,0,0,0,24,23,0,1
1990,Gray,KS,20069,15,12,1,0,2,3,0,1,0,2,12,12,0,0
1990,Greeley,KS,20071,4,3,0,1,0,2,1,0,1,0,2,2,0,0
1990,Greenwood,KS,20073,23,18,1,0,4,1,0,1,0,0,22,18,0,4
1990,Hamilton,KS,20075,5,5,0,0,0,0,0,0,0,0,5,5,0,0
1990,Harper,KS,20077,29,26,0,0,3,2,2,0,0,0,27,24,0,3
1990,Harvey,KS,20079,94,82,1,0,11,7,5,1,0,1,87,77,0,10
1990,Haskell,KS,20081,12,12,0,0,0,2,2,0,0,0,10,10,0,0
1990,Hodgeman,KS,20083,8,6,1,1,0,3,1,1,1,0,5,5,0,0
1990,Jackson,KS,20085,44,23,1,1,19,4,2,1,1,0,40,21,0,19
1990,Jefferson,KS,20087,60,30,0,1,29,3,2,0,1,0,57,28,0,29
1990,Jewell,KS,20089,9,7,1,0,1,1,0,1,0,0,8,7,0,1
1990,Johnson,KS,20091,1152,972,20,1,159,100,74,20,1,5,1052,898,0,154
1990,Kearny,KS,20093,4,3,0,0,1,0,0,0,0,0,4,3,0,1
1990,Kingman,KS,20095,15,14,0,0,1,1,1,0,0,0,14,13,0,1
1990,Kiowa,KS,20097,5,4,0,0,1,0,0,0,0,0,5,4,0,1
1990,Labette,KS,20099,71,69,2,0,0,5,3,2,0,0,66,66,0,0
1990,Lane,KS,20101,3,2,0,1,0,2,1,0,1,0,1,1,0,0
1990,Leavenworth,KS,20103,197,162,2,0,33,11,7,2,0,2,186,155,0,31
1990,Lincoln,KS,20105,5,4,1,0,0,2,1,1,0,0,3,3,0,0
1990,Linn,KS,20107,21,19,0,0,2,2,0,0,0,2,19,19,0,0
1990,Logan,KS,20109,3,2,0,0,1,0,0,0,0,0,3,2,0,1
1990,Lyon,KS,20111,143,87,18,0,38,20,2,18,0,0,123,85,0,38
1990,McPherson,KS,20113,64,62,2,0,0,5,3,2,0,0,59,59,0,0
1990,Marion,KS,20115,21,18,0,0,3,1,1,0,0,0,20,17,0,3
1990,Marshall,KS,20117,28,19,1,2,6,4,1,1,2,0,24,18,0,6
1990,Meade,KS,20119,10,8,0,1,1,1,0,0,1,0,9,8,0,1
1990,Miami,KS,20121,61,55,1,0,5,5,4,1,0,0,56,51,0,5
1990,Mitchell,KS,20123,6,6,0,0,0,2,2,0,0,0,4,4,0,0
1990,Montgomery,KS,20125,148,144,2,0,2,8,6,2,0,0,140,138,0,2
1990,Morris,KS,20127,20,14,0,0,6,1,1,0,0,0,19,13,0,6
1990,Morton,KS,20129,6,5,0,1,0,1,0,0,1,0,5,5,0,0
1990,Nemaha,KS,20131,14,10,0,0,4,0,0,0,0,0,14,10,0,4
1990,Neosho,KS,20133,38,37,0,0,1,4,4,0,0,0,34,33,0,1
1990,Ness,KS,20135,5,4,0,0,1,1,1,0,0,0,4,3,0,1
1990,Norton,KS,20137,8,8,0,0,0,0,0,0,0,0,8,8,0,0
1990,Osage,KS,20139,73,35,0,0,38,2,2,0,0,0,71,33,0,38
1990,Osborne,KS,20141,10,8,0,1,1,2,1,0,1,0,8,7,0,1
1990,Ottawa,KS,20143,16,14,0,0,2,0,0,0,0,0,16,14,0,2
1990,Pawnee,KS,20145,17,15,0,1,1,2,1,0,1,0,15,14,0,1
1990,Phillips,KS,20147,9,7,0,0,2,1,1,0,0,0,8,6,0,2
1990,Pottawatomie,KS,20149,85,68,0,0,17,1,0,0,0,1,84,68,0,16
1990,Pratt,KS,20151,20,17,0,0,3,2,2,0,0,0,18,15,0,3
1990,Rawlins,KS,20153,5,4,0,1,0,2,1,0,1,0,3,3,0,0
1990,Reno,KS,20155,224,204,7,0,13,21,12,7,0,2,203,192,0,11
1990,Republic,KS,20157,7,5,0,0,2,0,0,0,0,0,7,5,0,2
1990,Rice,KS,20159,21,21,0,0,0,4,4,0,0,0,17,17,0,0
1990,Riley,KS,20161,57,46,0,0,11,5,4,0,0,1,52,42,0,10
1990,Rooks,KS,20163,15,11,0,1,3,1,0,0,1,0,14,11,0,3
1990,Rush,KS,20165,6,4,0,1,1,1,0,0,1,0,5,4,0,1
1990,Russell,KS,20167,39,31,1,2,5,11,7,1,2,1,28,24,0,4
1990,Saline,KS,20169,165,149,0,0,16,5,4,0,0,1,160,145,0,15
1990,Scott,KS,20171,6,4,0,2,0,3,1,0,2,0,3,3,0,0
1990,Sedgwick,KS,20173,2006,1842,26,0,138,97,63,26,0,8,1909,1779,0,130
1990,Seward,KS,20175,50,40,2,1,7,4,1,2,1,0,46,39,0,7
1990,Shawnee,KS,20177,957,429,10,0,518,34,20,9,0,5,923,409,1,513
1990,Sheridan,KS,20179,3,3,0,0,0,0,0,0,0,0,3,3,0,0
1990,Sherman,KS,20181,9,7,1,1,0,4,2,1,1,0,5,5,0,0
1990,Smith,KS,20183,6,6,0,0,0,0,0,0,0,0,6,6,0,0
1990,Stafford,KS,20185,15,13,2,0,0,4,2,2,0,0,11,11,0,0
1990,Stanton,KS,20187,5,3,1,0,1,1,0,1,0,0,4,3,0,1
1990,Stevens,KS,20189,10,8,0,0,2,1,1,0,0,0,9,7,0,2
1990,Sumner,KS,20191,89,82,0,0,7,4,4,0,0,0,85,78,0,7
1990,Thomas,KS,20193,21,16,2,1,2,3,2,0,1,0,18,14,2,2
1990,Trego,KS,20195,9,9,0,0,0,1,1,0,0,0,8,8,0,0
1990,Wabaunsee,KS,20197,20,17,0,0,3,1,1,0,0,0,19,16,0,3
1990,Wallace,KS,20199,3,1,2,0,0,2,0,2,0,0,1,1,0,0
1990,Washington,KS,20201,12,8,0,2,2,3,1,0,2,0,9,7,0,2
1990,Wichita,KS,20203,4,4,0,0,0,1,1,0,0,0,3,3,0,0
1990,Wilson,KS,20205,28,28,0,0,0,3,3,0,0,0,25,25,0,0
1990,Woodson,KS,20207,11,9,0,1,1,1,0,0,1,0,10,9,0,1
1990,Wyandotte,KS,20209,767,570,9,0,188,23,13,9,0,1,744,557,0,187
1990,Adair,KY,21001,42,37,1,0,4,2,1,1,0,0,40,36,0,4
1990,Allen,KY,21003,54,49,0,0,5,3,3,0,0,0,51,46,0,5
1990,Anderson,KY,21005,57,36,0,0,21,4,4,0,0,0,53,32,0,21
1990,Ballard,KY,21007,26,23,0,1,2,7,6,0,1,0,19,17,0,2
1990,Barren,KY,21009,111,106,2,1,2,4,1,2,1,0,107,105,0,2
1990,Bath,KY,21011,19,14,0,0,5,3,2,0,0,1,16,12,0,4
1990,Bell,KY,21013,76,75,0,0,1,13,12,0,0,1,63,63,0,0
1990,Boone,KY,21015,328,277,2,0,49,28,25,2,0,1,300,252,0,48
1990,Bourbon,KY,21017,84,63,3,1,17,13,4,3,1,5,71,59,0,12
1990,Boyd,KY,21019,178,106,4,0,68,24,15,4,0,5,154,91,0,63
1990,Boyle,KY,21021,67,47,1,0,19,8,6,1,0,1,59,41,0,18
1990,Bracken,KY,21023,28,26,0,0,2,4,4,0,0,0,24,22,0,2
1990,Breathitt,KY,21025,38,29,0,0,9,5,5,0,0,0,33,24,0,9
1990,Breckinridge,KY,21027,23,18,0,0,5,2,2,0,0,0,21,16,0,5
1990,Bullitt,KY,21029,157,116,2,0,39,6,4,2,0,0,151,112,0,39
1990,Butler,KY,21031,33,30,0,0,3,1,1,0,0,0,32,29,0,3
1990,Caldwell,KY,21033,55,51,0,0,4,4,4,0,0,0,51,47,0,4
1990,Calloway,KY,21035,52,47,1,1,3,7,4,1,1,1,45,43,0,2
1990,Campbell,KY,21037,394,328,0,0,66,26,21,0,0,5,368,307,0,61
1990,Carlisle,KY,21039,9,9,0,0,0,1,1,0,0,0,8,8,0,0
1990,Carroll,KY,21041,33,28,0,0,5,3,3,0,0,0,30,25,0,5
1990,Carter,KY,21043,28,20,1,0,7,5,4,1,0,0,23,16,0,7
1990,Casey,KY,21045,25,19,0,2,4,5,2,0,2,1,20,17,0,3
1990,Christian,KY,21047,357,210,1,1,145,12,10,1,1,0,345,200,0,145
1990,Clark,KY,21049,193,160,2,0,31,20,14,2,0,4,173,146,0,27
1990,Clay,KY,21051,40,36,0,0,4,8,7,0,0,1,32,29,0,3
1990,Clinton,KY,21053,20,20,0,0,0,1,1,0,0,0,19,19,0,0
1990,Crittenden,KY,21055,17,17,0,0,0,0,0,0,0,0,17,17,0,0
1990,Cumberland,KY,21057,17,16,1,0,0,4,3,1,0,0,13,13,0,0
1990,Daviess,KY,21059,379,333,4,0,42,27,23,4,0,0,352,310,0,42
1990,Edmonson,KY,21061,23,23,0,0,0,3,3,0,0,0,20,20,0,0
1990,Elliott,KY,21063,6,5,0,0,1,1,0,0,0,1,5,5,0,0
1990,Estill,KY,21065,22,18,0,0,4,1,1,0,0,0,21,17,0,4
1990,Fayette,KY,21067,1196,869,14,2,311,118,87,14,2,15,1078,782,0,296
1990,Fleming,KY,21069,22,17,0,0,5,3,2,0,0,1,19,15,0,4
1990,Floyd,KY,21071,164,108,2,0,54,38,25,2,0,11,126,83,0,43
1990,Franklin,KY,21073,282,200,0,0,82,10,10,0,0,0,272,190,0,82
1990,Fulton,KY,21075,35,29,0,1,5,2,1,0,1,0,33,28,0,5
1990,Gallatin,KY,21077,27,24,0,0,3,0,0,0,0,0,27,24,0,3
1990,Garrard,KY,21079,40,32,1,0,7,8,7,1,0,0,32,25,0,7
1990,Grant,KY,21081,112,95,0,0,17,7,6,0,0,1,105,89,0,16
1990,Graves,KY,21083,70,61,0,0,9,1,0,0,0,1,69,61,0,8
1990,Grayson,KY,21085,40,38,0,0,2,1,1,0,0,0,39,37,0,2
1990,Green,KY,21087,32,30,0,0,2,5,5,0,0,0,27,25,0,2
1990,Greenup,KY,21089,101,69,0,0,32,13,10,0,0,3,88,59,0,29
1990,Hancock,KY,21091,21,17,0,0,4,2,1,0,0,1,19,16,0,3
1990,Hardin,KY,21093,607,460,4,0,143,27,22,3,0,2,580,438,1,141
1990,Harlan,KY,21095,89,79,3,0,7,7,4,3,0,0,82,75,0,7
1990,Harrison,KY,21097,74,56,0,0,18,9,6,0,0,3,65,50,0,15
1990,Hart,KY,21099,33,33,0,0,0,1,1,0,0,0,32,32,0,0
1990,Henderson,KY,21101,247,230,7,0,10,27,20,7,0,0,220,210,0,10
1990,Henry,KY,21103,53,44,0,0,9,5,5,0,0,0,48,39,0,9
1990,Hickman,KY,21105,15,15,0,0,0,1,1,0,0,0,14,14,0,0
1990,Hopkins,KY,21107,230,217,2,0,11,8,6,2,0,0,222,211,0,11
1990,Jackson,KY,21109,20,13,1,0,6,5,2,1,0,2,15,11,0,4
1990,Jefferson,KY,21111,3290,2213,62,1,1014,203,130,60,1,12,3087,2083,2,1002
1990,Jessamine,KY,21113,172,124,0,0,48,18,14,0,0,4,154,110,0,44
1990,Johnson,KY,21115,98,71,1,0,26,10,3,1,0,6,88,68,0,20
1990,Kenton,KY,21117,712,607,3,0,102,52,43,3,0,6,660,564,0,96
1990,Knott,KY,21119,33,24,0,0,9,9,9,0,0,0,24,15,0,9
1990,Knox,KY,21121,48,44,0,0,4,5,4,0,0,1,43,40,0,3
1990,Larue,KY,21123,45,38,1,0,6,5,4,1,0,0,40,34,0,6
1990,Laurel,KY,21125,147,138,2,0,7,23,18,2,0,3,124,120,0,4
1990,Lawrence,KY,21127,28,23,0,0,5,5,5,0,0,0,23,18,0,5
1990,Lee,KY,21129,8,7,0,0,1,3,3,0,0,0,5,4,0,1
1990,Leslie,KY,21131,14,9,0,0,5,3,2,0,0,1,11,7,0,4
1990,Letcher,KY,21133,58,44,0,0,14,7,5,0,0,2,51,39,0,12
1990,Lewis,KY,21135,30,23,0,2,5,4,2,0,2,0,26,21,0,5
1990,Lincoln,KY,21137,58,44,0,0,14,9,5,0,0,4,49,39,0,10
1990,Livingston,KY,21139,30,24,0,1,5,2,1,0,1,0,28,23,0,5
1990,Logan,KY,21141,133,127,2,0,4,4,2,2,0,0,129,125,0,4
1990,Lyon,KY,21143,24,21,0,0,3,4,3,0,0,1,20,18,0,2
1990,McCracken,KY,21145,191,145,4,0,42,15,10,4,0,1,176,135,0,41
1990,McCreary,KY,21147,27,27,0,0,0,6,6,0,0,0,21,21,0,0
1990,McLean,KY,21149,33,30,0,1,2,3,1,0,1,1,30,29,0,1
1990,Madison,KY,21151,167,140,1,0,26,23,20,1,0,2,144,120,0,24
1990,Magoffin,KY,21153,34,28,2,0,4,6,4,2,0,0,28,24,0,4
1990,Marion,KY,21155,29,25,0,0,4,0,0,0,0,0,29,25,0,4
1990,Marshall,KY,21157,90,78,4,0,8,10,6,4,0,0,80,72,0,8
1990,Martin,KY,21159,30,22,0,0,8,4,3,0,0,1,26,19,0,7
1990,Mason,KY,21161,52,47,0,0,5,8,7,0,0,1,44,40,0,4
1990,Meade,KY,21163,55,44,1,0,10,3,2,1,0,0,52,42,0,10
1990,Menifee,KY,21165,22,17,0,0,5,4,3,0,0,1,18,14,0,4
1990,Mercer,KY,21167,81,65,2,0,14,7,4,2,0,1,74,61,0,13
1990,Metcalfe,KY,21169,24,21,0,1,2,2,1,0,1,0,22,20,0,2
1990,Monroe,KY,21171,37,35,0,0,2,1,1,0,0,0,36,34,0,2
1990,Montgomery,KY,21173,98,85,0,0,13,16,14,0,0,2,82,71,0,11
1990,Morgan,KY,21175,29,22,0,0,7,5,4,0,0,1,24,18,0,6
1990,Muhlenberg,KY,21177,130,121,1,1,7,9,7,1,1,0,121,114,0,7
1990,Nelson,KY,21179,65,55,2,0,8,4,2,2,0,0,61,53,0,8
1990,Nicholas,KY,21181,33,26,0,0,7,6,4,0,0,2,27,22,0,5
1990,Ohio,KY,21183,78,74,0,1,3,7,5,0,1,1,71,69,0,2
1990,Oldham,KY,21185,90,67,1,0,22,8,6,1,0,1,82,61,0,21
1990,Owen,KY,21187,27,20,1,0,6,5,3,1,0,1,22,17,0,5
1990,Owsley,KY,21189,6,6,0,0,0,3,3,0,0,0,3,3,0,0
1990,Pendleton,KY,21191,43,37,0,1,5,4,2,0,1,1,39,35,0,4
1990,Perry,KY,21193,131,83,1,0,47,22,16,1,0,5,109,67,0,42
1990,Pike,KY,21195,198,167,3,0,28,42,32,3,0,7,156,135,0,21
1990,Powell,KY,21197,67,48,0,0,19,3,3,0,0,0,64,45,0,19
1990,Pulaski,KY,21199,102,83,1,0,18,23,19,1,0,3,79,64,0,15
1990,Robertson,KY,21201,4,4,0,0,0,1,1,0,0,0,3,3,0,0
1990,Rockcastle,KY,21203,37,31,1,0,5,7,6,1,0,0,30,25,0,5
1990,Rowan,KY,21205,64,41,1,0,22,10,6,1,0,3,54,35,0,19
1990,Russell,KY,21207,35,33,0,0,2,0,0,0,0,0,35,33,0,2
1990,Scott,KY,21209,106,74,1,0,31,10,6,1,0,3,96,68,0,28
1990,Shelby,KY,21211,92,68,1,0,23,9,6,1,0,2,83,62,0,21
1990,Simpson,KY,21213,68,63,1,0,4,8,7,1,0,0,60,56,0,4
1990,Spencer,KY,21215,19,17,0,0,2,2,2,0,0,0,17,15,0,2
1990,Taylor,KY,21217,55,48,0,1,6,1,0,0,1,0,54,48,0,6
1990,Todd,KY,21219,25,20,0,1,4,3,1,0,1,1,22,19,0,3
1990,Trigg,KY,21221,32,25,1,0,6,2,1,1,0,0,30,24,0,6
1990,Trimble,KY,21223,25,24,0,0,1,5,5,0,0,0,20,19,0,1
1990,Union,KY,21225,62,60,1,0,1,5,4,1,0,0,57,56,0,1
1990,Warren,KY,21227,406,372,7,0,27,26,17,6,0,3,380,355,1,24
1990,Washington,KY,21229,17,15,0,0,2,3,3,0,0,0,14,12,0,2
1990,Wayne,KY,21231,41,40,0,0,1,11,10,0,0,1,30,30,0,0
1990,Webster,KY,21233,46,45,0,0,1,0,0,0,0,0,46,45,0,1
1990,Whitley,KY,21235,130,121,3,0,6,34,28,3,0,3,96,93,0,3
1990,Wolfe,KY,21237,14,11,0,0,3,1,1,0,0,0,13,10,0,3
1990,Woodford,KY,21239,101,73,1,0,27,13,11,1,0,1,88,62,0,26
1990,Acadia,LA,22001,94,83,1,3,7,13,9,1,3,0,81,74,0,7
1990,Allen,LA,22003,50,39,1,3,7,10,4,1,3,2,40,35,0,5
1990,Ascension,LA,22005,117,94,3,0,20,6,3,3,0,0,111,91,0,20
1990,Assumption,LA,22007,15,12,0,0,3,1,1,0,0,0,14,11,0,3
1990,Avoyelles,LA,22009,65,49,2,0,14,11,7,2,0,2,54,42,0,12
1990,Beauregard,LA,22011,63,54,0,0,9,6,6,0,0,0,57,48,0,9
1990,Bienville,LA,22013,71,26,0,0,45,6,6,0,0,0,65,20,0,45
1990,Bossier,LA,22015,425,256,4,1,164,42,28,4,1,9,383,228,0,155
1990,Caddo,LA,22017,1108,581,24,1,502,137,87,24,1,25,971,494,0,477
1990,Calcasieu,LA,22019,545,443,15,4,83,82,57,15,4,6,463,386,0,77
1990,Caldwell,LA,22021,51,33,2,1,15,10,5,2,1,2,41,28,0,13
1990,Cameron,LA,22023,27,19,0,0,8,3,2,0,0,1,24,17,0,7
1990,Catahoula,LA,22025,23,15,0,2,6,11,6,0,2,3,12,9,0,3
1990,Claiborne,LA,22027,47,15,0,0,32,3,2,0,0,1,44,13,0,31
1990,Concordia,LA,22029,35,27,1,5,2,17,9,1,5,2,18,18,0,0
1990,De Soto,LA,22031,66,38,0,1,27,10,6,0,1,3,56,32,0,24
1990,East Baton Rouge,LA,22033,1110,819,29,0,262,84,51,28,0,5,1026,768,1,257
1990,East Carroll,LA,22035,15,10,0,3,2,7,4,0,3,0,8,6,0,2
1990,East Feliciana,LA,22037,61,40,1,0,20,5,3,1,0,1,56,37,0,19
1990,Evangeline,LA,22039,43,42,0,0,1,8,8,0,0,0,35,34,0,1
1990,Franklin,LA,22041,56,43,1,5,7,11,4,1,5,1,45,39,0,6
1990,Grant,LA,22043,51,33,5,1,12,14,6,5,1,2,37,27,0,10
1990,Iberia,LA,22045,141,107,1,0,33,22,19,1,0,2,119,88,0,31
1990,Iberville,LA,22047,49,33,1,2,13,4,1,1,2,0,45,32,0,13
1990,Jackson,LA,22049,124,35,2,0,87,16,5,2,0,9,108,30,0,78
1990,Jefferson,LA,22051,1569,1200,77,0,292,100,32,68,0,0,1469,1168,9,292
1990,Jefferson Davis,LA,22053,73,56,0,2,15,18,15,0,2,1,55,41,0,14
1990,Lafayette,LA,22055,445,382,18,1,44,97,73,18,1,5,348,309,0,39
1990,Lafourche,LA,22057,112,94,2,0,16,3,1,2,0,0,109,93,0,16
1990,La Salle,LA,22059,46,39,1,0,6,5,3,1,0,1,41,36,0,5
1990,Lincoln,LA,22061,213,93,2,0,118,21,10,2,0,9,192,83,0,109
1990,Livingston,LA,22063,170,126,2,0,42,8,7,1,0,0,162,119,1,42
1990,Madison,LA,22065,24,11,0,1,12,3,2,0,1,0,21,9,0,12
1990,Morehouse,LA,22067,129,87,2,1,39,15,9,2,1,3,114,78,0,36
1990,Natchitoches,LA,22069,96,74,9,4,9,27,12,9,4,2,69,62,0,7
1990,Orleans,LA,22071,1767,1189,60,0,518,81,33,47,0,1,1686,1156,13,517
1990,Ouachita,LA,22073,748,514,17,0,217,103,70,17,0,16,645,444,0,201
1990,Plaquemines,LA,22075,62,53,5,0,4,5,0,5,0,0,57,53,0,4
1990,Pointe Coupee,LA,22077,27,20,3,1,3,4,2,1,1,0,23,18,2,3
1990,Rapides,LA,22079,391,272,22,1,96,80,44,22,1,13,311,228,0,83
1990,Red River,LA,22081,21,13,1,0,7,2,1,1,0,0,19,12,0,7
1990,Richland,LA,22083,60,28,4,7,21,17,5,3,7,2,43,23,1,19
1990,Sabine,LA,22085,40,32,0,0,8,5,3,0,0,2,35,29,0,6
1990,St. Bernard,LA,22087,202,186,3,0,13,6,4,2,0,0,196,182,1,13
1990,St. Charles,LA,22089,92,70,2,0,20,4,3,1,0,0,88,67,1,20
1990,St. Helena,LA,22091,9,1,0,1,7,1,0,0,1,0,8,1,0,7
1990,St. James,LA,22093,33,27,0,0,6,0,0,0,0,0,33,27,0,6
1990,St. John the Baptist,LA,22095,113,82,2,0,29,1,0,1,0,0,112,82,1,29
1990,St. Landry,LA,22097,143,120,3,4,16,27,20,3,4,0,116,100,0,16
1990,St. Martin,LA,22099,83,68,0,0,15,14,12,0,0,2,69,56,0,13
1990,St. Mary,LA,22101,88,70,1,0,17,13,12,1,0,0,75,58,0,17
1990,St. Tammany,LA,22103,501,429,13,0,59,23,11,12,0,0,478,418,1,59
1990,Tangipahoa,LA,22105,314,205,3,0,106,6,4,2,0,0,308,201,1,106
1990,Tensas,LA,22107,23,10,1,10,2,16,5,1,10,0,7,5,0,2
1990,Terrebonne,LA,22109,207,160,13,0,34,13,1,12,0,0,194,159,1,34
1990,Union,LA,22111,77,41,1,2,33,12,5,1,2,4,65,36,0,29
1990,Vermilion,LA,22113,75,63,1,1,10,12,8,1,1,2,63,55,0,8
1990,Vernon,LA,22115,128,111,1,0,16,10,7,1,0,2,118,104,0,14
1990,Washington,LA,22117,77,64,1,0,12,1,1,0,0,0,76,63,1,12
1990,Webster,LA,22119,171,116,4,0,51,23,17,4,0,2,148,99,0,49
1990,West Baton Rouge,LA,22121,52,36,1,0,15,4,3,1,0,0,48,33,0,15
1990,West Carroll,LA,22123,28,18,1,2,7,8,3,1,2,2,20,15,0,5
1990,West Feliciana,LA,22125,25,17,2,0,6,1,0,1,0,0,24,17,1,6
1990,Winn,LA,22127,48,22,1,0,25,5,1,1,0,3,43,21,0,22
1990,Androscoggin,ME,23001,1,1,0,0,0,0,0,0,0,0,1,1,0,0
1990,Cumberland,ME,23005,3,1,0,0,2,0,0,0,0,0,3,1,0,2
1990,Franklin,ME,23007,1,1,0,0,0,0,0,0,0,0,1,1,0,0
1990,Kennebec,ME,23011,2,2,0,0,0,0,0,0,0,0,2,2,0,0
1990,Oxford,ME,23017,1,1,0,0,0,0,0,0,0,0,1,1,0,0
1990,Penobscot,ME,23019,177,165,4,0,8,23,19,4,0,0,154,146,0,8
1990,Piscataquis,ME,23021,33,33,0,0,0,9,9,0,0,0,24,24,0,0
1990,Sagadahoc,ME,23023,49,38,2,0,9,7,5,2,0,0,42,33,0,9
1990,Somerset,ME,23025,50,44,0,0,6,5,5,0,0,0,45,39,0,6
1990,Waldo,ME,23027,26,24,0,0,2,5,4,0,0,1,21,20,0,1
1990,Washington,ME,23029,29,26,1,0,2,3,2,1,0,0,26,24,0,2
1990,York,ME,23031,343,177,11,0,155,64,34,11,0,19,279,143,0,136
1990,Allegany,MD,24001,52,49,1,0,2,9,8,1,0,0,43,41,0,2
1990,Anne Arundel,MD,24003,931,671,42,0,218,111,63,41,0,7,820,608,1,211
1990,Baltimore,MD,24005,1765,1180,69,0,516,176,93,68,0,15,1589,1087,1,501
1990,Calvert,MD,24009,79,41,2,0,36,13,6,2,0,5,66,35,0,31
1990,Caroline,MD,24011,44,41,0,0,3,4,4,0,0,0,40,37,0,3
1990,Carroll,MD,24013,171,131,4,0,36,17,12,4,0,1,154,119,0,35
1990,Cecil,MD,24015,104,81,6,0,17,13,6,6,0,1,91,75,0,16
1990,Charles,MD,24017,225,159,4,0,62,35,26,4,0,5,190,133,0,57
1990,Dorchester,MD,24019,38,34,1,0,3,6,4,1,0,1,32,30,0,2
1990,Frederick,MD,24021,277,204,25,0,48,64,34,25,0,5,213,170,0,43
1990,Garrett,MD,24023,31,25,1,1,4,9,6,1,1,1,22,19,0,3
1990,Harford,MD,24025,359,253,20,0,86,46,20,20,0,6,313,233,0,80
1990,Howard,MD,24027,316,231,18,0,67,46,26,18,0,2,270,205,0,65
1990,Kent,MD,24029,12,10,0,0,2,2,2,0,0,0,10,8,0,2
1990,Montgomery,MD,24031,1297,913,112,0,272,306,175,110,0,21,991,738,2,251
1990,Prince George's,MD,24033,2173,1007,77,0,1089,259,110,76,0,73,1914,897,1,1016
1990,Queen Anne's,MD,24035,53,40,2,0,11,12,8,2,0,2,41,32,0,9
1990,St. Mary's,MD,24037,122,90,5,0,27,22,13,5,0,4,100,77,0,23
1990,Somerset,MD,24039,37,35,0,0,2,6,5,0,0,1,31,30,0,1
1990,Talbot,MD,24041,48,41,0,4,3,20,16,0,4,0,28,25,0,3
1990,Washington,MD,24043,255,236,5,0,14,28,23,4,0,1,227,213,1,13
1990,Wicomico,MD,24045,189,179,3,0,7,29,24,3,0,2,160,155,0,5
1990,Worcester,MD,24047,88,80,2,0,6,13,11,2,0,0,75,69,0,6
1990,Baltimore city,MD,24510,1546,876,51,0,619,96,36,51,0,9,1450,840,0,610
1990,Barnstable,MA,25001,574,375,106,1,92,180,74,95,1,10,394,301,11,82
1990,Berkshire,MA,25003,159,134,11,0,14,31,17,10,0,4,128,117,1,10
1990,Bristol,MA,25005,932,737,72,0,123,145,68,68,0,9,787,669,4,114
1990,Dukes,MA,25007,24,19,0,0,5,3,3,0,0,0,21,16,0,5
1990,Essex,MA,25009,1195,913,89,0,193,211,110,82,0,19,984,803,7,174
1990,Franklin,MA,25011,79,65,2,0,12,6,2,2,0,2,73,63,0,10
1990,Hampden,MA,25013,706,584,45,0,77,77,41,34,0,2,629,543,11,75
1990,Hampshire,MA,25015,151,110,17,1,23,26,7,15,1,3,125,103,2,20
1990,Middlesex,MA,25017,2042,1579,219,0,244,416,202,201,0,13,1626,1377,18,231
1990,Nantucket,MA,25019,9,5,3,0,1,7,3,3,0,1,2,2,0,0
1990,Norfolk,MA,25021,875,625,91,0,159,175,92,78,0,5,700,533,13,154
1990,Plymouth,MA,25023,947,622,66,0,259,156,89,57,0,10,791,533,9,249
1990,Suffolk,MA,25025,1193,810,134,0,249,233,98,122,0,13,960,712,12,236
1990,Worcester,MA,25027,1272,1039,103,0,130,184,84,94,0,6,1088,955,9,124
1990,Alcona,MI,26001,13,12,0,0,1,1,1,0,0,0,12,11,0,1
1990,Alger,MI,26003,14,13,0,1,0,1,0,0,1,0,13,13,0,0
1990,Allegan,MI,26005,197,135,7,3,52,26,11,7,3,5,171,124,0,47
1990,Alpena,MI,26007,22,19,1,0,2,2,1,1,0,0,20,18,0,2
1990,Antrim,MI,26009,31,23,1,0,7,6,4,1,0,1,25,19,0,6
1990,Arenac,MI,26011,11,10,1,0,0,3,2,1,0,0,8,8,0,0
1990,Baraga,MI,26013,6,5,1,0,0,1,0,1,0,0,5,5,0,0
1990,Barry,MI,26015,90,53,2,0,35,9,4,2,0,3,81,49,0,32
1990,Bay,MI,26017,151,122,8,0,21,17,9,6,0,2,134,113,2,19
1990,Benzie,MI,26019,21,16,1,0,4,1,0,1,0,0,20,16,0,4
1990,Berrien,MI,26021,430,294,15,1,120,39,17,12,1,9,391,277,3,111
1990,Branch,MI,26023,103,83,4,0,16,12,8,4,0,0,91,75,0,16
1990,Calhoun,MI,26025,405,240,1,0,164,33,18,1,0,14,372,222,0,150
1990,Cass,MI,26027,125,92,3,0,30,12,8,3,0,1,113,84,0,29
1990,Charlevoix,MI,26029,45,32,5,0,8,10,4,5,0,1,35,28,0,7
1990,Cheboygan,MI,26031,28,25,1,0,2,4,3,1,0,0,24,22,0,2
1990,Chippewa,MI,26033,34,34,0,0,0,4,4,0,0,0,30,30,0,0
1990,Clare,MI,26035,37,28,1,0,8,2,1,1,0,0,35,27,0,8
1990,Clinton,MI,26037,78,55,5,0,18,17,8,4,0,5,61,47,1,13
1990,Crawford,MI,26039,12,9,1,0,2,2,0,1,0,1,10,9,0,1
1990,Delta,MI,26041,54,47,3,0,4,10,6,3,0,1,44,41,0,3
1990,Dickinson,MI,26043,35,32,0,0,3,4,3,0,0,1,31,29,0,2
1990,Eaton,MI,26045,163,107,5,0,51,20,14,4,0,2,143,93,1,49
1990,Emmet,MI,26047,31,29,1,0,1,6,4,1,0,1,25,25,0,0
1990,Genesee,MI,26049,1119,596,20,0,503,60,31,19,0,10,1059,565,1,493
1990,Gladwin,MI,26051,26,18,1,0,7,3,2,1,0,0,23,16,0,7
1990,Gogebic,MI,26053,26,18,1,1,6,3,1,1,1,0,23,17,0,6
1990,Grand Traverse,MI,26055,201,142,15,0,44,44,25,12,0,7,157,117,3,37
1990,Gratiot,MI,26057,86,78,0,1,7,10,8,0,1,1,76,70,0,6
1990,Hillsdale,MI,26059,91,78,1,1,11,16,13,1,1,1,75,65,0,10
1990,Houghton,MI,26061,25,24,0,0,1,0,0,0,0,0,25,24,0,1
1990,Huron,MI,26063,43,32,1,6,4,11,4,1,6,0,32,28,0,4
1990,Ingham,MI,26065,719,532,12,4,171,80,54,12,4,10,639,478,0,161
1990,Ionia,MI,26067,128,81,0,0,47,18,12,0,0,6,110,69,0,41
1990,Iosco,MI,26069,40,34,1,0,5,5,4,1,0,0,35,30,0,5
1990,Iron,MI,26071,15,15,0,0,0,1,1,0,0,0,14,14,0,0
1990,Isabella,MI,26073,64,60,0,1,3,8,7,0,1,0,56,53,0,3
1990,Jackson,MI,26075,427,410,1,0,16,21,20,1,0,0,406,390,0,16
1990,Kalamazoo,MI,26077,499,401,11,0,87,56,35,11,0,10,443,366,0,77
1990,Kalkaska,MI,26079,26,19,2,0,5,4,1,2,0,1,22,18,0,4
1990,Kent,MI,26081,1144,747,39,1,357,158,91,37,1,29,986,656,2,328
1990,Keweenaw,MI,26083,2,2,0,0,0,0,0,0,0,0,2,2,0,0
1990,Lake,MI,26085,13,11,1,0,1,2,1,1,0,0,11,10,0,1
1990,Lapeer,MI,26087,126,84,0,0,42,10,7,0,0,3,116,77,0,39
1990,Leelanau,MI,26089,19,15,0,0,4,5,2,0,0,3,14,13,0,1
1990,Lenawee,MI,26091,177,165,1,4,7,15,10,1,4,0,162,155,0,7
1990,Livingston,MI,26093,131,115,6,0,10,12,6,6,0,0,119,109,0,10
1990,Luce,MI,26095,10,9,0,0,1,2,2,0,0,0,8,7,0,1
1990,Mackinac,MI,26097,8,5,3,0,0,2,0,2,0,0,6,5,1,0
1990,Macomb,MI,26099,1518,1250,41,1,226,98,54,37,1,6,1420,1196,4,220
1990,Manistee,MI,26101,19,14,2,1,2,4,1,2,1,0,15,13,0,2
1990,Marquette,MI,26103,92,88,1,0,3,6,5,1,0,0,86,83,0,3
1990,Mason,MI,26105,20,15,0,1,4,7,3,0,1,3,13,12,0,1
1990,Mecosta,MI,26107,41,29,0,0,12,3,3,0,0,0,38,26,0,12
1990,Menominee,MI,26109,14,14,0,0,0,2,2,0,0,0,12,12,0,0
1990,Midland,MI,26111,81,62,2,0,17,6,3,2,0,1,75,59,0,16
1990,Missaukee,MI,26113,21,15,0,1,5,6,4,0,1,1,15,11,0,4
1990,Monroe,MI,26115,273,255,0,0,18,19,18,0,0,1,254,237,0,17
1990,Montcalm,MI,26117,142,78,4,1,59,16,6,4,1,5,126,72,0,54
1990,Montmorency,MI,26119,16,15,0,0,1,2,2,0,0,0,14,13,0,1
1990,Muskegon,MI,26121,362,154,4,0,204,54,32,4,0,18,308,122,0,186
1990,Newaygo,MI,26123,111,70,3,1,37,23,10,3,1,9,88,60,0,28
1990,Oakland,MI,26125,2420,1965,85,0,370,185,89,82,0,14,2235,1876,3,356
1990,Oceana,MI,26127,22,9,4,0,9,5,0,4,0,1,17,9,0,8
1990,Ogemaw,MI,26129,24,16,1,0,7,4,3,1,0,0,20,13,0,7
1990,Ontonagon,MI,26131,5,5,0,0,0,0,0,0,0,0,5,5,0,0
1990,Osceola,MI,26133,31,26,0,0,5,5,5,0,0,0,26,21,0,5
1990,Oscoda,MI,26135,16,13,1,0,2,5,2,1,0,2,11,11,0,0
1990,Otsego,MI,26137,22,18,1,0,3,1,0,1,0,0,21,18,0,3
1990,Ottawa,MI,26139,258,167,5,2,84,36,22,4,2,8,222,145,1,76
1990,Presque Isle,MI,26141,17,15,0,0,2,1,1,0,0,0,16,14,0,2
1990,Roscommon,MI,26143,24,22,0,0,2,3,2,0,0,1,21,20,0,1
1990,Saginaw,MI,26145,336,209,14,0,113,34,21,13,0,0,302,188,1,113
1990,St. Clair,MI,26147,271,242,6,1,22,13,4,6,1,2,258,238,0,20
1990,St. Joseph,MI,26149,168,138,2,0,28,15,10,2,0,3,153,128,0,25
1990,Sanilac,MI,26151,44,37,0,3,4,6,3,0,3,0,38,34,0,4
1990,Schoolcraft,MI,26153,13,13,0,0,0,3,3,0,0,0,10,10,0,0
1990,Shiawassee,MI,26155,148,109,4,0,35,13,6,4,0,3,135,103,0,32
1990,Tuscola,MI,26157,83,61,1,1,20,6,4,1,1,0,77,57,0,20
1990,Van Buren,MI,26159,163,123,0,0,40,18,14,0,0,4,145,109,0,36
1990,Washtenaw,MI,26161,490,421,8,0,61,35,22,8,0,5,455,399,0,56
1990,Wayne,MI,26163,6015,4414,95,3,1503,218,108,94,3,13,5797,4306,1,1490
1990,Wexford,MI,26165,46,37,0,1,8,6,5,0,1,0,40,32,0,8
1990,Aitkin,MN,27001,21,20,0,1,0,8,7,0,1,0,13,13,0,0
1990,Anoka,MN,27003,1381,987,8,0,386,81,54,8,0,19,1300,933,0,367
1990,Becker,MN,27005,51,41,1,2,7,14,10,1,2,1,37,31,0,6
1990,Beltrami,MN,27007,33,26,2,0,5,12,9,2,0,1,21,17,0,4
1990,Benton,MN,27009,65,54,1,0,10,11,8,1,0,2,54,46,0,8
1990,Big Stone,MN,27011,6,4,2,0,0,3,2,1,0,0,3,2,1,0
1990,Blue Earth,MN,27013,95,86,0,0,9,18,15,0,0,3,77,71,0,6
1990,Brown,MN,27015,33,29,0,0,4,5,5,0,0,0,28,24,0,4
1990,Carlton,MN,27017,62,57,0,1,4,6,4,0,1,1,56,53,0,3
1990,Carver,MN,27019,154,104,3,0,47,15,8,3,0,4,139,96,0,43
1990,Cass,MN,27021,26,23,0,1,2,4,3,0,1,0,22,20,0,2
1990,Chippewa,MN,27023,25,21,0,0,4,8,5,0,0,3,17,16,0,1
1990,Chisago,MN,27025,106,84,0,0,22,13,13,0,0,0,93,71,0,22
1990,Clay,MN,27027,86,76,0,2,8,19,15,0,2,2,67,61,0,6
1990,Clearwater,MN,27029,2,2,0,0,0,0,0,0,0,0,2,2,0,0
1990,Cook,MN,27031,6,6,0,0,0,0,0,0,0,0,6,6,0,0
1990,Cottonwood,MN,27033,15,13,0,0,2,2,2,0,0,0,13,11,0,2
1990,Crow Wing,MN,27035,67,57,4,1,5,18,13,4,1,0,49,44,0,5
1990,Dakota,MN,27037,1426,971,12,0,442,172,129,12,0,31,1254,842,0,412
1990,Dodge,MN,27039,40,34,0,1,5,5,4,0,1,0,35,30,0,5
1990,Douglas,MN,27041,43,40,0,0,3,15,15,0,0,0,28,25,0,3
1990,Faribault,MN,27043,17,17,0,0,0,2,2,0,0,0,15,15,0,0
1990,Fillmore,MN,27045,27,23,0,1,3,3,2,0,1,0,24,21,0,3
1990,Freeborn,MN,27047,77,71,1,1,4,11,9,1,1,0,66,62,0,4
1990,Goodhue,MN,27049,100,78,1,0,21,18,15,1,0,2,82,63,0,19
1990,Grant,MN,27051,7,4,1,0,2,2,1,1,0,0,5,3,0,2
1990,Hennepin,MN,27053,5212,3298,111,0,1803,448,268,111,0,69,4764,3030,0,1734
1990,Houston,MN,27055,29,27,1,0,1,8,7,1,0,0,21,20,0,1
1990,Hubbard,MN,27057,28,19,3,2,4,13,7,3,2,1,15,12,0,3
1990,Isanti,MN,27059,122,96,1,0,25,10,8,1,0,1,112,88,0,24
1990,Itasca,MN,27061,57,55,0,0,2,17,16,0,0,1,40,39,0,1
1990,Jackson,MN,27063,11,11,0,0,0,4,4,0,0,0,7,7,0,0
1990,Kanabec,MN,27065,38,30,0,0,8,3,1,0,0,2,35,29,0,6
1990,Kandiyohi,MN,27067,59,54,0,1,4,7,6,0,1,0,52,48,0,4
1990,Kittson,MN,27069,4,3,0,1,0,3,2,0,1,0,1,1,0,0
1990,Koochiching,MN,27071,9,9,0,0,0,3,3,0,0,0,6,6,0,0
1990,Lac qui Parle,MN,27073,15,9,1,1,4,5,3,1,1,0,10,6,0,4
1990,Lake,MN,27075,15,15,0,0,0,2,2,0,0,0,13,13,0,0
1990,Lake of the Woods,MN,27077,6,5,0,0,1,1,1,0,0,0,5,4,0,1
1990,Le Sueur,MN,27079,41,35,0,0,6,4,4,0,0,0,37,31,0,6
1990,Lincoln,MN,27081,9,9,0,0,0,4,4,0,0,0,5,5,0,0
1990,Lyon,MN,27083,29,27,0,0,2,8,7,0,0,1,21,20,0,1
1990,McLeod,MN,27085,53,40,0,3,10,8,5,0,3,0,45,35,0,10
1990,Mahnomen,MN,27087,5,5,0,0,0,1,1,0,0,0,4,4,0,0
1990,Marshall,MN,27089,13,13,0,0,0,7,7,0,0,0,6,6,0,0
1990,Martin,MN,27091,37,35,0,1,1,4,3,0,1,0,33,32,0,1
1990,Meeker,MN,27093,49,43,1,1,4,8,6,1,1,0,41,37,0,4
1990,Mille Lacs,MN,27095,47,38,1,1,7,9,7,1,1,0,38,31,0,7
1990,Morrison,MN,27097,54,45,0,0,9,12,10,0,0,2,42,35,0,7
1990,Mower,MN,27099,121,107,0,0,14,9,9,0,0,0,112,98,0,14
1990,Murray,MN,27101,10,9,0,0,1,2,2,0,0,0,8,7,0,1
1990,Nicollet,MN,27103,49,49,0,0,0,7,7,0,0,0,42,42,0,0
1990,Nobles,MN,27105,42,39,0,0,3,10,10,0,0,0,32,29,0,3
1990,Norman,MN,27107,12,9,0,2,1,4,2,0,2,0,8,7,0,1
1990,Olmsted,MN,27109,233,209,2,0,22,34,30,2,0,2,199,179,0,20
1990,Otter Tail,MN,27111,56,47,1,5,3,22,14,1,5,2,34,33,0,1
1990,Pennington,MN,27113,25,25,0,0,0,7,7,0,0,0,18,18,0,0
1990,Pine,MN,27115,51,41,0,0,10,11,9,0,0,2,40,32,0,8
1990,Pipestone,MN,27117,11,9,0,0,2,3,1,0,0,2,8,8,0,0
1990,Polk,MN,27119,33,29,2,0,2,14,12,2,0,0,19,17,0,2
1990,Pope,MN,27121,15,14,0,0,1,5,4,0,0,1,10,10,0,0
1990,Ramsey,MN,27123,2193,1501,29,0,663,203,137,29,0,37,1990,1364,0,626
1990,Red Lake,MN,27125,7,7,0,0,0,5,5,0,0,0,2,2,0,0
1990,Redwood,MN,27127,24,22,0,0,2,11,11,0,0,0,13,11,0,2
1990,Renville,MN,27129,20,18,1,0,1,6,5,1,0,0,14,13,0,1
1990,Rice,MN,27131,109,86,0,0,23,9,9,0,0,0,100,77,0,23
1990,Rock,MN,27133,11,11,0,0,0,5,5,0,0,0,6,6,0,0
1990,Roseau,MN,27135,21,17,0,1,3,8,6,0,1,1,13,11,0,2
1990,St. Louis,MN,27137,331,312,2,0,17,49,46,2,0,1,282,266,0,16
1990,Scott,MN,27139,236,181,4,0,51,37,26,4,0,7,199,155,0,44
1990,Sherburne,MN,27141,191,137,1,1,52,21,18,1,1,1,170,119,0,51
1990,Sibley,MN,27143,19,13,0,1,5,5,3,0,1,1,14,10,0,4
1990,Stearns,MN,27145,194,146,8,1,39,49,34,8,1,6,145,112,0,33
1990,Steele,MN,27147,63,52,1,1,9,9,7,1,1,0,54,45,0,9
1990,Stevens,MN,27149,7,7,0,0,0,3,3,0,0,0,4,4,0,0
1990,Swift,MN,27151,10,8,0,0,2,3,3,0,0,0,7,5,0,2
1990,Todd,MN,27153,45,38,5,0,2,19,13,5,0,1,26,25,0,1
1990,Traverse,MN,27155,5,3,1,1,0,3,1,1,1,0,2,2,0,0
1990,Wabasha,MN,27157,39,34,0,0,5,6,5,0,0,1,33,29,0,4
1990,Wadena,MN,27159,17,15,1,0,1,3,1,1,0,1,14,14,0,0
1990,Waseca,MN,27161,31,28,0,0,3,8,8,0,0,0,23,20,0,3
1990,Washington,MN,27163,550,382,8,0,160,70,52,8,0,10,480,330,0,150
1990,Watonwan,MN,27165,24,20,1,1,2,10,6,1,1,2,14,14,0,0
1990,Wilkin,MN,27167,15,12,0,2,1,5,3,0,2,0,10,9,0,1
1990,Winona,MN,27169,104,92,7,1,4,14,5,7,1,1,90,87,0,3
1990,Wright,MN,27171,268,207,3,0,58,27,23,3,0,1,241,184,0,57
1990,Yellow Medicine,MN,27173,17,15,0,0,2,8,8,0,0,0,9,7,0,2
1990,Adams,MS,28001,115,90,3,0,22,2,1,1,0,0,113,89,2,22
1990,Alcorn,MS,28003,107,96,5,0,6,9,3,5,0,1,98,93,0,5
1990,Amite,MS,28005,36,30,2,1,3,2,0,1,1,0,34,30,1,3
1990,Attala,MS,28007,48,34,0,0,14,5,5,0,0,0,43,29,0,14
1990,Benton,MS,28009,45,17,0,0,28,0,0,0,0,0,45,17,0,28
1990,Bolivar,MS,28011,179,87,1,1,90,13,7,1,1,4,166,80,0,86
1990,Calhoun,MS,28013,45,27,1,2,15,3,0,1,2,0,42,27,0,15
1990,Carroll,MS,28015,37,25,0,0,12,0,0,0,0,0,37,25,0,12
1990,Chickasaw,MS,28017,62,35,3,0,24,4,1,3,0,0,58,34,0,24
1990,Choctaw,MS,28019,22,15,1,0,6,2,0,1,0,1,20,15,0,5
1990,Claiborne,MS,28021,35,25,0,0,10,0,0,0,0,0,35,25,0,10
1990,Clarke,MS,28023,63,31,0,2,30,2,0,0,2,0,61,31,0,30
1990,Clay,MS,28025,99,46,0,1,52,4,3,0,1,0,95,43,0,52
1990,Coahoma,MS,28027,78,58,2,2,16,6,2,2,2,0,72,56,0,16
1990,Copiah,MS,28029,136,61,0,0,75,0,0,0,0,0,136,61,0,75
1990,Covington,MS,28031,74,36,0,0,38,0,0,0,0,0,74,36,0,38
1990,De Soto,MS,28033,513,304,4,0,205,11,8,3,0,0,502,296,1,205
1990,Forrest,MS,28035,361,266,9,0,86,7,1,6,0,0,354,265,3,86
1990,Franklin,MS,28037,18,14,2,0,2,1,0,1,0,0,17,14,1,2
1990,George,MS,28039,61,36,2,0,23,0,0,0,0,0,61,36,2,23
1990,Greene,MS,28041,20,17,0,0,3,1,1,0,0,0,19,16,0,3
1990,Grenada,MS,28043,143,64,1,0,78,4,1,1,0,2,139,63,0,76
1990,Hancock,MS,28045,102,68,1,0,33,1,0,1,0,0,101,68,0,33
1990,Harrison,MS,28047,913,585,10,0,318,12,5,7,0,0,901,580,3,318
1990,Hinds,MS,28049,1728,883,31,0,814,28,3,25,0,0,1700,880,6,814
1990,Holmes,MS,28051,41,20,0,0,21,0,0,0,0,0,41,20,0,21
1990,Humphreys,MS,28053,33,18,0,0,15,1,1,0,0,0,32,17,0,15
1990,Issaquena,MS,28055,5,0,0,0,0,1,0,0,1,0,4,0,0,4
1990,Itawamba,MS,28057,80,59,0,0,21,3,1,0,0,2,77,58,0,19
1990,Jackson,MS,28059,626,355,5,0,266,7,4,3,0,0,619,351,2,266
1990,Jasper,MS,28061,66,24,1,0,41,1,0,1,0,0,65,24,0,41
1990,Jefferson,MS,28063,18,9,0,0,9,0,0,0,0,0,18,9,0,9
1990,Jefferson Davis,MS,28065,46,20,2,0,24,4,2,2,0,0,42,18,0,24
1990,Jones,MS,28067,255,138,6,0,111,5,1,4,0,0,250,137,2,111
1990,Kemper,MS,28069,21,5,0,0,16,0,0,0,0,0,21,5,0,16
1990,Lafayette,MS,28071,125,65,2,0,58,5,2,2,0,1,120,63,0,57
1990,Lamar,MS,28073,94,75,0,0,19,0,0,0,0,0,94,75,0,19
1990,Lauderdale,MS,28075,278,157,5,0,116,6,1,5,0,0,272,156,0,116
1990,Lawrence,MS,28077,48,27,0,0,21,1,1,0,0,0,47,26,0,21
1990,Leake,MS,28079,62,33,0,2,27,3,1,0,2,0,59,32,0,27
1990,Lee,MS,28081,381,272,3,0,106,17,14,3,0,0,364,258,0,106
1990,Leflore,MS,28083,156,113,4,0,39,7,3,3,0,1,149,110,1,38
1990,Lincoln,MS,28085,122,86,0,0,36,0,0,0,0,0,122,86,0,36
1990,Lowndes,MS,28087,318,147,3,4,164,18,6,3,4,5,300,141,0,159
1990,Madison,MS,28089,238,138,3,0,97,2,0,2,0,0,236,138,1,97
1990,Marion,MS,28091,102,66,0,0,36,0,0,0,0,0,102,66,0,36
1990,Marshall,MS,28093,213,65,1,1,146,3,0,1,1,1,210,65,0,145
1990,Monroe,MS,28095,236,100,0,0,136,2,1,0,0,1,234,99,0,135
1990,Montgomery,MS,28097,44,30,0,0,14,1,1,0,0,0,43,29,0,14
1990,Neshoba,MS,28099,48,33,0,1,14,1,0,0,1,0,47,33,0,14
1990,Newton,MS,28101,59,34,0,0,25,0,0,0,0,0,59,34,0,25
1990,Noxubee,MS,28103,34,16,1,0,17,1,0,1,0,0,33,16,0,17
1990,Oktibbeha,MS,28105,100,45,1,0,54,2,1,0,0,1,98,44,1,53
1990,Panola,MS,28107,129,94,1,0,34,3,2,1,0,0,126,92,0,34
1990,Pearl River,MS,28109,114,77,2,0,35,2,1,1,0,0,112,76,1,35
1990,Perry,MS,28111,25,20,0,0,5,0,0,0,0,0,25,20,0,5
1990,Pike,MS,28113,119,93,0,0,26,0,0,0,0,0,119,93,0,26
1990,Pontotoc,MS,28115,95,65,1,1,28,4,1,1,1,1,91,64,0,27
1990,Prentiss,MS,28117,79,76,0,0,3,3,3,0,0,0,76,73,0,3
1990,Quitman,MS,28119,34,24,0,1,9,5,4,0,1,0,29,20,0,9
1990,Rankin,MS,28121,572,398,4,0,170,4,0,4,0,0,568,398,0,170
1990,Scott,MS,28123,122,64,0,1,57,1,0,0,1,0,121,64,0,57
1990,Sharkey,MS,28125,8,5,0,0,3,0,0,0,0,0,8,5,0,3
1990,Simpson,MS,28127,128,50,1,1,76,2,0,1,1,0,126,50,0,76
1990,Smith,MS,28129,66,19,1,1,45,2,0,1,1,0,64,19,0,45
1990,Stone,MS,28131,42,31,3,0,8,1,0,1,0,0,41,31,2,8
1990,Sunflower,MS,28133,122,86,0,1,35,5,4,0,1,0,117,82,0,35
1990,Tallahatchie,MS,28135,45,20,0,3,22,6,2,0,3,1,39,18,0,21
1990,Tate,MS,28137,74,38,0,1,35,3,2,0,1,0,71,36,0,35
1990,Tippah,MS,28139,57,32,1,1,23,3,1,1,1,0,54,31,0,23
1990,Tishomingo,MS,28141,54,51,1,0,2,4,3,1,0,0,50,48,0,2
1990,Tunica,MS,28143,26,15,2,0,9,3,1,2,0,0,23,14,0,9
1990,Union,MS,28145,120,103,2,1,14,6,3,2,1,0,114,100,0,14
1990,Walthall,MS,28147,30,23,2,0,5,0,0,0,0,0,30,23,2,5
1990,Warren,MS,28149,208,134,1,0,73,0,0,0,0,0,208,134,1,73
1990,Washington,MS,28151,354,242,7,2,103,14,4,7,2,1,340,238,0,102
1990,Wayne,MS,28153,32,16,1,0,15,1,0,1,0,0,31,16,0,15
1990,Webster,MS,28155,29,20,0,0,9,2,1,0,0,1,27,19,0,8
1990,Wilkinson,MS,28157,22,19,0,0,3,0,0,0,0,0,22,19,0,3
1990,Winston,MS,28159,72,39,3,0,30,10,6,3,0,1,62,33,0,29
1990,Yalobusha,MS,28161,51,29,0,0,22,1,1,0,0,0,50,28,0,22
1990,Yazoo,MS,28163,70,45,1,0,24,1,0,1,0,0,69,45,0,24
1990,Adair,MO,29001,43,37,0,0,6,3,2,0,0,1,40,35,0,5
1990,Andrew,MO,29003,26,21,0,2,3,3,1,0,2,0,23,20,0,3
1990,Atchison,MO,29005,7,7,0,0,0,1,1,0,0,0,6,6,0,0
1990,Audrain,MO,29007,46,41,1,0,4,2,1,1,0,0,44,40,0,4
1990,Barry,MO,29009,46,36,5,0,5,13,7,5,0,1,33,29,0,4
1990,Barton,MO,29011,15,13,0,0,2,1,1,0,0,0,14,12,0,2
1990,Bates,MO,29013,25,22,2,1,0,9,6,2,1,0,16,16,0,0
1990,Benton,MO,29015,26,23,1,0,2,5,4,1,0,0,21,19,0,2
1990,Bollinger,MO,29017,26,23,0,0,3,1,1,0,0,0,25,22,0,3
1990,Boone,MO,29019,338,303,3,0,32,31,28,2,0,1,307,275,1,31
1990,Buchanan,MO,29021,199,187,2,1,9,26,23,2,1,0,173,164,0,9
1990,Butler,MO,29023,95,91,1,0,3,4,3,1,0,0,91,88,0,3
1990,Caldwell,MO,29025,28,25,0,0,3,8,8,0,0,0,20,17,0,3
1990,Callaway,MO,29027,85,78,0,0,7,7,7,0,0,0,78,71,0,7
1990,Camden,MO,29029,73,65,5,1,2,16,9,5,1,1,57,56,0,1
1990,Cape Girardeau,MO,29031,182,173,1,0,8,14,13,1,0,0,168,160,0,8
1990,Carroll,MO,29033,25,18,0,4,3,8,4,0,4,0,17,14,0,3
1990,Carter,MO,29035,14,13,1,0,0,2,1,1,0,0,12,12,0,0
1990,Cass,MO,29037,221,189,3,0,29,27,20,3,0,4,194,169,0,25
1990,Cedar,MO,29039,26,19,0,3,4,6,3,0,3,0,20,16,0,4
1990,Chariton,MO,29041,12,12,0,0,0,1,1,0,0,0,11,11,0,0
1990,Christian,MO,29043,114,100,3,0,11,13,8,3,0,2,101,92,0,9
1990,Clark,MO,29045,18,16,0,2,0,4,2,0,2,0,14,14,0,0
1990,Clay,MO,29047,464,405,4,0,55,39,27,4,0,8,425,378,0,47
1990,Clinton,MO,29049,45,41,0,0,4,1,1,0,0,0,44,40,0,4
1990,Cole,MO,29051,158,147,1,0,10,10,8,1,0,1,148,139,0,9
1990,Cooper,MO,29053,40,37,0,0,3,8,8,0,0,0,32,29,0,3
1990,Crawford,MO,29055,38,32,0,0,6,1,1,0,0,0,37,31,0,6
1990,Dade,MO,29057,17,14,0,1,2,3,2,0,1,0,14,12,0,2
1990,Dallas,MO,29059,26,23,0,1,2,3,2,0,1,0,23,21,0,2
1990,Daviess,MO,29061,14,11,0,2,1,5,2,0,2,1,9,9,0,0
1990,DeKalb,MO,29063,17,15,0,1,1,1,0,0,1,0,16,15,0,1
1990,Dent,MO,29065,27,27,0,0,0,1,1,0,0,0,26,26,0,0
1990,Douglas,MO,29067,11,6,2,0,3,6,2,2,0,2,5,4,0,1
1990,Dunklin,MO,29069,76,73,1,0,2,5,4,1,0,0,71,69,0,2
1990,Franklin,MO,29071,274,194,3,1,76,10,5,3,1,1,264,189,0,75
1990,Gasconade,MO,29073,34,23,0,0,11,3,2,0,0,1,31,21,0,10
1990,Gentry,MO,29075,24,17,0,4,3,16,11,0,4,1,8,6,0,2
1990,Greene,MO,29077,676,577,30,0,69,107,65,30,0,12,569,512,0,57
1990,Grundy,MO,29079,14,12,0,2,0,6,4,0,2,0,8,8,0,0
1990,Harrison,MO,29081,8,8,0,0,0,2,2,0,0,0,6,6,0,0
1990,Henry,MO,29083,29,29,0,0,0,2,2,0,0,0,27,27,0,0
1990,Hickory,MO,29085,5,4,0,0,1,0,0,0,0,0,5,4,0,1
1990,Holt,MO,29087,9,9,0,0,0,4,4,0,0,0,5,5,0,0
1990,Howard,MO,29089,15,14,0,0,1,0,0,0,0,0,15,14,0,1
1990,Howell,MO,29091,35,30,1,0,4,7,5,1,0,1,28,25,0,3
1990,Iron,MO,29093,18,10,0,0,8,2,2,0,0,0,16,8,0,8
1990,Jackson,MO,29095,2241,1735,28,0,478,188,140,28,0,20,2053,1595,0,458
1990,Jasper,MO,29097,272,234,8,1,29,38,25,8,1,4,234,209,0,25
1990,Jefferson,MO,29099,703,434,1,0,268,33,22,1,0,10,670,412,0,258
1990,Johnson,MO,29101,84,71,3,1,9,5,0,3,1,1,79,71,0,8
1990,Knox,MO,29103,6,3,0,2,1,2,0,0,2,0,4,3,0,1
1990,Laclede,MO,29105,72,69,1,2,0,8,5,1,2,0,64,64,0,0
1990,Lafayette,MO,29107,82,75,0,0,7,7,6,0,0,1,75,69,0,6
1990,Lawrence,MO,29109,64,56,1,0,7,6,4,1,0,1,58,52,0,6
1990,Lewis,MO,29111,25,22,0,1,2,2,1,0,1,0,23,21,0,2
1990,Lincoln,MO,29113,82,50,1,1,30,4,2,1,1,0,78,48,0,30
1990,Linn,MO,29115,19,18,0,0,1,2,2,0,0,0,17,16,0,1
1990,Livingston,MO,29117,25,21,0,0,4,5,5,0,0,0,20,16,0,4
1990,Macon,MO,29119,30,27,0,0,3,6,5,0,0,1,24,22,0,2
1990,Madison,MO,29121,28,23,0,1,4,2,1,0,1,0,26,22,0,4
1990,Maries,MO,29123,19,18,0,0,1,1,1,0,0,0,18,17,0,1
1990,Marion,MO,29125,13,13,0,0,0,1,1,0,0,0,12,12,0,0
1990,McDonald,MO,29127,95,73,0,1,21,3,2,0,1,0,92,71,0,21
1990,Miller,MO,29131,41,38,0,0,3,13,12,0,0,1,28,26,0,2
1990,Mississippi,MO,29133,45,39,5,0,1,8,3,5,0,0,37,36,0,1
1990,Moniteau,MO,29135,25,23,0,1,1,5,4,0,1,0,20,19,0,1
1990,Monroe,MO,29137,26,22,1,1,2,4,2,1,1,0,22,20,0,2
1990,Montgomery,MO,29139,19,14,0,0,5,1,1,0,0,0,18,13,0,5
1990,Morgan,MO,29141,25,23,0,0,2,3,3,0,0,0,22,20,0,2
1990,New Madrid,MO,29143,49,47,1,0,1,3,2,1,0,0,46,45,0,1
1990,Newton,MO,29145,70,65,1,0,4,11,9,1,0,1,59,56,0,3
1990,Nodaway,MO,29147,24,20,0,1,3,10,9,0,1,0,14,11,0,3
1990,Oregon,MO,29149,8,5,0,1,2,3,1,0,1,1,5,4,0,1
1990,Osage,MO,29151,8,7,0,0,1,1,1,0,0,0,7,6,0,1
1990,Ozark,MO,29153,7,6,0,0,1,1,1,0,0,0,6,5,0,1
1990,Pemiscot,MO,29155,41,40,1,0,0,2,1,1,0,0,39,39,0,0
1990,Perry,MO,29157,25,19,0,0,6,0,0,0,0,0,25,19,0,6
1990,Pettis,MO,29159,76,70,1,0,5,17,16,1,0,0,59,54,0,5
1990,Phelps,MO,29161,70,64,2,0,4,11,9,2,0,0,59,55,0,4
1990,Pike,MO,29163,43,34,0,0,9,2,2,0,0,0,41,32,0,9
1990,Platte,MO,29165,171,142,5,0,24,15,9,5,0,1,156,133,0,23
1990,Polk,MO,29167,48,42,1,1,4,7,5,1,1,0,41,37,0,4
1990,Pulaski,MO,29169,153,141,1,0,11,20,16,1,0,3,133,125,0,8
1990,Putnam,MO,29171,4,4,0,0,0,1,1,0,0,0,3,3,0,0
1990,Ralls,MO,29173,25,18,0,0,7,2,2,0,0,0,23,16,0,7
1990,Randolph,MO,29175,67,60,2,0,5,5,1,2,0,2,62,59,0,3
1990,Ray,MO,29177,56,54,0,0,2,5,5,0,0,0,51,49,0,2
1990,Reynolds,MO,29179,8,7,0,0,1,1,1,0,0,0,7,6,0,1
1990,Ripley,MO,29181,28,28,0,0,0,1,1,0,0,0,27,27,0,0
1990,Saline,MO,29183,650,424,8,0,218,44,31,8,0,5,606,393,0,213
1990,Schuyler,MO,29185,15,11,2,0,2,10,6,2,0,2,5,5,0,0
1990,Scotland,MO,29186,31,25,0,0,6,2,2,0,0,0,29,23,0,6
1990,Scott,MO,29187,108,80,0,0,28,8,6,0,0,2,100,74,0,26
1990,Shannon,MO,29189,2977,1477,52,0,1448,169,103,52,0,14,2808,1374,0,1434
1990,Shelby,MO,29195,69,63,0,3,3,13,9,0,3,1,56,54,0,2
1990,St. Charles,MO,29197,4,4,0,0,0,0,0,0,0,0,4,4,0,0
1990,St. Clair,MO,29199,4,4,0,0,0,1,1,0,0,0,3,3,0,0
1990,St. Francois,MO,29201,157,154,1,0,2,7,6,1,0,0,150,148,0,2
1990,St. Louis city,MO,29203,6,6,0,0,0,0,0,0,0,0,6,6,0,0
1990,St. Louis,MO,29205,12,8,0,1,3,1,0,0,1,0,11,8,0,3
1990,Ste. Genevieve,MO,29207,95,91,2,0,2,12,10,2,0,0,83,81,0,2
1990,Stoddard,MO,29209,36,31,1,2,2,13,10,1,2,0,23,21,0,2
1990,Stone,MO,29211,9,8,0,1,0,3,2,0,1,0,6,6,0,0
1990,Sullivan,MO,29213,71,57,10,0,4,19,8,10,0,1,52,49,0,3
1990,Taney,MO,29215,28,24,1,0,3,8,6,1,0,1,20,18,0,2
1990,Texas,MO,29217,32,31,0,0,1,7,7,0,0,0,25,24,0,1
1990,Vernon,MO,29219,56,38,1,0,17,2,1,1,0,0,54,37,0,17
1990,Warren,MO,29221,35,19,0,0,16,4,3,0,0,1,31,16,0,15
1990,Washington,MO,29223,24,24,0,0,0,1,1,0,0,0,23,23,0,0
1990,Wayne,MO,29225,54,48,1,0,5,11,9,1,0,1,43,39,0,4
1990,Webster,MO,29227,3,1,0,1,0,3,1,0,2,0,0,0,0,0
1990,Worth,MO,29229,31,26,0,3,2,10,7,0,3,0,21,19,0,2
1990,Wright,MO,29510,1485,732,15,0,738,42,22,15,0,5,1443,710,0,733
1990,Beaverhead,MT,30001,19,13,2,0,4,3,1,2,0,0,16,12,0,4
1990,Big Horn,MT,30003,15,12,0,2,1,5,3,0,2,0,10,9,0,1
1990,Blaine,MT,30005,7,2,3,2,0,4,0,2,2,0,3,2,1,0
1990,Broadwater,MT,30007,5,4,0,1,0,1,0,0,1,0,4,4,0,0
1990,Carbon,MT,30009,16,11,0,1,4,4,1,0,1,2,12,10,0,2
1990,Carter,MT,30011,2,1,0,1,0,1,0,0,1,0,1,1,0,0
1990,Cascade,MT,30013,237,217,4,1,15,17,10,4,1,2,220,207,0,13
1990,Chouteau,MT,30015,11,6,0,4,1,5,1,0,4,0,6,5,0,1
1990,Custer,MT,30017,19,15,0,1,3,3,1,0,1,1,16,14,0,2
1990,Daniels,MT,30019,4,3,0,1,0,2,1,0,1,0,2,2,0,0
1990,Dawson,MT,30021,20,18,0,2,0,4,2,0,2,0,16,16,0,0
1990,Deer Lodge,MT,30023,19,18,0,0,1,0,0,0,0,0,19,18,0,1
1990,Fallon,MT,30025,5,3,0,1,1,1,0,0,1,0,4,3,0,1
1990,Fergus,MT,30027,13,9,2,1,1,2,0,1,1,0,11,9,1,1
1990,Flathead,MT,30029,188,157,6,0,25,16,8,6,0,2,172,149,0,23
1990,Gallatin,MT,30031,87,75,0,0,12,10,7,0,0,3,77,68,0,9
1990,Garfield,MT,30033,2,0,2,0,0,2,0,2,0,0,0,0,0,0
1990,Glacier,MT,30035,14,11,0,2,1,2,0,0,2,0,12,11,0,1
1990,Granite,MT,30039,4,3,1,0,0,2,1,1,0,0,2,2,0,0
1990,Hill,MT,30041,28,26,0,0,2,2,2,0,0,0,26,24,0,2
1990,Jefferson,MT,30043,16,15,0,1,0,2,1,0,1,0,14,14,0,0
1990,Judith Basin,MT,30045,3,2,1,0,0,1,0,1,0,0,2,2,0,0
1990,Lake,MT,30047,53,49,1,0,3,9,8,1,0,0,44,41,0,3
1990,Lewis and Clark,MT,30049,117,113,0,0,4,9,8,0,0,1,108,105,0,3
1990,Liberty,MT,30051,3,2,0,1,0,1,0,0,1,0,2,2,0,0
1990,Lincoln,MT,30053,44,38,1,0,5,2,1,1,0,0,42,37,0,5
1990,McCone,MT,30055,4,1,0,3,0,3,0,0,3,0,1,1,0,0
1990,Madison,MT,30057,8,4,1,1,2,2,0,1,1,0,6,4,0,2
1990,Meagher,MT,30059,8,5,0,0,3,2,0,0,0,2,6,5,0,1
1990,Mineral,MT,30061,8,8,0,0,0,1,1,0,0,0,7,7,0,0
1990,Missoula,MT,30063,242,210,5,0,27,17,10,5,0,2,225,200,0,25
1990,Musselshell,MT,30065,16,15,0,0,1,1,0,0,0,1,15,15,0,0
1990,Park,MT,30067,33,30,1,0,2,6,4,1,0,1,27,26,0,1
1990,Phillips,MT,30071,7,3,0,2,2,2,0,0,2,0,5,3,0,2
1990,Pondera,MT,30073,4,4,0,0,0,0,0,0,0,0,4,4,0,0
1990,Powder River,MT,30075,1,1,0,0,0,0,0,0,0,0,1,1,0,0
1990,Powell,MT,30077,15,14,1,0,0,1,0,1,0,0,14,14,0,0
1990,Ravalli,MT,30081,68,60,1,0,7,6,4,1,0,1,62,56,0,6
1990,Richland,MT,30083,39,34,0,3,2,5,2,0,3,0,34,32,0,2
1990,Roosevelt,MT,30085,8,5,0,3,0,5,2,0,3,0,3,3,0,0
1990,Rosebud,MT,30087,11,8,2,0,1,2,0,2,0,0,9,8,0,1
1990,Sanders,MT,30089,12,12,0,0,0,0,0,0,0,0,12,12,0,0
1990,Sheridan,MT,30091,6,3,0,2,1,2,0,0,2,0,4,3,0,1
1990,Silver Bow,MT,30093,60,53,1,0,6,6,4,1,0,1,54,49,0,5
1990,Stillwater,MT,30095,10,9,0,0,1,2,2,0,0,0,8,7,0,1
1990,Sweet Grass,MT,30097,4,3,0,0,1,0,0,0,0,0,4,3,0,1
1990,Teton,MT,30099,6,4,0,1,1,2,0,0,1,1,4,4,0,0
1990,Toole,MT,30101,6,5,0,1,0,1,0,0,1,0,5,5,0,0
1990,Treasure,MT,30103,1,1,0,0,0,0,0,0,0,0,1,1,0,0
1990,Valley,MT,30105,9,7,0,1,1,1,0,0,1,0,8,7,0,1
1990,Wheatland,MT,30107,3,2,0,1,0,1,0,0,1,0,2,2,0,0
1990,Wibaux,MT,30109,2,2,0,0,0,0,0,0,0,0,2,2,0,0
1990,Yellowstone,MT,30111,410,336,15,0,59,43,20,15,0,8,367,316,0,51
1990,Adams,NE,31001,59,50,0,0,9,0,0,0,0,0,59,50,0,9
1990,Antelope,NE,31003,9,6,0,1,2,3,0,0,1,2,6,6,0,0
1990,Banner,NE,31007,1,1,0,0,0,0,0,0,0,0,1,1,0,0
1990,Boone,NE,31011,3,3,0,0,0,0,0,0,0,0,3,3,0,0
1990,Box Butte,NE,31013,26,21,0,1,4,3,2,0,1,0,23,19,0,4
1990,Boyd,NE,31015,2,1,0,0,1,0,0,0,0,0,2,1,0,1
1990,Brown,NE,31017,10,6,1,1,2,2,0,0,1,1,8,6,1,1
1990,Buffalo,NE,31019,58,44,1,0,13,2,1,1,0,0,56,43,0,13
1990,Burt,NE,31021,18,11,0,0,7,2,1,0,0,1,16,10,0,6
1990,Butler,NE,31023,11,4,0,2,5,2,0,0,2,0,9,4,0,5
1990,Cass,NE,31025,50,33,0,0,17,1,0,0,0,1,49,33,0,16
1990,Cedar,NE,31027,4,3,0,1,0,2,1,0,1,0,2,2,0,0
1990,Chase,NE,31029,7,4,2,1,0,4,1,2,1,0,3,3,0,0
1990,Cherry,NE,31031,4,4,0,0,0,0,0,0,0,0,4,4,0,0
1990,Cheyenne,NE,31033,22,14,0,1,7,2,1,0,1,0,20,13,0,7
1990,Clay,NE,31035,23,17,0,5,1,6,1,0,5,0,17,16,0,1
1990,Colfax,NE,31037,27,18,0,5,4,6,0,0,5,1,21,18,0,3
1990,Cuming,NE,31039,14,10,0,2,2,3,1,0,2,0,11,9,0,2
1990,Custer,NE,31041,12,10,2,0,0,2,0,2,0,0,10,10,0,0
1990,Dakota,NE,31043,60,57,0,1,2,8,6,0,1,1,52,51,0,1
1990,Dawes,NE,31045,5,5,0,0,0,3,3,0,0,0,2,2,0,0
1990,Dawson,NE,31047,42,35,0,2,5,5,3,0,2,0,37,32,0,5
1990,Deuel,NE,31049,2,2,0,0,0,1,1,0,0,0,1,1,0,0
1990,Dixon,NE,31051,7,6,0,1,0,1,0,0,1,0,6,6,0,0
1990,Dodge,NE,31053,111,66,4,0,41,13,4,4,0,5,98,62,0,36
1990,Douglas,NE,31055,1596,815,30,0,749,176,85,30,0,59,1420,730,0,690
1990,Dundy,NE,31057,3,2,1,0,0,1,0,1,0,0,2,2,0,0
1990,Fillmore,NE,31059,8,6,0,0,2,0,0,0,0,0,8,6,0,2
1990,Franklin,NE,31061,9,8,1,0,0,1,0,1,0,0,8,8,0,0
1990,Frontier,NE,31063,4,2,0,2,0,2,0,0,2,0,2,2,0,0
1990,Furnas,NE,31065,9,4,1,2,2,3,0,1,2,0,6,4,0,2
1990,Gage,NE,31067,56,34,2,4,15,10,3,2,5,0,46,31,0,15
1990,Garden,NE,31069,7,6,0,1,0,2,1,0,1,0,5,5,0,0
1990,Garfield,NE,31071,2,2,0,0,0,0,0,0,0,0,2,2,0,0
1990,Gosper,NE,31073,4,2,0,2,0,2,0,0,2,0,2,2,0,0
1990,Greeley,NE,31077,4,2,0,1,1,1,0,0,1,0,3,2,0,1
1990,Hall,NE,31079,93,77,2,0,14,5,2,2,0,1,88,75,0,13
1990,Hamilton,NE,31081,11,9,0,1,1,1,0,0,1,0,10,9,0,1
1990,Harlan,NE,31083,6,3,0,3,0,4,1,0,3,0,2,2,0,0
1990,Hitchcock,NE,31087,5,1,0,1,3,1,0,0,1,0,4,1,0,3
1990,Holt,NE,31089,25,21,0,1,3,3,2,0,1,0,22,19,0,3
1990,Howard,NE,31093,8,4,0,0,4,0,0,0,0,0,8,4,0,4
1990,Jefferson,NE,31095,23,18,1,1,3,2,0,1,1,0,21,18,0,3
1990,Johnson,NE,31097,54,42,0,2,10,3,0,0,2,1,51,42,0,9
1990,Kearney,NE,31099,13,13,0,0,0,2,2,0,0,0,11,11,0,0
1990,Keith,NE,31101,13,10,1,0,2,1,0,1,0,0,12,10,0,2
1990,Keya Paha,NE,31103,2,1,0,0,1,0,0,0,0,0,2,1,0,1
1990,Kimball,NE,31105,12,8,0,2,2,2,0,0,2,0,10,8,0,2
1990,Knox,NE,31107,9,7,0,1,1,2,0,0,1,1,7,7,0,0
1990,Lancaster,NE,31109,541,387,8,3,143,21,8,8,3,2,520,379,0,141
1990,Lincoln,NE,31111,73,56,1,1,15,6,3,1,1,1,67,53,0,14
1990,Madison,NE,31119,66,49,2,0,15,7,4,2,0,1,59,45,0,14
1990,Merrick,NE,31121,20,14,1,2,3,3,0,1,2,0,17,14,0,3
1990,Morrill,NE,31123,9,9,0,0,0,0,0,0,0,0,9,9,0,0
1990,Nance,NE,31125,10,9,0,0,1,1,1,0,0,0,9,8,0,1
1990,Nemaha,NE,31127,12,9,1,0,2,2,1,1,0,0,10,8,0,2
1990,Nuckolls,NE,31129,4,3,0,0,1,0,0,0,0,0,4,3,0,1
1990,Otoe,NE,31131,27,15,0,0,12,1,0,0,0,1,26,15,0,11
1990,Pawnee,NE,31133,5,5,0,0,0,0,0,0,0,0,5,5,0,0
1990,Perkins,NE,31135,3,1,1,1,0,2,0,1,1,0,1,1,0,0
1990,Phelps,NE,31137,25,19,1,0,5,0,0,0,0,0,25,19,1,5
1990,Pierce,NE,31139,3,1,0,0,2,1,0,0,0,1,2,1,0,1
1990,Platte,NE,31141,15,10,0,3,2,3,0,0,3,0,12,10,0,2
1990,Polk,NE,31143,6,4,0,0,2,0,0,0,0,0,6,4,0,2
1990,Red Willow,NE,31145,29,20,0,1,8,3,2,0,1,0,26,18,0,8
1990,Richardson,NE,31147,23,21,0,0,2,3,3,0,0,0,20,18,0,2
1990,Rock,NE,31149,2,2,0,0,0,0,0,0,0,0,2,2,0,0
1990,Saline,NE,31151,31,24,0,3,4,3,0,0,3,0,28,24,0,4
1990,Sarpy,NE,31153,312,189,0,1,122,30,20,0,1,9,282,169,0,113
1990,Saunders,NE,31155,49,25,0,0,24,2,1,0,0,1,47,24,0,23
1990,Scotts Bluff,NE,31157,74,65,0,1,8,10,6,0,1,3,64,59,0,5
1990,Seward,NE,31159,26,19,1,2,4,3,0,1,2,0,23,19,0,4
1990,Sheridan,NE,31161,10,8,1,1,0,5,3,1,1,0,5,5,0,0
1990,Sherman,NE,31163,4,3,0,1,0,1,0,0,1,0,3,3,0,0
1990,Stanton,NE,31167,9,6,0,2,1,2,0,0,2,0,7,6,0,1
1990,Thayer,NE,31169,13,11,0,1,1,2,1,0,1,0,11,10,0,1
1990,Thomas,NE,31171,1,1,0,0,0,0,0,0,0,0,1,1,0,0
1990,Thurston,NE,31173,15,9,0,4,2,7,2,0,4,1,8,7,0,1
1990,Valley,NE,31175,8,8,0,0,0,0,0,0,0,0,8,8,0,0
1990,Washington,NE,31177,40,26,0,0,14,6,3,0,0,3,34,23,0,11
1990,Wayne,NE,31179,12,10,1,0,1,3,1,1,0,1,9,9,0,0
1990,Webster,NE,31181,5,5,0,0,0,0,0,0,0,0,5,5,0,0
1990,Wheeler,NE,31183,1,0,0,0,0,1,0,0,1,0,0,0,0,0
1990,York,NE,31185,23,14,0,3,6,6,2,0,3,1,17,12,0,5
1990,Churchill,NV,32001,62,57,3,0,2,3,1,2,0,0,59,56,1,2
1990,Clark,NV,32003,4532,2835,140,0,1557,201,69,116,0,16,4331,2766,24,1541
1990,Douglas,NV,32005,76,67,5,0,4,9,4,5,0,0,67,63,0,4
1990,Elko,NV,32007,92,84,2,0,6,7,5,2,0,0,85,79,0,6
1990,Esmeralda,NV,32009,1,1,0,0,0,0,0,0,0,0,1,1,0,0
1990,Eureka,NV,32011,7,3,0,2,2,2,0,0,2,0,5,3,0,2
1990,Humboldt,NV,32013,37,29,2,0,6,5,2,2,0,1,32,27,0,5
1990,Lander,NV,32015,20,19,0,0,1,1,1,0,0,0,19,18,0,1
1990,Lincoln,NV,32017,4,3,1,0,0,1,0,1,0,0,3,3,0,0
1990,Lyon,NV,32019,92,82,2,0,8,3,1,2,0,0,89,81,0,8
1990,Mineral,NV,32021,20,19,0,0,1,0,0,0,0,0,20,19,0,1
1990,Nye,NV,32023,66,48,1,1,16,3,1,1,1,0,63,47,0,16
1990,Pershing,NV,32027,17,16,0,0,1,1,1,0,0,0,16,15,0,1
1990,Storey,NV,32029,7,3,2,0,2,3,0,2,0,1,4,3,0,1
1990,Washoe,NV,32031,1232,1078,46,0,108,104,49,42,0,13,1128,1029,4,95
1990,White Pine,NV,32033,32,32,0,0,0,0,0,0,0,0,32,32,0,0
1990,Carson City,NV,32510,172,158,5,0,9,10,3,5,0,2,162,155,0,7
1990,Belknap,NH,33001,116,94,9,0,13,23,14,9,0,0,93,80,0,13
1990,Carroll,NH,33003,67,54,8,0,5,26,19,7,0,0,41,35,1,5
1990,Cheshire,NH,33005,81,65,10,0,6,23,12,10,0,1,58,53,0,5
1990,Coos,NH,33007,27,25,1,0,1,4,3,1,0,0,23,22,0,1
1990,Grafton,NH,33009,116,98,9,0,9,38,29,8,0,1,78,69,1,8
1990,Hillsborough,NH,33011,949,834,54,0,61,145,83,49,0,13,804,751,5,48
1990,Merrimack,NH,33013,262,228,7,0,27,46,37,6,0,3,216,191,1,24
1990,Rockingham,NH,33015,680,547,54,1,78,135,73,49,1,12,545,474,5,66
1990,Strafford,NH,33017,202,166,13,0,23,42,26,13,0,3,160,140,0,20
1990,Sullivan,NH,33019,79,72,2,0,5,11,9,2,0,0,68,63,0,5
1990,Atlantic,NJ,34001,832,593,42,0,197,53,13,40,0,0,779,580,2,197
1990,Bergen,NJ,34003,1246,1038,87,0,121,115,53,62,0,0,1131,985,25,121
1990,Burlington,NJ,34005,1012,516,37,1,458,55,22,28,1,4,957,494,9,454
1990,Camden,NJ,34007,1447,612,39,0,796,64,26,35,0,3,1383,586,4,793
1990,Cape May,NJ,34009,187,126,16,0,45,20,7,12,0,1,167,119,4,44
1990,Cumberland,NJ,34011,347,246,6,1,94,14,6,6,1,1,333,240,0,93
1990,Essex,NJ,34013,1386,960,74,0,352,114,47,67,0,0,1272,913,7,352
1990,Gloucester,NJ,34015,527,283,15,0,229,25,7,15,0,3,502,276,0,226
1990,Hudson,NJ,34017,1003,847,50,0,106,64,21,43,0,0,939,826,7,106
1990,Hunterdon,NJ,34019,143,116,10,1,16,17,8,8,1,0,126,108,2,16
1990,Mercer,NJ,34021,590,356,34,1,199,52,21,29,1,1,538,335,5,198
1990,Middlesex,NJ,34023,1217,1007,34,0,176,82,54,27,0,1,1135,953,7,175
1990,Monmouth,NJ,34025,1225,883,94,0,248,125,65,57,0,3,1100,818,37,245
1990,Morris,NJ,34027,658,523,57,0,78,78,32,45,0,1,580,491,12,77
1990,Ocean,NJ,34029,1161,803,61,0,297,88,43,42,0,3,1073,760,19,294
1990,Passaic,NJ,34031,783,638,22,0,123,56,36,20,0,0,727,602,2,123
1990,Salem,NJ,34033,127,98,1,0,28,1,0,1,0,0,126,98,0,28
1990,Somerset,NJ,34035,366,287,24,0,55,40,20,19,0,1,326,267,5,54
1990,Sussex,NJ,34037,254,179,12,0,63,15,6,9,0,0,239,173,3,63
1990,Union,NJ,34039,768,568,36,0,164,52,24,28,0,0,716,544,8,164
1990,Warren,NJ,34041,156,126,3,0,27,9,8,1,0,0,147,118,2,27
1990,Bernalillo,NM,35001,1860,1541,65,0,254,160,86,51,0,23,1700,1455,14,231
1990,Catron,NM,35003,6,3,1,0,2,0,0,0,0,0,6,3,1,2
1990,Chaves,NM,35005,170,159,4,1,6,14,10,3,1,0,156,149,1,6
1990,Cibola,NM,35006,35,30,1,0,4,4,3,1,0,0,31,27,0,4
1990,Colfax,NM,35007,23,19,1,0,3,1,0,1,0,0,22,19,0,3
1990,Curry,NM,35009,92,87,0,3,2,7,3,0,3,1,85,84,0,1
1990,DeBaca,NM,35011,6,6,0,0,0,1,1,0,0,0,5,5,0,0
1990,Dona Ana,NM,35013,315,293,13,0,9,28,16,11,0,1,287,277,2,8
1990,Eddy,NM,35015,123,113,1,2,7,13,9,1,2,1,110,104,0,6
1990,Grant,NM,35017,64,45,3,0,16,6,1,2,0,3,58,44,1,13
1990,Guadalupe,NM,35019,1,1,0,0,0,0,0,0,0,0,1,1,0,0
1990,Hidalgo,NM,35023,14,7,0,0,7,0,0,0,0,0,14,7,0,7
1990,Lea,NM,35025,209,202,2,0,5,12,10,2,0,0,197,192,0,5
1990,Lincoln,NM,35027,33,31,2,0,0,5,5,0,0,0,28,26,2,0
1990,Los Alamos,NM,35028,22,19,0,0,3,2,2,0,0,0,20,17,0,3
1990,Luna,NM,35029,27,23,0,0,4,1,1,0,0,0,26,22,0,4
1990,McKinley,NM,35031,55,45,2,0,8,4,2,2,0,0,51,43,0,8
1990,Mora,NM,35033,2,2,0,0,0,0,0,0,0,0,2,2,0,0
1990,Otero,NM,35035,137,129,4,0,4,8,4,3,0,1,129,125,1,3
1990,Quay,NM,35037,15,14,0,0,1,1,1,0,0,0,14,13,0,1
1990,Rio Arriba,NM,35039,30,23,0,0,7,3,2,0,0,1,27,21,0,6
1990,Roosevelt,NM,35041,24,23,0,1,0,1,0,0,1,0,23,23,0,0
1990,Sandoval,NM,35043,188,158,2,0,28,9,7,1,0,1,179,151,1,27
1990,San Juan,NM,35045,200,185,6,0,9,17,11,6,0,0,183,174,0,9
1990,San Miguel,NM,35047,37,29,0,0,8,1,1,0,0,0,36,28,0,8
1990,Santa Fe,NM,35049,222,187,4,0,30,26,15,3,1,7,196,172,1,23
1990,Sierra,NM,35051,21,21,0,0,0,0,0,0,0,0,21,21,0,0
1990,Socorro,NM,35053,19,12,0,1,6,5,1,0,1,3,14,11,0,3
1990,Taos,NM,35055,26,18,0,0,8,2,1,0,0,1,24,17,0,7
1990,Torrance,NM,35057,38,33,0,0,5,0,0,0,0,0,38,33,0,5
1990,Union,NM,35059,8,5,0,1,2,2,1,0,1,0,6,4,0,2
1990,Valencia,NM,35061,157,130,3,0,24,12,9,3,0,0,145,121,0,24
1990,Albany,NY,36001,750,543,23,0,184,64,36,21,0,7,686,507,2,177
1990,Allegany,NY,36003,73,57,3,1,12,3,0,2,1,0,70,57,1,12
1990,Bronx,NY,36005,1560,1381,45,0,134,52,8,41,0,3,1508,1373,4,131
1990,Broome,NY,36007,550,348,8,0,194,44,25,8,0,11,506,323,0,183
1990,Cattaraugus,NY,36009,154,116,3,0,35,3,1,2,0,0,151,115,1,35
1990,Cayuga,NY,36011,220,212,1,1,6,15,12,1,1,1,205,200,0,5
1990,Chautauqua,NY,36013,390,243,2,0,145,4,1,2,0,1,386,242,0,144
1990,Chemung,NY,36015,224,150,1,0,73,2,1,1,0,0,222,149,0,73
1990,Chenango,NY,36017,110,95,1,0,14,10,8,1,0,1,100,87,0,13
1990,Clinton,NY,36019,127,126,0,0,1,13,12,0,0,1,114,114,0,0
1990,Columbia,NY,36021,98,78,9,2,9,13,3,7,2,1,85,75,2,8
1990,Cortland,NY,36023,103,91,0,0,12,14,10,0,0,4,89,81,0,8
1990,Delaware,NY,36025,74,60,0,3,11,15,10,0,3,2,59,50,0,9
1990,Dutchess,NY,36027,520,471,15,0,34,38,24,12,0,2,482,447,3,32
1990,Erie,NY,36029,2446,1338,47,0,1061,76,34,42,0,0,2370,1304,5,1061
1990,Essex,NY,36031,45,37,1,0,7,6,5,1,0,0,39,32,0,7
1990,Franklin,NY,36033,51,50,1,0,0,12,11,1,0,0,39,39,0,0
1990,Fulton,NY,36035,119,97,3,0,19,7,2,3,0,2,112,95,0,17
1990,Genesee,NY,36037,165,113,1,0,51,1,1,0,0,0,164,112,1,51
1990,Greene,NY,36039,74,64,4,0,6,9,5,4,0,0,65,59,0,6
1990,Hamilton,NY,36041,8,5,0,0,3,2,1,0,0,1,6,4,0,2
1990,Herkimer,NY,36043,117,103,1,0,13,6,3,1,0,2,111,100,0,11
1990,Jefferson,NY,36045,262,250,4,1,7,29,24,3,1,1,233,226,1,6
1990,Kings,NY,36047,3064,2546,112,0,406,137,38,95,0,4,2927,2508,17,402
1990,Lewis,NY,36049,26,24,0,0,2,4,3,0,0,1,22,21,0,1
1990,Livingston,NY,36051,129,109,3,0,17,5,2,3,0,0,124,107,0,17
1990,Madison,NY,36053,164,148,0,0,16,9,6,0,0,3,155,142,0,13
1990,Monroe,NY,36055,1871,1375,54,0,442,77,25,51,0,1,1794,1350,3,441
1990,Montgomery,NY,36057,89,68,2,0,19,8,5,2,0,1,81,63,0,18
1990,Nassau,NY,36059,2081,1488,113,0,480,174,80,92,0,2,1907,1408,21,478
1990,New York,NY,36061,2784,1838,728,0,213,843,140,699,0,0,1941,1698,29,214
1990,Niagara,NY,36063,582,419,11,0,152,17,7,10,0,0,565,412,1,152
1990,Oneida,NY,36065,538,484,7,1,46,38,21,7,1,9,500,463,0,37
1990,Onondaga,NY,36067,1271,1150,20,1,100,96,61,19,1,15,1175,1089,1,85
1990,Ontario,NY,36069,230,184,2,0,44,4,3,1,0,0,226,181,1,44
1990,Orange,NY,36071,529,468,13,0,48,32,22,9,0,1,497,446,4,47
1990,Orleans,NY,36073,128,92,5,2,29,8,1,5,2,0,120,91,0,29
1990,Oswego,NY,36075,285,259,4,2,20,17,9,3,2,3,268,250,1,17
1990,Otsego,NY,36077,57,49,2,0,6,13,8,2,0,3,44,41,0,3
1990,Putnam,NY,36079,111,91,8,0,12,10,3,7,0,0,101,88,1,12
1990,Queens,NY,36081,3019,2447,90,0,482,118,42,74,0,2,2901,2405,16,480
1990,Rensselaer,NY,36083,393,269,11,0,113,23,10,10,0,3,370,259,1,110
1990,Richmond,NY,36085,707,575,23,0,109,20,6,14,0,0,687,569,9,109
1990,Rockland,NY,36087,323,250,18,0,55,21,6,15,0,0,302,244,3,55
1990,St. Lawrence,NY,36089,160,159,0,0,1,16,15,0,0,1,144,144,0,0
1990,Saratoga,NY,36091,501,406,16,0,79,59,38,16,0,5,442,368,0,74
1990,Schenectady,NY,36093,389,287,11,0,91,39,22,11,0,6,350,265,0,85
1990,Schoharie,NY,36095,44,32,4,0,8,7,4,3,0,0,37,28,1,8
1990,Schuyler,NY,36097,31,19,1,0,11,1,0,1,0,0,30,19,0,11
1990,Seneca,NY,36099,57,51,1,0,5,2,1,1,0,0,55,50,0,5
1990,Steuben,NY,36101,178,139,4,5,30,9,0,4,5,0,169,139,0,30
1990,Suffolk,NY,36103,3107,2265,116,0,726,177,86,90,0,1,2930,2179,26,725
1990,Sullivan,NY,36105,123,105,7,0,11,11,4,7,0,0,112,101,0,11
1990,Tioga,NY,36107,109,50,0,0,59,10,4,0,0,6,99,46,0,53
1990,Tompkins,NY,36109,70,63,1,1,5,9,7,1,1,0,61,56,0,5
1990,Ulster,NY,36111,323,288,9,0,26,27,17,8,0,2,296,271,1,24
1990,Warren,NY,36113,144,130,1,0,13,11,7,1,0,3,133,123,0,10
1990,Washington,NY,36115,117,98,2,1,16,11,7,2,1,1,106,91,0,15
1990,Wayne,NY,36117,201,168,7,0,26,8,2,6,0,0,193,166,1,26
1990,Westchester,NY,36119,1016,795,100,0,121,104,23,81,0,0,912,772,19,121
1990,Wyoming,NY,36121,84,57,0,0,27,0,0,0,0,0,84,57,0,27
1990,Yates,NY,36123,38,25,1,0,12,1,0,1,0,0,37,25,0,12
1990,Alamance,NC,37001,249,69,7,0,173,28,11,7,0,10,221,58,0,163
1990,Alexander,NC,37003,28,10,0,0,18,0,0,0,0,0,28,10,0,18
1990,Alleghany,NC,37005,7,6,0,1,0,1,0,0,1,0,6,6,0,0
1990,Anson,NC,37007,48,2,3,0,43,4,0,3,0,1,44,2,0,42
1990,Ashe,NC,37009,26,19,1,0,6,2,0,1,0,1,24,19,0,5
1990,Avery,NC,37011,22,11,1,0,10,2,1,1,0,0,20,10,0,10
1990,Beaufort,NC,37013,32,21,1,1,9,3,1,1,1,0,29,20,0,9
1990,Bertie,NC,37015,17,10,0,1,6,1,0,0,1,0,16,10,0,6
1990,Bladen,NC,37017,20,8,3,0,9,4,1,2,0,1,16,7,1,8
1990,Brunswick,NC,37019,70,43,1,2,24,21,10,1,2,8,49,33,0,16
1990,Buncombe,NC,37021,266,135,10,1,120,28,13,9,1,5,238,122,1,115
1990,Burke,NC,37023,80,23,0,0,57,5,1,0,0,4,75,22,0,53
1990,Cabarrus,NC,37025,156,47,2,0,107,9,6,2,0,1,147,41,0,106
1990,Caldwell,NC,37027,70,21,1,0,48,5,3,1,0,1,65,18,0,47
1990,Camden,NC,37029,8,5,0,0,3,0,0,0,0,0,8,5,0,3
1990,Carteret,NC,37031,103,77,5,0,21,21,14,5,0,2,82,63,0,19
1990,Caswell,NC,37033,24,11,1,0,12,3,2,1,0,0,21,9,0,12
1990,Catawba,NC,37035,218,59,1,0,158,16,13,1,0,2,202,46,0,156
1990,Chatham,NC,37037,97,14,3,0,80,7,2,3,0,2,90,12,0,78
1990,Cherokee,NC,37039,34,24,0,0,10,3,3,0,0,0,31,21,0,10
1990,Chowan,NC,37041,9,2,0,2,5,2,0,0,2,0,7,2,0,5
1990,Clay,NC,37043,10,6,0,0,4,1,1,0,0,0,9,5,0,4
1990,Cleveland,NC,37045,216,8,0,1,207,3,0,0,1,2,213,8,0,205
1990,Columbus,NC,37047,29,11,1,0,17,3,2,0,0,1,26,9,1,16
1990,Craven,NC,37049,169,101,1,2,65,16,4,1,2,9,153,97,0,56
1990,Cumberland,NC,37051,677,422,11,2,242,59,30,11,2,16,618,392,0,226
1990,Currituck,NC,37053,25,23,1,0,1,4,3,1,0,0,21,20,0,1
1990,Dare,NC,37055,43,35,5,0,3,25,19,5,0,1,18,16,0,2
1990,Davidson,NC,37057,195,61,4,0,130,24,15,4,0,5,171,46,0,125
1990,Davie,NC,37059,35,16,1,0,18,4,2,1,0,1,31,14,0,17
1990,Duplin,NC,37061,32,9,2,2,19,7,2,2,2,1,25,7,0,18
1990,Durham,NC,37063,439,52,9,0,378,37,11,9,0,17,402,41,0,361
1990,Edgecombe,NC,37065,126,27,2,0,97,7,3,2,0,2,119,24,0,95
1990,Forsyth,NC,37067,481,215,14,0,252,81,54,14,0,13,400,161,0,239
1990,Franklin,NC,37069,89,41,1,0,47,13,4,1,0,8,76,37,0,39
1990,Gaston,NC,37071,541,61,4,0,476,15,7,4,0,4,526,54,0,472
1990,Gates,NC,37073,14,9,1,0,4,1,0,1,0,0,13,9,0,4
1990,Graham,NC,37075,13,7,1,0,5,1,0,1,0,0,12,7,0,5
1990,Granville,NC,37077,121,11,1,0,109,3,1,1,0,1,118,10,0,108
1990,Greene,NC,37079,14,3,0,0,11,1,0,0,0,1,13,3,0,10
1990,Guilford,NC,37081,818,260,18,0,540,110,67,18,0,25,708,193,0,515
1990,Halifax,NC,37083,55,20,0,0,35,2,1,0,0,1,53,19,0,34
1990,Harnett,NC,37085,112,51,7,0,54,11,2,6,0,3,101,49,1,51
1990,Haywood,NC,37087,80,57,2,0,21,6,4,2,0,0,74,53,0,21
1990,Henderson,NC,37089,92,47,8,0,37,15,6,8,0,1,77,41,0,36
1990,Hertford,NC,37091,25,9,0,0,16,4,3,0,0,1,21,6,0,15
1990,Hoke,NC,37093,63,6,0,0,57,5,0,0,0,5,58,6,0,52
1990,Hyde,NC,37095,6,1,1,0,4,1,0,1,0,0,5,1,0,4
1990,Iredell,NC,37097,225,68,0,0,157,5,5,0,0,0,220,63,0,157
1990,Jackson,NC,37099,16,13,1,0,2,1,0,1,0,0,15,13,0,2
1990,Johnston,NC,37101,150,69,4,0,77,17,9,4,0,4,133,60,0,73
1990,Jones,NC,37103,16,3,2,0,11,4,1,2,0,1,12,2,0,10
1990,Lee,NC,37105,127,17,3,0,107,10,4,3,0,3,117,13,0,104
1990,Lenoir,NC,37107,89,50,1,0,38,9,4,1,0,4,80,46,0,34
1990,Lincoln,NC,37109,134,21,1,0,112,7,4,1,0,2,127,17,0,110
1990,McDowell,NC,37111,43,10,1,0,32,2,1,1,0,0,41,9,0,32
1990,Macon,NC,37113,32,19,3,0,10,5,2,3,0,0,27,17,0,10
1990,Madison,NC,37115,11,6,0,0,5,0,0,0,0,0,11,6,0,5
1990,Martin,NC,37117,23,9,0,1,13,2,1,0,1,0,21,8,0,13
1990,Mecklenburg,NC,37119,1073,461,42,0,570,82,37,39,0,6,991,424,3,564
1990,Mitchell,NC,37121,22,6,0,0,16,1,1,0,0,0,21,5,0,16
1990,Montgomery,NC,37123,38,6,0,0,32,4,1,0,0,3,34,5,0,29
1990,Moore,NC,37125,175,34,7,0,134,24,9,7,0,8,151,25,0,126
1990,Nash,NC,37127,128,47,3,0,78,13,6,3,0,4,115,41,0,74
1990,New Hanover,NC,37129,183,133,5,0,45,36,23,5,0,8,147,110,0,37
1990,Northampton,NC,37131,17,5,0,3,9,4,0,0,3,1,13,5,0,8
1990,Onslow,NC,37133,403,219,7,0,177,24,9,7,0,8,379,210,0,169
1990,Orange,NC,37135,146,37,6,0,103,17,8,6,0,3,129,29,0,100
1990,Pamlico,NC,37137,12,3,0,0,9,1,0,0,0,1,11,3,0,8
1990,Pasquotank,NC,37139,60,52,1,1,6,9,7,1,1,0,51,45,0,6
1990,Pender,NC,37141,28,17,3,2,6,9,3,3,2,1,19,14,0,5
1990,Perquimans,NC,37143,20,19,0,0,1,2,2,0,0,0,18,17,0,1
1990,Person,NC,37145,46,6,0,0,40,3,2,0,0,1,43,4,0,39
1990,Pitt,NC,37147,181,77,7,0,97,29,11,7,0,11,152,66,0,86
1990,Polk,NC,37149,8,2,0,0,6,0,0,0,0,0,8,2,0,6
1990,Randolph,NC,37151,215,48,0,0,167,11,6,0,0,5,204,42,0,162
1990,Richmond,NC,37153,119,5,2,0,112,7,0,2,0,5,112,5,0,107
1990,Robeson,NC,37155,133,39,0,3,91,17,4,0,3,10,116,35,0,81
1990,Rockingham,NC,37157,183,48,1,1,133,10,4,1,1,4,173,44,0,129
1990,Rowan,NC,37159,169,56,3,2,108,17,9,3,2,3,152,47,0,105
1990,Rutherford,NC,37161,61,6,2,0,53,4,1,2,0,1,57,5,0,52
1990,Sampson,NC,37163,53,24,1,0,28,9,5,1,0,3,44,19,0,25
1990,Scotland,NC,37165,109,16,3,0,90,7,1,3,0,3,102,15,0,87
1990,Stanly,NC,37167,74,29,1,0,44,10,5,1,0,4,64,24,0,40
1990,Stokes,NC,37169,46,20,0,0,26,6,4,0,0,2,40,16,0,24
1990,Surry,NC,37171,85,25,7,0,53,12,3,7,0,2,73,22,0,51
1990,Swain,NC,37173,11,6,2,0,3,2,0,2,0,0,9,6,0,3
1990,Transylvania,NC,37175,22,9,2,0,11,4,2,2,0,0,18,7,0,11
1990,Tyrrell,NC,37177,5,3,0,2,0,2,0,0,2,0,3,3,0,0
1990,Union,NC,37179,244,38,7,1,198,20,3,7,1,9,224,35,0,189
1990,Vance,NC,37181,107,24,0,0,83,2,0,0,0,2,105,24,0,81
1990,Wake,NC,37183,912,557,28,1,326,137,73,24,1,39,775,484,4,287
1990,Warren,NC,37185,30,11,0,0,19,5,2,0,0,3,25,9,0,16
1990,Washington,NC,37187,17,13,0,0,4,1,1,0,0,0,16,12,0,4
1990,Watauga,NC,37189,37,15,1,0,21,10,4,1,0,5,27,11,0,16
1990,Wayne,NC,37191,180,92,2,0,86,10,3,1,0,6,170,89,1,80
1990,Wilkes,NC,37193,70,44,1,0,25,7,5,1,0,1,63,39,0,24
1990,Wilson,NC,37195,107,44,0,0,63,1,1,0,0,0,106,43,0,63
1990,Yadkin,NC,37197,27,16,0,0,11,6,6,0,0,0,21,10,0,11
1990,Yancey,NC,37199,14,5,0,0,9,0,0,0,0,0,14,5,0,9
1990,Adams,ND,38001,13,5,3,2,3,10,2,3,2,3,3,3,0,0
1990,Barnes,ND,38003,20,15,0,2,3,7,2,0,2,3,13,13,0,0
1990,Benson,ND,38005,11,10,0,1,0,1,0,0,1,0,10,10,0,0
1990,Bottineau,ND,38009,5,5,0,0,0,0,0,0,0,0,5,5,0,0
1990,Bowman,ND,38011,10,6,1,1,2,6,2,1,1,2,4,4,0,0
1990,Burke,ND,38013,2,2,0,0,0,1,1,0,0,0,1,1,0,0
1990,Burleigh,ND,38015,118,111,0,0,7,16,13,0,0,3,102,98,0,4
1990,Cass,ND,38017,227,201,8,3,15,36,25,8,3,0,191,176,0,15
1990,Cavalier,ND,38019,6,5,0,0,1,1,1,0,0,0,5,4,0,1
1990,Dickey,ND,38021,4,2,0,2,0,2,0,0,2,0,2,2,0,0
1990,Divide,ND,38023,3,1,0,1,1,3,1,0,1,1,0,0,0,0
1990,Dunn,ND,38025,6,4,0,1,1,3,1,0,1,1,3,3,0,0
1990,Eddy,ND,38027,5,4,0,1,0,2,1,0,1,0,3,3,0,0
1990,Emmons,ND,38029,1,1,0,0,0,0,0,0,0,0,1,1,0,0
1990,Foster,ND,38031,7,7,0,0,0,1,1,0,0,0,6,6,0,0
1990,Golden Valley,ND,38033,4,4,0,0,0,2,2,0,0,0,2,2,0,0
1990,Grand Forks,ND,38035,156,146,6,0,4,20,14,6,0,0,136,132,0,4
1990,Grant,ND,38037,3,1,0,2,0,3,1,0,2,0,0,0,0,0
1990,Griggs,ND,38039,1,0,0,0,0,1,0,0,1,0,0,0,0,0
1990,Hettinger,ND,38041,12,3,0,8,1,9,0,0,8,1,3,3,0,0
1990,Kidder,ND,38043,3,2,1,0,0,1,0,1,0,0,2,2,0,0
1990,LaMoure,ND,38045,4,4,0,0,0,0,0,0,0,0,4,4,0,0
1990,Logan,ND,38047,7,6,0,1,0,4,3,0,1,0,3,3,0,0
1990,McHenry,ND,38049,12,10,0,1,1,3,1,0,1,1,9,9,0,0
1990,McIntosh,ND,38051,3,3,0,0,0,2,2,0,0,0,1,1,0,0
1990,McKenzie,ND,38053,6,6,0,0,0,1,1,0,0,0,5,5,0,0
1990,McLean,ND,38055,16,15,1,0,0,3,2,1,0,0,13,13,0,0
1990,Mercer,ND,38057,11,9,0,2,0,4,2,0,2,0,7,7,0,0
1990,Morton,ND,38059,52,42,1,3,6,7,2,1,3,1,45,40,0,5
1990,Mountrail,ND,38061,5,4,1,0,0,2,1,1,0,0,3,3,0,0
1990,Nelson,ND,38063,3,3,0,0,0,0,0,0,0,0,3,3,0,0
1990,Oliver,ND,38065,3,3,0,0,0,0,0,0,0,0,3,3,0,0
1990,Pembina,ND,38067,7,7,0,0,0,0,0,0,0,0,7,7,0,0
1990,Pierce,ND,38069,5,5,0,0,0,0,0,0,0,0,5,5,0,0
1990,Ramsey,ND,38071,20,19,0,1,0,3,2,0,1,0,17,17,0,0
1990,Ransom,ND,38073,9,7,0,1,1,1,0,0,1,0,8,7,0,1
1990,Renville,ND,38075,3,3,0,0,0,1,1,0,0,0,2,2,0,0
1990,Richland,ND,38077,27,25,0,1,1,4,3,0,1,0,23,22,0,1
1990,Rolette,ND,38079,6,6,0,0,0,1,1,0,0,0,5,5,0,0
1990,Sargent,ND,38081,8,7,0,0,1,1,1,0,0,0,7,6,0,1
1990,Sheridan,ND,38083,4,2,0,2,0,2,0,0,2,0,2,2,0,0
1990,Sioux,ND,38085,3,3,0,0,0,0,0,0,0,0,3,3,0,0
1990,Stark,ND,38089,43,35,1,4,3,12,5,1,4,2,31,30,0,1
1990,Steele,ND,38091,1,1,0,0,0,0,0,0,0,0,1,1,0,0
1990,Stutsman,ND,38093,21,20,0,0,1,5,4,0,0,1,16,16,0,0
1990,Towner,ND,38095,6,6,0,0,0,2,2,0,0,0,4,4,0,0
1990,Traill,ND,38097,2,2,0,0,0,0,0,0,0,0,2,2,0,0
1990,Walsh,ND,38099,20,20,0,0,0,2,2,0,0,0,18,18,0,0
1990,Ward,ND,38101,112,108,1,1,2,9,7,1,1,0,103,101,0,2
1990,Wells,ND,38103,10,8,0,2,0,6,4,0,2,0,4,4,0,0
1990,Williams,ND,38105,31,30,0,1,0,6,5,0,1,0,25,25,0,0
1990,Adams,OH,39001,53,49,0,0,4,6,5,0,0,1,47,44,0,3
1990,Allen,OH,39003,299,280,3,1,15,28,20,3,1,4,271,260,0,11
1990,Ashland,OH,39005,115,94,0,1,20,4,3,0,1,0,111,91,0,20
1990,Ashtabula,OH,39007,419,391,1,1,26,18,12,1,1,4,401,379,0,22
1990,Athens,OH,39009,84,71,1,0,12,1,0,1,0,0,83,71,0,12
1990,Auglaize,OH,39011,77,69,2,0,6,8,6,2,0,0,69,63,0,6
1990,Belmont,OH,39013,133,129,2,0,2,3,2,1,0,0,130,127,1,2
1990,Brown,OH,39015,142,125,0,0,17,8,7,0,0,1,134,118,0,16
1990,Butler,OH,39017,1399,1190,14,1,194,84,61,14,1,8,1315,1129,0,186
1990,Carroll,OH,39019,78,64,0,0,14,2,2,0,0,0,76,62,0,14
1990,Champaign,OH,39021,104,93,0,0,11,0,0,0,0,0,104,93,0,11
1990,Clark,OH,39023,648,526,1,0,121,6,5,1,0,0,642,521,0,121
1990,Clermont,OH,39025,756,661,4,0,91,35,28,3,0,4,721,633,1,87
1990,Clinton,OH,39027,112,85,1,2,24,3,0,1,2,0,109,85,0,24
1990,Columbiana,OH,39029,327,246,2,0,79,15,10,2,0,3,312,236,0,76
1990,Coshocton,OH,39031,109,90,1,3,15,4,0,1,3,0,105,90,0,15
1990,Crawford,OH,39033,171,155,1,0,15,11,9,1,0,1,160,146,0,14
1990,Cuyahoga,OH,39035,4784,3213,59,0,1512,101,40,57,0,4,4683,3173,2,1508
1990,Darke,OH,39037,184,115,2,0,67,2,0,2,0,0,182,115,0,67
1990,Defiance,OH,39039,79,69,1,0,9,5,2,1,0,2,74,67,0,7
1990,Delaware,OH,39041,238,144,1,3,90,4,0,1,3,0,234,144,0,90
1990,Erie,OH,39043,249,241,0,0,8,12,10,0,0,2,237,231,0,6
1990,Fairfield,OH,39045,314,238,1,0,74,3,2,0,1,0,311,236,1,74
1990,Fayette,OH,39047,130,98,0,3,29,4,1,0,3,0,126,97,0,29
1990,Franklin,OH,39049,4849,3193,259,1,1396,288,30,257,1,0,4561,3163,2,1396
1990,Fulton,OH,39051,90,81,0,1,8,8,6,0,1,1,82,75,0,7
1990,Gallia,OH,39053,80,65,0,1,14,1,0,0,1,0,79,65,0,14
1990,Geauga,OH,39055,139,121,4,0,14,7,3,4,0,0,132,118,0,14
1990,Greene,OH,39057,498,286,3,0,209,5,3,1,0,1,493,283,2,208
1990,Guernsey,OH,39059,129,111,1,0,17,2,1,1,0,0,127,110,0,17
1990,Hamilton,OH,39061,4060,3083,123,0,854,337,189,122,0,26,3723,2894,1,828
1990,Hancock,OH,39063,188,171,1,2,14,13,8,1,2,2,175,163,0,12
1990,Hardin,OH,39065,86,80,0,2,4,7,5,0,2,0,79,75,0,4
1990,Harrison,OH,39067,35,32,0,0,3,2,2,0,0,0,33,30,0,3
1990,Henry,OH,39069,67,64,0,0,3,4,3,0,0,1,63,61,0,2
1990,Highland,OH,39071,118,105,0,0,13,9,8,0,0,1,109,97,0,12
1990,Hocking,OH,39073,113,91,0,0,22,0,0,0,0,0,113,91,0,22
1990,Holmes,OH,39075,45,39,0,1,5,2,0,0,1,1,43,39,0,4
1990,Huron,OH,39077,177,167,1,1,8,11,8,1,1,1,166,159,0,7
1990,Jackson,OH,39079,106,90,0,0,16,0,0,0,0,0,106,90,0,16
1990,Jefferson,OH,39081,186,179,1,0,6,2,1,1,0,0,184,178,0,6
1990,Knox,OH,39083,147,136,0,1,10,1,0,0,1,0,146,136,0,10
1990,Lake,OH,39085,533,465,5,0,63,14,9,5,0,0,519,456,0,63
1990,Lawrence,OH,39087,133,123,0,0,10,4,3,0,0,1,129,120,0,9
1990,Licking,OH,39089,429,316,2,3,108,4,0,1,3,0,425,316,1,108
1990,Logan,OH,39091,126,101,1,0,24,1,0,1,0,0,125,101,0,24
1990,Lorain,OH,39093,733,634,2,0,97,3,3,0,0,0,730,631,2,97
1990,Lucas,OH,39095,1836,1561,29,0,246,113,72,27,0,14,1723,1489,2,232
1990,Madison,OH,39097,169,121,1,0,47,1,0,1,0,0,168,121,0,47
1990,Mahoning,OH,39099,718,485,14,1,218,46,23,14,1,8,672,462,0,210
1990,Marion,OH,39101,313,297,0,1,15,11,10,0,1,0,302,287,0,15
1990,Medina,OH,39103,289,250,1,2,36,11,8,1,2,0,278,242,0,36
1990,Meigs,OH,39105,66,61,0,0,5,0,0,0,0,0,66,61,0,5
1990,Mercer,OH,39107,45,44,0,0,1,4,4,0,0,0,41,40,0,1
1990,Miami,OH,39109,327,210,1,1,115,5,3,1,1,0,322,207,0,115
1990,Monroe,OH,39111,18,17,0,0,1,0,0,0,0,0,18,17,0,1
1990,Montgomery,OH,39113,3142,1436,41,0,1665,64,28,33,0,3,3078,1408,8,1662
1990,Morgan,OH,39115,18,17,0,0,1,1,1,0,0,0,17,16,0,1
1990,Morrow,OH,39117,128,85,0,1,42,1,0,0,1,0,127,85,0,42
1990,Muskingum,OH,39119,262,244,1,0,17,2,2,0,0,0,260,242,1,17
1990,Noble,OH,39121,21,15,0,0,6,0,0,0,0,0,21,15,0,6
1990,Ottawa,OH,39123,102,94,1,0,7,3,2,1,0,0,99,92,0,7
1990,Paulding,OH,39125,44,37,0,5,2,8,3,0,5,0,36,34,0,2
1990,Perry,OH,39127,80,63,1,1,15,2,0,1,1,0,78,63,0,15
1990,Pickaway,OH,39129,206,162,1,0,43,0,0,0,0,0,206,162,1,43
1990,Pike,OH,39131,64,60,1,0,3,1,0,1,0,0,63,60,0,3
1990,Portage,OH,39133,521,472,4,0,45,23,17,2,0,4,498,455,2,41
1990,Preble,OH,39135,164,101,0,1,62,3,1,0,1,1,161,100,0,61
1990,Putnam,OH,39137,38,35,0,0,3,3,3,0,0,0,35,32,0,3
1990,Richland,OH,39139,501,400,2,0,99,23,19,2,0,2,478,381,0,97
1990,Ross,OH,39141,220,175,0,0,45,0,0,0,0,0,220,175,0,45
1990,Sandusky,OH,39143,139,119,3,2,15,11,4,3,2,2,128,115,0,13
1990,Scioto,OH,39145,182,171,1,0,10,14,11,1,0,2,168,160,0,8
1990,Seneca,OH,39147,120,113,0,2,5,11,9,0,2,0,109,104,0,5
1990,Shelby,OH,39149,110,82,3,0,25,3,0,3,0,0,107,82,0,25
1990,Stark,OH,39151,1282,1015,7,0,260,77,55,7,0,15,1205,960,0,245
1990,Summit,OH,39153,1924,1478,14,0,432,107,65,11,0,31,1817,1413,3,401
1990,Trumbull,OH,39155,738,603,14,1,120,39,18,13,1,7,699,585,1,113
1990,Tuscarawas,OH,39157,202,180,2,0,20,14,10,2,0,2,188,170,0,18
1990,Union,OH,39159,153,117,0,2,34,2,0,0,2,0,151,117,0,34
1990,Van Wert,OH,39161,65,62,0,1,2,1,0,0,1,0,64,62,0,2
1990,Vinton,OH,39163,28,22,0,0,6,0,0,0,0,0,28,22,0,6
1990,Warren,OH,39165,472,366,6,0,100,22,16,5,0,1,450,350,1,99
1990,Washington,OH,39167,146,123,5,0,18,6,2,4,0,0,140,121,1,18
1990,Wayne,OH,39169,293,253,1,0,39,14,12,1,0,1,279,241,0,38
1990,Williams,OH,39171,109,100,2,0,7,6,2,2,0,2,103,98,0,5
1990,Wood,OH,39173,325,296,5,2,21,33,24,4,2,2,292,272,1,19
1990,Wyandot,OH,39175,52,52,0,0,0,2,2,0,0,0,50,50,0,0
1990,Adair,OK,40001,26,25,0,0,1,5,5,0,0,0,21,20,0,1
1990,Alfalfa,OK,40003,8,8,0,0,0,1,1,0,0,0,7,7,0,0
1990,Atoka,OK,40005,14,12,0,2,0,4,2,0,2,0,10,10,0,0
1990,Beaver,OK,40007,9,5,0,3,1,5,2,0,3,0,4,3,0,1
1990,Beckham,OK,40009,50,47,0,2,1,7,5,0,2,0,43,42,0,1
1990,Blaine,OK,40011,35,32,0,1,2,7,6,0,1,0,28,26,0,2
1990,Bryan,OK,40013,66,52,1,8,5,16,7,1,8,0,50,45,0,5
1990,Caddo,OK,40015,81,72,2,2,5,10,6,2,2,0,71,66,0,5
1990,Canadian,OK,40017,435,374,2,1,58,41,34,2,1,4,394,340,0,54
1990,Carter,OK,40019,188,152,4,0,32,29,22,4,0,3,159,130,0,29
1990,Cherokee,OK,40021,90,83,0,0,7,7,7,0,0,0,83,76,0,7
1990,Choctaw,OK,40023,10,7,1,0,2,2,1,1,0,0,8,6,0,2
1990,Cleveland,OK,40027,963,817,7,0,139,66,50,5,0,11,897,767,2,128
1990,Coal,OK,40029,10,9,0,0,1,0,0,0,0,0,10,9,0,1
1990,Comanche,OK,40031,709,570,1,0,138,44,35,1,0,8,665,535,0,130
1990,Cotton,OK,40033,18,15,0,1,2,4,3,0,1,0,14,12,0,2
1990,Craig,OK,40035,39,39,0,0,0,6,6,0,0,0,33,33,0,0
1990,Creek,OK,40037,331,294,12,0,25,51,35,12,0,4,280,259,0,21
1990,Custer,OK,40039,87,82,1,0,4,7,6,1,0,0,80,76,0,4
1990,Delaware,OK,40041,53,50,0,0,3,15,14,0,0,1,38,36,0,2
1990,Dewey,OK,40043,11,10,0,1,0,3,2,0,1,0,8,8,0,0
1990,Ellis,OK,40045,12,12,0,0,0,3,3,0,0,0,9,9,0,0
1990,Garfield,OK,40047,241,233,0,0,8,17,17,0,0,0,224,216,0,8
1990,Garvin,OK,40049,100,89,0,0,11,12,12,0,0,0,88,77,0,11
1990,Grady,OK,40051,160,142,1,3,14,23,19,1,3,0,137,123,0,14
1990,Grant,OK,40053,12,11,0,0,1,2,2,0,0,0,10,9,0,1
1990,Greer,OK,40055,20,19,1,0,0,5,4,1,0,0,15,15,0,0
1990,Harmon,OK,40057,5,5,0,0,0,0,0,0,0,0,5,5,0,0
1990,Harper,OK,40059,6,5,0,1,0,1,0,0,1,0,5,5,0,0
1990,Haskell,OK,40061,19,18,0,0,1,3,2,0,0,1,16,16,0,0
1990,Hughes,OK,40063,24,21,0,0,3,2,2,0,0,0,22,19,0,3
1990,Jackson,OK,40065,121,99,1,7,14,11,3,1,7,0,110,96,0,14
1990,Jefferson,OK,40067,11,10,0,0,1,3,2,0,0,1,8,8,0,0
1990,Johnston,OK,40069,17,14,0,1,2,3,1,0,1,1,14,13,0,1
1990,Kay,OK,40071,148,139,1,1,7,11,9,1,1,0,137,130,0,7
1990,Kingfisher,OK,40073,52,49,0,2,1,6,4,0,2,0,46,45,0,1
1990,Kiowa,OK,40075,30,27,1,1,1,8,6,1,1,0,22,21,0,1
1990,Latimer,OK,40077,20,20,0,0,0,1,1,0,0,0,19,19,0,0
1990,Le Flore,OK,40079,149,139,2,0,8,15,10,2,0,3,134,129,0,5
1990,Lincoln,OK,40081,121,115,0,0,6,9,9,0,0,0,112,106,0,6
1990,Logan,OK,40083,126,112,3,1,10,8,3,3,1,1,118,109,0,9
1990,Love,OK,40085,16,10,0,0,6,3,2,0,0,1,13,8,0,5
1990,McClain,OK,40087,119,109,0,1,9,13,12,0,1,0,106,97,0,9
1990,McCurtain,OK,40089,30,27,0,3,0,8,5,0,3,0,22,22,0,0
1990,McIntosh,OK,40091,35,32,2,0,1,6,4,2,0,0,29,28,0,1
1990,Major,OK,40093,30,28,0,1,1,7,6,0,1,0,23,22,0,1
1990,Marshall,OK,40095,31,23,0,0,8,3,2,0,0,1,28,21,0,7
1990,Mayes,OK,40097,143,133,2,0,8,26,23,2,0,1,117,110,0,7
1990,Murray,OK,40099,40,35,0,0,5,5,4,0,0,1,35,31,0,4
1990,Muskogee,OK,40101,316,301,6,1,8,23,15,6,1,1,293,286,0,7
1990,Noble,OK,40103,42,39,0,0,3,2,2,0,0,0,40,37,0,3
1990,Nowata,OK,40105,24,22,0,0,2,4,3,0,0,1,20,19,0,1
1990,Okfuskee,OK,40107,27,27,0,0,0,1,1,0,0,0,26,26,0,0
1990,Oklahoma,OK,40109,4511,3865,46,0,600,342,274,46,0,22,4169,3591,0,578
1990,Okmulgee,OK,40111,127,100,2,2,23,15,8,2,2,3,112,92,0,20
1990,Osage,OK,40113,142,124,1,0,17,23,20,0,0,3,119,104,1,14
1990,Ottawa,OK,40115,57,55,2,0,0,13,11,2,0,0,44,44,0,0
1990,Pawnee,OK,40117,74,70,1,1,2,11,9,1,1,0,63,61,0,2
1990,Payne,OK,40119,215,200,3,0,12,17,14,3,0,0,198,186,0,12
1990,Pittsburg,OK,40121,109,106,1,0,2,15,14,1,0,0,94,92,0,2
1990,Pontotoc,OK,40123,82,76,5,0,1,12,9,3,0,0,70,67,2,1
1990,Pottawatomie,OK,40125,302,268,2,2,30,30,25,2,2,1,272,243,0,29
1990,Pushmataha,OK,40127,14,12,0,1,1,3,2,0,1,0,11,10,0,1
1990,Roger Mills,OK,40129,8,7,0,0,1,3,2,0,0,1,5,5,0,0
1990,Rogers,OK,40131,225,207,6,0,12,26,17,6,0,3,199,190,0,9
1990,Seminole,OK,40133,98,89,1,1,7,15,11,1,1,2,83,78,0,5
1990,Sequoyah,OK,40135,99,95,2,0,2,5,4,1,0,0,94,91,1,2
1990,Stephens,OK,40137,144,133,0,0,11,16,15,0,0,1,128,118,0,10
1990,Texas,OK,40139,35,34,0,0,1,6,6,0,0,0,29,28,0,1
1990,Tillman,OK,40141,26,19,1,2,4,6,2,1,2,1,20,17,0,3
1990,Tulsa,OK,40143,2911,2631,59,0,221,398,311,59,0,28,2513,2320,0,193
1990,Wagoner,OK,40145,239,223,2,1,13,32,26,2,1,3,207,197,0,10
1990,Washington,OK,40147,172,168,2,0,2,21,19,2,0,0,151,149,0,2
1990,Washita,OK,40149,27,24,2,0,1,2,0,2,0,0,25,24,0,1
1990,Woods,OK,40151,14,11,3,0,0,5,2,3,0,0,9,9,0,0
1990,Woodward,OK,40153,61,56,0,0,5,12,12,0,0,0,49,44,0,5
1990,Baker,OR,41001,34,29,0,0,5,3,0,0,0,3,31,29,0,2
1990,Benton,OR,41003,154,94,4,0,56,11,4,4,0,3,143,90,0,53
1990,Clackamas,OR,41005,1074,748,15,0,311,104,42,13,0,49,970,706,2,262
1990,Clatsop,OR,41007,94,79,2,0,13,8,4,2,0,2,86,75,0,11
1990,Columbia,OR,41009,134,86,2,0,46,6,1,1,0,4,128,85,1,42
1990,Coos,OR,41011,158,131,3,0,24,24,13,3,0,8,134,118,0,16
1990,Crook,OR,41013,53,47,1,0,5,4,2,1,0,1,49,45,0,4
1990,Curry,OR,41015,51,38,3,0,10,8,2,3,0,3,43,36,0,7
1990,Deschutes,OR,41017,282,207,3,0,72,29,10,3,0,16,253,197,0,56
1990,Douglas,OR,41019,483,335,2,0,146,29,11,2,0,16,454,324,0,130
1990,Gilliam,OR,41021,5,2,0,2,1,2,0,0,2,0,3,2,0,1
1990,Grant,OR,41023,13,11,1,0,1,2,0,1,0,1,11,11,0,0
1990,Harney,OR,41025,15,13,0,0,2,3,2,0,0,1,12,11,0,1
1990,Hood River,OR,41027,48,37,1,0,10,5,3,1,0,1,43,34,0,9
1990,Jackson,OR,41029,777,663,3,0,111,69,38,3,0,28,708,625,0,83
1990,Jefferson,OR,41031,29,21,1,0,7,5,2,1,0,2,24,19,0,5
1990,Josephine,OR,41033,246,216,3,0,27,31,20,3,0,8,215,196,0,19
1990,Klamath,OR,41035,242,211,4,3,23,32,21,4,4,3,210,190,0,20
1990,Lake,OR,41037,12,10,0,0,2,1,1,0,0,0,11,9,0,2
1990,Lane,OR,41039,1364,833,7,0,524,103,35,6,0,62,1261,798,1,462
1990,Lincoln,OR,41041,125,96,2,0,27,18,7,2,0,9,107,89,0,18
1990,Linn,OR,41043,458,324,2,0,132,19,8,2,0,9,439,316,0,123
1990,Malheur,OR,41045,80,63,1,6,10,13,5,1,6,1,67,58,0,9
1990,Marion,OR,41047,1029,717,18,3,291,97,33,18,3,43,932,684,0,248
1990,Morrow,OR,41049,30,29,1,0,0,2,1,1,0,0,28,28,0,0
1990,Multnomah,OR,41051,2986,1959,35,0,992,228,89,33,0,106,2758,1870,2,886
1990,Polk,OR,41053,211,144,2,2,63,20,5,2,2,11,191,139,0,52
1990,Sherman,OR,41055,8,5,0,1,2,1,0,0,1,0,7,5,0,2
1990,Tillamook,OR,41057,40,33,0,0,7,4,2,0,0,2,36,31,0,5
1990,Umatilla,OR,41059,267,233,1,5,28,33,21,1,5,6,234,212,0,22
1990,Union,OR,41061,46,34,1,2,8,6,0,1,3,2,40,34,0,6
1990,Wallowa,OR,41063,18,16,1,1,0,3,1,1,1,0,15,15,0,0
1990,Wasco,OR,41065,53,38,0,0,15,4,2,0,0,2,49,36,0,13
1990,Washington,OR,41067,1193,846,19,1,327,106,52,19,1,34,1087,794,0,293
1990,Yamhill,OR,41071,254,193,3,0,58,26,10,3,0,13,228,183,0,45
1990,Adams,PA,42001,101,85,2,0,14,10,7,1,0,2,91,78,1,12
1990,Allegheny,PA,42003,2172,1563,126,0,483,227,102,115,0,10,1945,1461,11,473
1990,Armstrong,PA,42005,63,55,2,0,6,7,4,2,0,1,56,51,0,5
1990,Beaver,PA,42007,255,188,18,0,49,22,2,15,0,5,233,186,3,44
1990,Bedford,PA,42009,39,33,2,0,4,6,3,2,0,1,33,30,0,3
1990,Berks,PA,42011,362,258,21,0,83,42,16,20,0,6,320,242,1,77
1990,Blair,PA,42013,173,159,7,0,7,14,7,7,0,0,159,152,0,7
1990,Bradford,PA,42015,57,50,2,1,4,11,8,2,1,0,46,42,0,4
1990,Bucks,PA,42017,863,546,67,0,250,105,40,61,0,4,758,506,6,246
1990,Butler,PA,42019,197,171,9,0,17,22,12,8,0,2,175,159,1,15
1990,Cambria,PA,42021,95,86,5,0,4,7,3,4,0,0,88,83,1,4
1990,Cameron,PA,42023,5,3,0,0,2,0,0,0,0,0,5,3,0,2
1990,Carbon,PA,42025,69,58,0,0,11,5,4,0,0,1,64,54,0,10
1990,Centre,PA,42027,101,77,6,0,18,19,10,6,0,3,82,67,0,15
1990,Chester,PA,42029,488,329,27,1,131,56,31,21,1,3,432,298,6,128
1990,Clarion,PA,42031,43,38,3,0,2,6,3,3,0,0,37,35,0,2
1990,Clearfield,PA,42033,63,58,2,0,3,5,4,1,0,0,58,54,1,3
1990,Clinton,PA,42035,49,48,1,0,0,4,3,1,0,0,45,45,0,0
1990,Columbia,PA,42037,103,72,7,0,24,17,6,7,0,4,86,66,0,20
1990,Crawford,PA,42039,107,92,7,2,6,12,4,5,2,1,95,88,2,5
1990,Cumberland,PA,42041,344,270,8,0,66,41,25,8,0,8,303,245,0,58
1990,Dauphin,PA,42043,598,402,13,0,183,55,31,10,0,14,543,371,3,169
1990,Delaware,PA,42045,910,408,17,0,485,47,30,16,0,1,863,378,1,484
1990,Elk,PA,42047,25,21,1,0,3,3,2,1,0,0,22,19,0,3
1990,Erie,PA,42049,468,418,20,0,30,53,33,19,0,1,415,385,1,29
1990,Fayette,PA,42051,211,199,4,0,8,13,8,4,0,1,198,191,0,7
1990,Forest,PA,42053,4,4,0,0,0,0,0,0,0,0,4,4,0,0
1990,Franklin,PA,42055,136,106,6,0,24,25,16,5,0,4,111,90,1,20
1990,Fulton,PA,42057,13,12,0,0,1,1,1,0,0,0,12,11,0,1
1990,Greene,PA,42059,62,60,2,0,0,6,4,2,0,0,56,56,0,0
1990,Huntingdon,PA,42061,52,44,0,0,8,9,7,0,0,2,43,37,0,6
1990,Indiana,PA,42063,91,79,6,1,5,18,11,6,1,0,73,68,0,5
1990,Jefferson,PA,42065,35,33,1,0,1,3,2,1,0,0,32,31,0,1
1990,Juniata,PA,42067,28,23,0,0,5,3,2,0,0,1,25,21,0,4
1990,Lackawanna,PA,42069,231,200,21,0,10,42,19,20,0,3,189,181,1,7
1990,Lancaster,PA,42071,519,462,13,0,44,38,26,11,0,1,481,436,2,43
1990,Lawrence,PA,42073,118,97,11,0,10,18,7,10,0,1,100,90,1,9
1990,Lebanon,PA,42075,133,104,7,0,22,25,14,7,0,4,108,90,0,18
1990,Lehigh,PA,42077,455,373,16,0,66,25,9,14,0,2,430,364,2,64
1990,Luzerne,PA,42079,380,313,30,0,37,45,15,28,0,2,335,298,2,35
1990,Lycoming,PA,42081,135,123,2,1,9,14,7,2,1,4,121,116,0,5
1990,Mc Kean,PA,42083,66,58,4,0,4,9,4,4,0,1,57,54,0,3
1990,Mercer,PA,42085,142,135,6,0,1,17,10,6,0,1,125,125,0,0
1990,Mifflin,PA,42087,53,43,4,0,6,10,6,4,0,0,43,37,0,6
1990,Monroe,PA,42089,213,156,19,0,38,46,22,19,0,5,167,134,0,33
1990,Montgomery,PA,42091,842,552,45,0,245,89,42,40,0,7,753,510,5,238
1990,Montour,PA,42093,18,14,0,0,4,0,0,0,0,0,18,14,0,4
1990,Northampton,PA,42095,376,310,12,0,54,23,10,10,0,3,353,300,2,51
1990,Northumberland,PA,42097,114,100,3,2,9,15,10,3,2,0,99,90,0,9
1990,Perry,PA,42099,83,67,1,0,15,8,4,1,0,3,75,63,0,12
1990,Philadelphia,PA,42101,3829,1316,177,0,2336,225,62,156,0,7,3604,1254,21,2329
1990,Pike,PA,42103,55,41,6,0,8,11,5,6,0,0,44,36,0,8
1990,Potter,PA,42105,17,11,1,0,5,2,1,1,0,0,15,10,0,5
1990,Schuylkill,PA,42107,184,168,8,0,8,16,6,8,0,2,168,162,0,6
1990,Snyder,PA,42109,32,25,0,0,7,5,2,0,0,3,27,23,0,4
1990,Somerset,PA,42111,56,53,0,0,3,6,5,0,0,1,50,48,0,2
1990,Sullivan,PA,42113,1,1,0,0,0,0,0,0,0,0,1,1,0,0
1990,Susquehanna,PA,42115,35,26,1,0,8,7,5,1,0,1,28,21,0,7
1990,Tioga,PA,42117,29,24,0,0,5,1,0,0,0,1,28,24,0,4
1990,Union,PA,42119,29,25,0,0,4,3,3,0,0,0,26,22,0,4
1990,Venango,PA,42121,54,47,2,1,4,7,2,2,1,2,47,45,0,2
1990,Warren,PA,42123,62,59,1,0,2,2,1,1,0,0,60,58,0,2
1990,Washington,PA,42125,245,190,16,0,38,33,14,13,0,5,212,176,3,33
1990,Wayne,PA,42127,52,47,1,0,4,13,12,1,0,0,39,35,0,4
1990,Westmoreland,PA,42129,422,367,18,1,36,48,29,17,1,1,374,338,1,35
1990,Wyoming,PA,42131,23,21,1,0,1,3,2,1,0,0,20,19,0,1
1990,York,PA,42133,505,440,18,0,47,73,46,18,0,9,432,394,0,38
1990,Bristol,RI,44001,73,63,3,0,7,16,13,3,0,0,57,50,0,7
1990,Kent,RI,44003,443,395,20,0,28,54,35,18,0,1,389,360,2,27
1990,Newport,RI,44005,194,171,18,0,5,38,21,17,0,0,156,150,1,5
1990,Providence,RI,44007,1397,1235,82,0,80,164,91,71,0,2,1233,1144,11,78
1990,Washington,RI,44009,217,190,13,0,14,45,34,10,0,1,172,156,3,13
1990,Abbeville,SC,45001,22,10,1,0,11,3,1,1,0,1,19,9,0,10
1990,Aiken,SC,45003,231,108,7,0,116,16,8,6,0,2,215,100,1,114
1990,Allendale,SC,45005,6,1,0,0,5,0,0,0,0,0,6,1,0,5
1990,Anderson,SC,45007,214,135,2,0,77,8,6,2,0,0,206,129,0,77
1990,Bamberg,SC,45009,30,3,0,0,27,1,1,0,0,0,29,2,0,27
1990,Barnwell,SC,45011,28,6,2,0,20,2,1,1,0,0,26,5,1,20
1990,Beaufort,SC,45013,146,90,16,0,40,21,6,13,0,2,125,84,3,38
1990,Berkeley,SC,45015,193,72,3,0,118,8,1,2,0,5,185,71,1,113
1990,Calhoun,SC,45017,19,6,0,0,13,1,1,0,0,0,18,5,0,13
1990,Charleston,SC,45019,559,249,18,0,292,52,21,13,0,18,507,228,5,274
1990,Cherokee,SC,45021,71,30,2,0,39,2,0,1,0,1,69,30,1,38
1990,Chester,SC,45023,45,26,1,0,18,3,3,0,0,0,42,23,1,18
1990,Chesterfield,SC,45025,85,16,0,0,69,0,0,0,0,0,85,16,0,69
1990,Clarendon,SC,45027,19,6,0,0,13,2,2,0,0,0,17,4,0,13
1990,Colleton,SC,45029,51,13,3,0,35,5,0,3,0,2,46,13,0,33
1990,Darlington,SC,45031,83,34,4,0,45,8,2,4,0,2,75,32,0,43
1990,Dillon,SC,45033,19,9,0,0,10,0,0,0,0,0,19,9,0,10
1990,Dorchester,SC,45035,160,66,3,0,91,8,5,3,0,0,152,61,0,91
1990,Edgefield,SC,45037,18,10,0,0,8,3,3,0,0,0,15,7,0,8
1990,Fairfield,SC,45039,35,11,0,0,24,2,2,0,0,0,33,9,0,24
1990,Florence,SC,45041,182,76,15,0,91,13,4,8,0,1,169,72,7,90
1990,Georgetown,SC,45043,58,26,1,0,31,4,3,0,0,1,54,23,1,30
1990,Greenville,SC,45045,454,323,18,0,113,30,14,14,0,2,424,309,4,111
1990,Greenwood,SC,45047,65,38,1,0,26,1,1,0,0,0,64,37,1,26
1990,Hampton,SC,45049,10,2,3,0,5,2,0,2,0,0,8,2,1,5
1990,Horry,SC,45051,220,173,16,1,29,48,31,15,1,1,172,142,1,29
1990,Jasper,SC,45053,21,8,2,0,11,2,1,1,0,0,19,7,1,11
1990,Kershaw,SC,45055,102,41,3,0,58,8,5,3,0,0,94,36,0,58
1990,Lancaster,SC,45057,64,41,1,0,22,1,0,1,0,0,63,41,0,22
1990,Laurens,SC,45059,63,39,0,0,24,1,1,0,0,0,62,38,0,24
1990,Lee,SC,45061,15,4,1,0,10,2,0,1,0,1,13,4,0,9
1990,Lexington,SC,45063,321,163,16,0,142,29,13,12,0,4,292,150,4,138
1990,McCormick,SC,45065,6,5,0,0,1,1,1,0,0,0,5,4,0,1
1990,Marion,SC,45067,23,14,1,0,8,1,0,1,0,0,22,14,0,8
1990,Marlboro,SC,45069,39,11,0,0,28,1,1,0,0,0,38,10,0,28
1990,Newberry,SC,45071,42,12,0,0,30,0,0,0,0,0,42,12,0,30
1990,Oconee,SC,45073,59,38,1,0,20,6,5,1,0,0,53,33,0,20
1990,Orangeburg,SC,45075,198,47,5,0,146,8,3,5,0,0,190,44,0,146
1990,Pickens,SC,45077,87,66,2,0,19,5,3,2,0,0,82,63,0,19
1990,Richland,SC,45079,657,269,23,0,365,40,16,19,0,5,617,253,4,360
1990,Saluda,SC,45081,10,3,0,0,7,0,0,0,0,0,10,3,0,7
1990,Spartanburg,SC,45083,341,186,15,0,140,27,13,12,0,2,314,173,3,138
1990,Sumter,SC,45085,204,113,0,0,91,3,2,0,0,1,201,111,0,90
1990,Union,SC,45087,37,23,2,0,12,1,0,1,0,0,36,23,1,12
1990,Williamsburg,SC,45089,40,6,0,0,34,1,0,0,0,1,39,6,0,33
1990,York,SC,45091,246,157,3,0,86,18,13,2,0,3,228,144,1,83
1990,Aurora,SD,46003,6,4,1,1,0,3,1,1,1,0,3,3,0,0
1990,Beadle,SD,46005,40,33,2,3,2,11,5,2,3,1,29,28,0,1
1990,Bennett,SD,46007,4,3,0,1,0,2,1,0,1,0,2,2,0,0
1990,Bon Homme,SD,46009,11,11,0,0,0,1,1,0,0,0,10,10,0,0
1990,Brookings,SD,46011,26,23,0,1,2,9,7,0,1,1,17,16,0,1
1990,Brown,SD,46013,77,67,2,3,5,13,6,2,3,2,64,61,0,3
1990,Brule,SD,46015,7,3,1,0,3,3,2,1,0,0,4,1,0,3
1990,Butte,SD,46019,21,19,0,1,1,9,8,0,1,0,12,11,0,1
1990,Campbell,SD,46021,1,0,0,0,0,1,0,0,1,0,0,0,0,0
1990,Charles Mix,SD,46023,10,5,0,5,0,6,1,0,5,0,4,4,0,0
1990,Clark,SD,46025,4,3,0,1,0,2,1,0,1,0,2,2,0,0
1990,Clay,SD,46027,21,18,1,0,2,8,6,1,0,1,13,12,0,1
1990,Codington,SD,46029,49,41,0,0,8,12,10,0,0,2,37,31,0,6
1990,Corson,SD,46031,1,1,0,0,0,0,0,0,0,0,1,1,0,0
1990,Custer,SD,46033,17,17,0,0,0,4,4,0,0,0,13,13,0,0
1990,Davison,SD,46035,49,45,3,0,1,15,11,3,0,1,34,34,0,0
1990,Day,SD,46037,8,6,0,2,0,3,1,0,2,0,5,5,0,0
1990,Deuel,SD,46039,9,4,0,3,2,4,1,0,3,0,5,3,0,2
1990,Dewey,SD,46041,4,2,0,2,0,2,0,0,2,0,2,2,0,0
1990,Douglas,SD,46043,1,1,0,0,0,0,0,0,0,0,1,1,0,0
1990,Edmunds,SD,46045,6,5,0,0,1,0,0,0,0,0,6,5,0,1
1990,Fall River,SD,46047,18,17,0,0,1,8,7,0,0,1,10,10,0,0
1990,Faulk,SD,46049,2,2,0,0,0,1,1,0,0,0,1,1,0,0
1990,Grant,SD,46051,11,8,0,3,0,6,3,0,3,0,5,5,0,0
1990,Gregory,SD,46053,2,0,0,0,0,2,0,0,2,0,0,0,0,0
1990,Haakon,SD,46055,1,1,0,0,0,0,0,0,0,0,1,1,0,0
1990,Hamlin,SD,46057,8,5,0,1,2,3,0,0,1,2,5,5,0,0
1990,Hand,SD,46059,8,3,1,4,0,6,1,1,4,0,2,2,0,0
1990,Hanson,SD,46061,1,1,0,0,0,0,0,0,0,0,1,1,0,0
1990,Harding,SD,46063,1,0,0,0,0,1,0,0,1,0,0,0,0,0
1990,Hughes,SD,46065,26,22,1,2,1,10,6,1,2,1,16,16,0,0
1990,Hutchinson,SD,46067,10,8,0,2,0,3,1,0,2,0,7,7,0,0
1990,Hyde,SD,46069,2,0,0,0,0,2,0,0,2,0,0,0,0,0
1990,Jackson,SD,46071,3,3,0,0,0,2,2,0,0,0,1,1,0,0
1990,Jerauld,SD,46073,1,1,0,0,0,1,1,0,0,0,0,0,0,0
1990,Kingsbury,SD,46077,6,5,0,0,1,2,1,0,0,1,4,4,0,0
1990,Lake,SD,46079,12,11,0,0,1,4,3,0,0,1,8,8,0,0
1990,Lawrence,SD,46081,38,34,1,0,3,9,6,1,0,2,29,28,0,1
1990,Lincoln,SD,46083,34,32,0,0,2,10,9,0,0,1,24,23,0,1
1990,Marshall,SD,46087,9,5,2,1,1,3,0,2,1,0,6,5,0,1
1990,McCook,SD,46089,1,0,0,0,0,1,0,0,1,0,0,0,0,0
1990,McPherson,SD,46091,6,3,0,3,0,4,1,0,3,0,2,2,0,0
1990,Meade,SD,46093,37,29,1,3,4,14,7,1,3,3,23,22,0,1
1990,Miner,SD,46097,4,4,0,0,0,2,2,0,0,0,2,2,0,0
1990,Minnehaha,SD,46099,482,427,8,4,43,78,57,8,4,9,404,370,0,34
1990,Moody,SD,46101,10,8,0,1,1,2,1,0,1,0,8,7,0,1
1990,Pennington,SD,46103,217,204,1,0,11,50,46,1,0,2,167,158,0,9
1990,Perkins,SD,46105,2,2,0,0,0,1,1,0,0,0,1,1,0,0
1990,Potter,SD,46107,6,5,0,1,0,3,2,0,1,0,3,3,0,0
1990,Roberts,SD,46109,10,6,0,2,2,5,1,0,2,2,5,5,0,0
1990,Sanborn,SD,46111,7,5,0,1,1,2,1,0,1,0,5,4,0,1
1990,Shannon,SD,46113,4,2,0,0,2,0,0,0,0,0,4,2,0,2
1990,Spink,SD,46115,21,18,0,3,0,3,0,0,3,0,18,18,0,0
1990,Stanley,SD,46117,8,7,0,1,0,5,4,0,1,0,3,3,0,0
1990,Todd,SD,46121,4,4,0,0,0,1,1,0,0,0,3,3,0,0
1990,Tripp,SD,46123,3,3,0,0,0,0,0,0,0,0,3,3,0,0
1990,Turner,SD,46125,22,17,1,2,2,11,6,1,2,2,11,11,0,0
1990,Union,SD,46127,31,27,0,1,3,10,6,0,1,3,21,21,0,0
1990,Walworth,SD,46129,10,6,1,3,0,5,1,1,3,0,5,5,0,0
1990,Yankton,SD,46135,43,39,0,1,3,5,3,0,1,1,38,36,0,2
1990,Anderson,TN,47001,286,199,3,0,84,9,4,3,0,2,277,195,0,82
1990,Bedford,TN,47003,222,85,0,1,136,4,1,0,1,2,218,84,0,134
1990,Benton,TN,47005,77,38,1,0,38,0,0,0,0,0,77,38,1,38
1990,Bledsoe,TN,47007,24,7,0,0,17,0,0,0,0,0,24,7,0,17
1990,Blount,TN,47009,495,339,1,0,155,11,9,1,0,1,484,330,0,154
1990,Bradley,TN,47011,393,151,3,1,238,9,5,1,1,2,384,146,2,236
1990,Campbell,TN,47013,95,76,0,0,19,2,1,0,0,1,93,75,0,18
1990,Cannon,TN,47015,49,20,0,0,29,1,1,0,0,0,48,19,0,29
1990,Carroll,TN,47017,174,65,4,0,105,4,2,2,0,0,170,63,2,105
1990,Carter,TN,47019,123,119,0,0,4,1,1,0,0,0,122,118,0,4
1990,Cheatham,TN,47021,255,126,0,0,129,19,13,0,0,6,236,113,0,123
1990,Chester,TN,47023,50,19,1,0,30,1,0,1,0,0,49,19,0,30
1990,Claiborne,TN,47025,47,35,1,0,11,4,2,1,0,1,43,33,0,10
1990,Clay,TN,47027,17,11,2,1,3,6,3,2,1,0,11,8,0,3
1990,Cocke,TN,47029,89,83,0,1,5,4,2,0,1,1,85,81,0,4
1990,Coffee,TN,47031,209,87,3,0,119,3,0,3,0,0,206,87,0,119
1990,Crockett,TN,47033,80,12,3,0,65,3,0,3,0,0,77,12,0,65
1990,Cumberland,TN,47035,103,74,6,1,22,12,6,4,1,1,91,68,2,21
1990,Davidson,TN,47037,5179,2168,108,0,2903,399,218,102,0,79,4780,1950,6,2824
1990,Decatur,TN,47039,33,15,2,0,16,2,0,2,0,0,31,15,0,16
1990,DeKalb,TN,47041,44,21,1,0,22,6,3,1,0,2,38,18,0,20
1990,Dickson,TN,47043,297,93,0,0,204,14,9,0,0,5,283,84,0,199
1990,Dyer,TN,47045,262,83,1,0,178,2,1,1,0,0,260,82,0,178
1990,Fayette,TN,47047,203,52,1,0,150,1,0,1,0,0,202,52,0,150
1990,Fentress,TN,47049,31,23,0,1,7,4,1,0,1,2,27,22,0,5
1990,Franklin,TN,47051,149,39,0,0,110,4,2,0,0,2,145,37,0,108
1990,Gibson,TN,47053,297,80,5,1,211,8,1,5,1,1,289,79,0,210
1990,Giles,TN,47055,111,68,0,0,43,10,7,0,0,3,101,61,0,40
1990,Grainger,TN,47057,58,44,0,0,14,0,0,0,0,0,58,44,0,14
1990,Greene,TN,47059,220,200,0,0,20,3,3,0,0,0,217,197,0,20
1990,Grundy,TN,47061,49,19,0,1,29,3,1,0,1,1,46,18,0,28
1990,Hamblen,TN,47063,257,246,1,0,10,5,3,1,0,1,252,243,0,9
1990,Hamilton,TN,47065,2480,790,27,0,1663,43,17,23,0,3,2437,773,4,1660
1990,Hancock,TN,47067,5,5,0,0,0,0,0,0,0,0,5,5,0,0
1990,Hardeman,TN,47069,141,25,3,0,113,2,0,2,0,0,139,25,1,113
1990,Hardin,TN,47071,97,29,2,0,66,4,1,2,0,1,93,28,0,65
1990,Hawkins,TN,47073,138,126,0,0,12,2,1,0,0,1,136,125,0,11
1990,Haywood,TN,47075,111,15,2,0,94,2,1,1,0,0,109,14,1,94
1990,Henderson,TN,47077,133,34,1,0,98,1,0,1,0,0,132,34,0,98
1990,Henry,TN,47079,137,60,7,2,68,10,1,7,2,0,127,59,0,68
1990,Hickman,TN,47081,104,39,1,0,64,10,5,1,0,4,94,34,0,60
1990,Houston,TN,47083,27,14,0,0,13,1,1,0,0,0,26,13,0,13
1990,Humphreys,TN,47085,78,31,0,0,47,5,4,0,0,1,73,27,0,46
1990,Jackson,TN,47087,19,15,1,0,3,2,1,0,0,1,17,14,1,2
1990,Jefferson,TN,47089,153,125,1,1,26,5,4,0,1,0,148,121,1,26
1990,Johnson,TN,47091,15,10,0,0,5,2,1,0,0,1,13,9,0,4
1990,Knox,TN,47093,1617,1016,19,0,582,78,50,18,0,10,1539,966,1,572
1990,Lake,TN,47095,35,7,0,1,27,1,0,0,1,0,34,7,0,27
1990,Lauderdale,TN,47097,204,31,3,0,170,4,1,3,0,0,200,30,0,170
1990,Lawrence,TN,47099,113,46,0,0,67,15,6,0,0,9,98,40,0,58
1990,Lewis,TN,47101,48,30,1,0,17,6,4,1,0,1,42,26,0,16
1990,Lincoln,TN,47103,140,47,1,0,92,2,1,1,0,0,138,46,0,92
1990,Loudon,TN,47105,119,71,0,0,48,6,4,0,0,2,113,67,0,46
1990,McMinn,TN,47107,131,89,0,0,42,1,1,0,0,0,130,88,0,42
1990,McNairy,TN,47109,113,44,3,0,66,3,0,3,0,0,110,44,0,66
1990,Macon,TN,47111,33,21,0,0,12,4,4,0,0,0,29,17,0,12
1990,Madison,TN,47113,561,124,22,0,415,21,3,18,0,0,540,121,4,415
1990,Marion,TN,47115,151,53,2,0,96,3,0,2,0,1,148,53,0,95
1990,Marshall,TN,47117,168,77,0,0,91,5,4,0,0,1,163,73,0,90
1990,Maury,TN,47119,373,108,4,0,261,15,7,4,0,4,358,101,0,257
1990,Meigs,TN,47121,45,28,0,0,17,0,0,0,0,0,45,28,0,17
1990,Monroe,TN,47123,100,70,0,1,29,2,1,0,1,0,98,69,0,29
1990,Montgomery,TN,47125,664,374,7,0,283,30,21,6,0,3,634,353,1,280
1990,Moore,TN,47127,15,3,0,0,12,0,0,0,0,0,15,3,0,12
1990,Morgan,TN,47129,61,55,1,0,5,2,1,1,0,0,59,54,0,5
1990,Obion,TN,47131,171,58,6,0,107,4,0,4,0,0,167,58,2,107
1990,Overton,TN,47133,49,28,4,1,16,8,3,4,1,0,41,25,0,16
1990,Perry,TN,47135,26,16,0,1,9,3,2,0,1,0,23,14,0,9
1990,Pickett,TN,47137,7,5,1,0,1,3,1,1,0,1,4,4,0,0
1990,Polk,TN,47139,50,16,0,0,34,2,1,0,0,1,48,15,0,33
1990,Putnam,TN,47141,236,161,3,1,71,25,17,3,1,4,211,144,0,67
1990,Rhea,TN,47143,160,45,0,0,115,0,0,0,0,0,160,45,0,115
1990,Roane,TN,47145,174,147,0,0,27,4,1,0,0,3,170,146,0,24
1990,Robertson,TN,47147,391,117,3,0,271,14,7,2,0,5,377,110,1,266
1990,Rutherford,TN,47149,960,451,10,0,499,50,29,9,0,12,910,422,1,487
1990,Scott,TN,47151,48,45,0,0,3,3,2,0,0,1,45,43,0,2
1990,Sequatchie,TN,47153,32,13,0,0,19,1,1,0,0,0,31,12,0,19
1990,Sevier,TN,47155,240,177,5,0,58,17,8,5,0,4,223,169,0,54
1990,Shelby,TN,47157,10668,2699,84,0,7885,127,55,68,0,4,10541,2644,16,7881
1990,Smith,TN,47159,53,31,0,0,22,2,1,0,0,1,51,30,0,21
1990,Stewart,TN,47161,41,27,0,0,14,0,0,0,0,0,41,27,0,14
1990,Sullivan,TN,47163,514,468,1,0,45,12,11,1,0,0,502,457,0,45
1990,Sumner,TN,47165,935,363,9,0,563,58,32,8,0,18,877,331,1,545
1990,Tipton,TN,47167,206,84,0,0,122,0,0,0,0,0,206,84,0,122
1990,Trousdale,TN,47169,44,9,1,0,34,2,1,1,0,0,42,8,0,34
1990,Unicoi,TN,47171,33,30,1,0,2,1,0,1,0,0,32,30,0,2
1990,Union,TN,47173,61,45,2,0,14,2,0,2,0,0,59,45,0,14
1990,Van Buren,TN,47175,26,5,0,0,21,1,0,0,0,1,25,5,0,20
1990,Warren,TN,47177,90,43,0,3,44,5,2,0,3,0,85,41,0,44
1990,Washington,TN,47179,305,290,0,0,15,11,9,0,0,2,294,281,0,13
1990,Wayne,TN,47181,26,19,0,0,7,4,4,0,0,0,22,15,0,7
1990,Weakley,TN,47183,156,65,2,0,89,3,1,1,0,1,153,64,1,88
1990,White,TN,47185,103,40,0,0,63,4,3,0,0,1,99,37,0,62
1990,Williamson,TN,47187,426,229,30,0,167,85,49,27,0,9,341,180,3,158
1990,Wilson,TN,47189,464,215,11,1,237,41,23,10,1,7,423,192,1,230
1990,Anderson,TX,48001,66,47,2,1,16,11,5,2,1,3,55,42,0,13
1990,Andrews,TX,48003,26,23,0,0,3,2,2,0,0,0,24,21,0,3
1990,Angelina,TX,48005,68,51,2,0,15,9,5,2,0,2,59,46,0,13
1990,Aransas,TX,48007,44,22,9,1,12,14,4,7,1,2,30,18,2,10
1990,Archer,TX,48009,14,10,1,0,3,2,2,0,0,0,12,8,1,3
1990,Armstrong,TX,48011,4,1,1,1,1,2,0,1,1,0,2,1,0,1
1990,Atascosa,TX,48013,36,25,0,0,11,4,4,0,0,0,32,21,0,11
1990,Austin,TX,48015,23,17,1,0,4,1,0,0,0,1,22,17,1,4
1990,Bailey,TX,48017,15,10,3,2,0,12,7,3,2,0,3,3,0,0
1990,Bandera,TX,48019,36,25,1,0,10,2,1,1,0,0,34,24,0,10
1990,Bastrop,TX,48021,126,70,2,0,54,5,3,2,0,0,121,67,0,54
1990,Baylor,TX,48023,7,7,0,0,0,1,1,0,0,0,6,6,0,0
1990,Bee,TX,48025,41,32,0,0,9,1,0,0,0,1,40,32,0,8
1990,Bell,TX,48027,781,425,16,0,340,42,18,14,0,10,739,407,2,330
1990,Bexar,TX,48029,3585,2050,106,2,1427,262,128,99,2,33,3323,1922,7,1394
1990,Blanco,TX,48031,9,6,1,0,2,1,0,0,0,1,8,6,1,1
1990,Bosque,TX,48035,24,20,0,1,3,4,3,0,1,0,20,17,0,3
1990,Bowie,TX,48037,133,115,5,0,13,11,7,4,0,0,122,108,1,13
1990,Brazoria,TX,48039,310,231,3,0,76,10,5,3,0,2,300,226,0,74
1990,Brazos,TX,48041,147,110,8,1,27,26,14,8,1,2,121,96,0,25
1990,Brewster,TX,48043,5,3,1,0,1,1,0,1,0,0,4,3,0,1
1990,Briscoe,TX,48045,8,7,0,1,0,4,3,0,1,0,4,4,0,0
1990,Brooks,TX,48047,5,3,0,0,2,0,0,0,0,0,5,3,0,2
1990,Brown,TX,48049,53,44,2,0,7,20,14,2,0,4,33,30,0,3
1990,Burleson,TX,48051,11,9,0,0,2,1,0,0,0,1,10,9,0,1
1990,Burnet,TX,48053,54,40,0,0,14,3,3,0,0,0,51,37,0,14
1990,Caldwell,TX,48055,40,24,1,0,15,3,2,1,0,0,37,22,0,15
1990,Calhoun,TX,48057,16,14,0,0,2,2,2,0,0,0,14,12,0,2
1990,Callahan,TX,48059,16,13,1,0,2,3,2,1,0,0,13,11,0,2
1990,Cameron,TX,48061,449,174,38,2,234,68,15,36,2,14,381,159,2,220
1990,Camp,TX,48063,13,4,1,0,8,1,0,1,0,0,12,4,0,8
1990,Carson,TX,48065,9,7,0,0,2,3,3,0,0,0,6,4,0,2
1990,Cass,TX,48067,25,20,0,0,5,2,2,0,0,0,23,18,0,5
1990,Castro,TX,48069,8,6,0,1,1,5,3,0,1,1,3,3,0,0
1990,Chambers,TX,48071,19,15,0,0,4,2,2,0,0,0,17,13,0,4
1990,Cherokee,TX,48073,40,31,0,0,9,1,0,0,0,1,39,31,0,8
1990,Childress,TX,48075,6,6,0,0,0,3,3,0,0,0,3,3,0,0
1990,Clay,TX,48077,15,12,0,0,3,2,2,0,0,0,13,10,0,3
1990,Cochran,TX,48079,5,4,0,0,1,4,3,0,0,1,1,1,0,0
1990,Coke,TX,48081,7,2,4,0,1,5,0,4,0,1,2,2,0,0
1990,Coleman,TX,48083,14,13,0,0,1,3,3,0,0,0,11,10,0,1
1990,Collin,TX,48085,903,617,38,0,248,133,83,36,0,14,770,534,2,234
1990,Collingsworth,TX,48087,1,0,0,0,1,0,0,0,0,0,1,0,0,1
1990,Colorado,TX,48089,12,8,1,0,3,3,2,1,0,0,9,6,0,3
1990,Comal,TX,48091,103,74,3,0,26,7,3,2,0,2,96,71,1,24
1990,Comanche,TX,48093,17,10,0,1,6,4,2,0,1,1,13,8,0,5
1990,Concho,TX,48095,2,2,0,0,0,2,2,0,0,0,0,0,0,0
1990,Cooke,TX,48097,36,31,2,0,3,6,4,2,0,0,30,27,0,3
1990,Coryell,TX,48099,172,99,2,0,71,9,4,1,0,4,163,95,1,67
1990,Cottle,TX,48101,2,2,0,0,0,2,2,0,0,0,0,0,0,0
1990,Crane,TX,48103,7,6,1,0,0,0,0,0,0,0,7,6,1,0
1990,Crockett,TX,48105,8,6,0,0,2,3,3,0,0,0,5,3,0,2
1990,Crosby,TX,48107,14,12,1,1,0,7,5,1,1,0,7,7,0,0
1990,Culberson,TX,48109,6,0,0,0,6,0,0,0,0,0,6,0,0,6
1990,Dallam,TX,48111,2,1,0,0,1,1,0,0,0,1,1,1,0,0
1990,Dallas,TX,48113,6972,3870,397,0,2704,1131,564,376,0,190,5841,3306,21,2514
1990,Dawson,TX,48115,7,5,0,0,2,2,0,0,0,2,5,5,0,0
1990,Deaf Smith,TX,48117,5,5,0,0,0,1,1,0,0,0,4,4,0,0
1990,Delta,TX,48119,6,3,1,1,1,4,1,1,1,1,2,2,0,0
1990,Denton,TX,48121,881,551,44,1,285,116,55,39,1,21,765,496,5,264
1990,DeWitt,TX,48123,26,22,2,0,2,2,0,2,0,0,24,22,0,2
1990,Dickens,TX,48125,1,0,0,0,1,0,0,0,0,0,1,0,0,1
1990,Dimmit,TX,48127,4,3,1,0,0,2,1,1,0,0,2,2,0,0
1990,Donley,TX,48129,8,8,0,0,0,4,4,0,0,0,4,4,0,0
1990,Duval,TX,48131,12,8,0,0,4,1,1,0,0,0,11,7,0,4
1990,Eastland,TX,48133,17,13,1,0,3,6,2,1,0,3,11,11,0,0
1990,Ector,TX,48135,257,226,7,0,24,23,14,6,0,3,234,212,1,21
1990,Edwards,TX,48137,1,0,0,0,1,1,0,0,0,1,0,0,0,0
1990,Ellis,TX,48139,192,99,8,0,84,28,15,6,0,7,164,84,2,78
1990,El Paso,TX,48141,1400,292,44,1,1063,76,31,36,1,8,1324,261,8,1055
1990,Erath,TX,48143,40,25,2,0,13,11,6,1,0,4,29,19,1,9
1990,Falls,TX,48145,18,10,1,0,7,4,4,0,0,0,14,6,1,7
1990,Fannin,TX,48147,26,18,1,0,7,4,1,1,0,2,22,17,0,5
1990,Fayette,TX,48149,26,21,0,0,5,1,1,0,0,0,25,20,0,5
1990,Fisher,TX,48151,12,11,0,0,1,4,4,0,0,0,8,7,0,1
1990,Floyd,TX,48153,8,8,0,0,0,2,2,0,0,0,6,6,0,0
1990,Foard,TX,48155,2,2,0,0,0,1,1,0,0,0,1,1,0,0
1990,Fort Bend,TX,48157,620,342,16,0,262,33,18,13,0,2,587,324,3,260
1990,Franklin,TX,48159,9,6,1,0,2,2,1,1,0,0,7,5,0,2
1990,Freestone,TX,48161,26,12,0,0,14,1,0,0,0,1,25,12,0,13
1990,Frio,TX,48163,11,10,0,0,1,2,2,0,0,0,9,8,0,1
1990,Gaines,TX,48165,19,17,0,1,1,8,6,0,1,1,11,11,0,0
1990,Galveston,TX,48167,381,267,11,1,102,34,21,10,1,2,347,246,1,100
1990,Garza,TX,48169,4,2,1,0,1,1,0,1,0,0,3,2,0,1
1990,Gillespie,TX,48171,24,22,0,0,2,4,4,0,0,0,20,18,0,2
1990,Glasscock,TX,48173,2,2,0,0,0,0,0,0,0,0,2,2,0,0
1990,Goliad,TX,48175,9,6,0,0,3,0,0,0,0,0,9,6,0,3
1990,Gonzales,TX,48177,8,6,1,0,1,2,1,1,0,0,6,5,0,1
1990,Gray,TX,48179,36,28,3,1,4,12,6,3,1,2,24,22,0,2
1990,Grayson,TX,48181,160,121,18,0,21,34,14,16,0,4,126,107,2,17
1990,Gregg,TX,48183,191,112,9,0,70,43,22,7,0,14,148,90,2,56
1990,Grimes,TX,48185,12,11,0,0,1,0,0,0,0,0,12,11,0,1
1990,Guadalupe,TX,48187,120,73,4,0,43,10,5,3,0,2,110,68,1,41
1990,Hale,TX,48189,41,31,2,1,7,12,7,2,1,2,29,24,0,5
1990,Hall,TX,48191,6,5,0,1,0,3,2,0,1,0,3,3,0,0
1990,Hamilton,TX,48193,11,6,1,0,4,1,1,0,0,0,10,5,1,4
1990,Hansford,TX,48195,6,2,0,1,3,1,0,0,1,0,5,2,0,3
1990,Hardeman,TX,48197,9,4,0,3,2,6,2,0,3,1,3,2,0,1
1990,Hardin,TX,48199,44,31,3,0,10,10,6,3,0,1,34,25,0,9
1990,Harris,TX,48201,7381,4653,395,1,2330,835,361,369,1,102,6546,4292,26,2228
1990,Harrison,TX,48203,95,32,6,0,57,22,9,6,0,7,73,23,0,50
1990,Hartley,TX,48205,2,2,0,0,0,0,0,0,0,0,2,2,0,0
1990,Haskell,TX,48207,6,5,0,0,1,1,1,0,0,0,5,4,0,1
1990,Hays,TX,48209,197,127,4,0,66,9,3,4,0,2,188,124,0,64
1990,Hemphill,TX,48211,6,6,0,0,0,0,0,0,0,0,6,6,0,0
1990,Henderson,TX,48213,156,81,11,0,64,34,12,7,0,15,122,69,4,49
1990,Hidalgo,TX,48215,431,217,32,3,179,80,28,28,3,21,351,189,4,158
1990,Hill,TX,48217,45,27,3,1,14,15,8,3,1,3,30,19,0,11
1990,Hockley,TX,48219,52,50,1,0,1,23,22,1,0,0,29,28,0,1
1990,Hood,TX,48221,73,56,4,0,13,11,8,3,0,0,62,48,1,13
1990,Hopkins,TX,48223,46,28,3,1,14,10,6,1,1,2,36,22,2,12
1990,Houston,TX,48225,16,13,0,0,3,4,4,0,0,0,12,9,0,3
1990,Howard,TX,48227,36,31,2,1,2,7,2,2,1,2,29,29,0,0
1990,Hunt,TX,48231,92,51,7,1,33,21,6,7,1,7,71,45,0,26
1990,Hutchinson,TX,48233,24,21,1,1,1,8,5,1,1,1,16,16,0,0
1990,Irion,TX,48235,4,2,0,1,1,3,1,0,1,1,1,1,0,0
1990,Jack,TX,48237,9,5,0,0,4,0,0,0,0,0,9,5,0,4
1990,Jackson,TX,48239,13,10,0,0,3,1,1,0,0,0,12,9,0,3
1990,Jasper,TX,48241,22,18,1,0,3,5,3,1,0,1,17,15,0,2
1990,Jefferson,TX,48245,240,180,18,0,42,56,29,17,0,10,184,151,1,32
1990,Jim Hogg,TX,48247,6,2,0,1,3,2,1,0,1,0,4,1,0,3
1990,Jim Wells,TX,48249,38,25,0,0,13,9,4,0,0,5,29,21,0,8
1990,Johnson,TX,48251,296,199,4,0,93,43,31,3,0,9,253,168,1,84
1990,Jones,TX,48253,30,23,0,2,5,5,2,0,2,1,25,21,0,4
1990,Karnes,TX,48255,13,7,0,0,6,2,1,0,0,1,11,6,0,5
1990,Kaufman,TX,48257,143,91,1,0,51,18,10,1,0,7,125,81,0,44
1990,Kendall,TX,48259,31,24,3,0,4,4,1,3,0,0,27,23,0,4
1990,Kenedy,TX,48261,1,1,0,0,0,0,0,0,0,0,1,1,0,0
1990,Kerr,TX,48265,81,69,9,0,3,17,9,8,0,0,64,60,1,3
1990,Kimble,TX,48267,3,2,0,0,1,0,0,0,0,0,3,2,0,1
1990,Kleberg,TX,48273,55,34,3,0,18,6,2,3,0,1,49,32,0,17
1990,Knox,TX,48275,4,2,1,0,1,1,1,0,0,0,3,1,1,1
1990,Lamar,TX,48277,28,22,1,1,4,6,3,1,1,1,22,19,0,3
1990,Lamb,TX,48279,29,27,1,0,1,16,15,1,0,0,13,12,0,1
1990,Lampasas,TX,48281,24,15,1,0,8,0,0,0,0,0,24,15,1,8
1990,La Salle,TX,48283,1,1,0,0,0,0,0,0,0,0,1,1,0,0
1990,Lavaca,TX,48285,14,12,0,0,2,5,4,0,0,1,9,8,0,1
1990,Lee,TX,48287,18,9,1,0,8,2,1,1,0,0,16,8,0,8
1990,Leon,TX,48289,8,4,0,0,4,1,0,0,0,1,7,4,0,3
1990,Liberty,TX,48291,81,56,6,0,19,12,4,6,0,2,69,52,0,17
1990,Limestone,TX,48293,23,11,0,0,12,1,1,0,0,0,22,10,0,12
1990,Lipscomb,TX,48295,2,2,0,0,0,1,1,0,0,0,1,1,0,0
1990,Live Oak,TX,48297,15,11,0,1,3,1,0,0,1,0,14,11,0,3
1990,Llano,TX,48299,22,11,2,0,9,5,2,1,0,2,17,9,1,7
1990,Lubbock,TX,48303,493,397,16,1,79,106,83,16,1,6,387,314,0,73
1990,Lynn,TX,48305,7,7,0,0,0,1,1,0,0,0,6,6,0,0
1990,McCulloch,TX,48307,11,8,0,2,1,6,3,0,2,1,5,5,0,0
1990,McLennan,TX,48309,339,212,9,2,116,49,23,9,2,15,290,189,0,101
1990,Madison,TX,48313,8,6,0,0,2,0,0,0,0,0,8,6,0,2
1990,Marion,TX,48315,8,5,0,0,3,2,2,0,0,0,6,3,0,3
1990,Martin,TX,48317,3,2,0,1,0,2,1,0,1,0,1,1,0,0
1990,Mason,TX,48319,4,3,0,0,1,0,0,0,0,0,4,3,0,1
1990,Matagorda,TX,48321,64,49,7,1,7,11,3,6,1,1,53,46,1,6
1990,Maverick,TX,48323,15,4,1,1,9,4,1,0,1,2,11,3,1,7
1990,Medina,TX,48325,34,17,4,1,12,8,4,3,1,0,26,13,1,12
1990,Menard,TX,48327,1,0,0,0,0,1,0,0,1,0,0,0,0,0
1990,Midland,TX,48329,177,147,9,0,21,19,8,6,0,5,158,139,3,16
1990,Milam,TX,48331,34,24,0,0,10,3,1,0,0,2,31,23,0,8
1990,Mills,TX,48333,2,0,0,0,0,2,0,0,1,1,0,0,0,0
1990,Mitchell,TX,48335,7,4,1,1,1,4,1,1,1,1,3,3,0,0
1990,Montague,TX,48337,29,18,1,2,8,6,4,0,2,0,23,14,1,8
1990,Montgomery,TX,48339,449,330,11,1,107,39,21,11,1,6,410,309,0,101
1990,Moore,TX,48341,23,20,2,1,0,8,5,2,1,0,15,15,0,0
1990,Morris,TX,48343,7,3,2,0,2,2,0,2,0,0,5,3,0,2
1990,Motley,TX,48345,1,1,0,0,0,1,1,0,0,0,0,0,0,0
1990,Nacogdoches,TX,48347,53,40,2,2,9,14,5,1,2,6,39,35,1,3
1990,Navarro,TX,48349,55,31,2,0,22,12,9,1,0,2,43,22,1,20
1990,Newton,TX,48351,13,9,0,0,4,2,1,0,0,1,11,8,0,3
1990,Nolan,TX,48353,25,21,0,1,3,13,10,0,1,2,12,11,0,1
1990,Nueces,TX,48355,881,502,52,1,326,87,27,44,1,15,794,475,8,311
1990,Ochiltree,TX,48357,20,17,0,2,1,4,2,0,2,0,16,15,0,1
1990,Orange,TX,48361,83,71,2,0,10,22,15,2,0,5,61,56,0,5
1990,Palo Pinto,TX,48363,36,26,1,0,9,2,1,1,0,0,34,25,0,9
1990,Panola,TX,48365,17,13,0,1,3,2,1,0,1,0,15,12,0,3
1990,Parker,TX,48367,133,75,5,0,53,20,12,5,0,3,113,63,0,50
1990,Parmer,TX,48369,12,10,2,0,0,8,6,2,0,0,4,4,0,0
1990,Pecos,TX,48371,5,3,0,0,2,2,1,0,0,1,3,2,0,1
1990,Polk,TX,48373,45,27,7,0,11,10,3,6,0,1,35,24,1,10
1990,Potter,TX,48375,155,135,10,0,10,24,11,10,0,3,131,124,0,7
1990,Rains,TX,48379,12,6,2,0,4,1,0,1,0,0,11,6,1,4
1990,Randall,TX,48381,172,149,6,0,17,42,33,6,0,3,130,116,0,14
1990,Reagan,TX,48383,6,5,0,0,1,2,2,0,0,0,4,3,0,1
1990,Real,TX,48385,4,4,0,0,0,0,0,0,0,0,4,4,0,0
1990,Red River,TX,48387,4,2,0,0,2,1,1,0,0,0,3,1,0,2
1990,Reeves,TX,48389,10,8,1,0,1,1,0,1,0,0,9,8,0,1
1990,Refugio,TX,48391,10,6,0,2,2,2,0,0,2,0,8,6,0,2
1990,Robertson,TX,48395,13,8,1,0,4,1,0,1,0,0,12,8,0,4
1990,Rockwall,TX,48397,102,61,3,0,38,18,11,3,0,4,84,50,0,34
1990,Runnels,TX,48399,17,15,0,1,1,9,8,0,1,0,8,7,0,1
1990,Rusk,TX,48401,36,19,2,0,15,6,2,2,0,2,30,17,0,13
1990,Sabine,TX,48403,6,4,1,0,1,2,1,1,0,0,4,3,0,1
1990,San Augustine,TX,48405,5,2,0,0,3,1,0,0,0,1,4,2,0,2
1990,San Jacinto,TX,48407,14,11,0,0,3,1,0,0,0,1,13,11,0,2
1990,San Patricio,TX,48409,105,59,8,1,37,7,0,6,1,0,98,59,2,37
1990,San Saba,TX,48411,5,3,0,0,2,2,1,0,0,1,3,2,0,1
1990,Schleicher,TX,48413,3,2,0,0,1,0,0,0,0,0,3,2,0,1
1990,Scurry,TX,48415,17,13,1,1,2,5,3,1,1,0,12,10,0,2
1990,Shackelford,TX,48417,5,3,0,0,2,1,0,0,0,1,4,3,0,1
1990,Shelby,TX,48419,18,14,0,0,4,3,1,0,0,2,15,13,0,2
1990,Sherman,TX,48421,4,4,0,0,0,2,2,0,0,0,2,2,0,0
1990,Smith,TX,48423,324,231,13,0,80,57,35,10,0,12,267,196,3,68
1990,Somervell,TX,48425,5,4,0,0,1,1,1,0,0,0,4,3,0,1
1990,Starr,TX,48427,10,4,2,0,4,2,0,2,0,0,8,4,0,4
1990,Stephens,TX,48429,11,9,1,0,1,1,0,1,0,0,10,9,0,1
1990,Stonewall,TX,48433,4,3,0,1,0,3,2,0,1,0,1,1,0,0
1990,Sutton,TX,48435,2,2,0,0,0,0,0,0,0,0,2,2,0,0
1990,Swisher,TX,48437,4,3,0,1,0,2,1,0,1,0,2,2,0,0
1990,Tarrant,TX,48439,4585,2628,146,0,1811,502,269,135,0,98,4083,2359,11,1713
1990,Taylor,TX,48441,291,258,8,1,24,52,38,8,1,5,239,220,0,19
1990,Terrell,TX,48443,3,0,1,0,0,2,0,0,2,0,1,0,1,0
1990,Terry,TX,48445,14,8,0,0,6,7,4,0,0,3,7,4,0,3
1990,Throckmorton,TX,48447,3,1,0,1,1,1,0,0,1,0,2,1,0,1
1990,Titus,TX,48449,25,18,1,0,6,6,4,1,0,1,19,14,0,5
1990,Tom Green,TX,48451,132,108,11,0,13,44,27,11,0,6,88,81,0,7
1990,Travis,TX,48453,2948,1894,91,1,962,154,59,75,1,19,2794,1835,16,943
1990,Trinity,TX,48455,6,5,0,0,1,0,0,0,0,0,6,5,0,1
1990,Tyler,TX,48457,11,9,1,0,1,4,2,1,0,1,7,7,0,0
1990,Upshur,TX,48459,40,27,0,0,13,10,7,0,0,3,30,20,0,10
1990,Upton,TX,48461,2,2,0,0,0,0,0,0,0,0,2,2,0,0
1990,Uvalde,TX,48463,19,15,2,2,0,4,1,1,2,0,15,14,1,0
1990,Val Verde,TX,48465,24,20,0,0,4,5,2,0,0,3,19,18,0,1
1990,Van Zandt,TX,48467,84,44,3,1,36,15,5,3,1,6,69,39,0,30
1990,Victoria,TX,48469,95,75,5,0,15,10,7,3,0,0,85,68,2,15
1990,Walker,TX,48471,49,34,1,0,14,7,4,1,0,2,42,30,0,12
1990,Waller,TX,48473,23,15,0,0,8,1,0,0,0,1,22,15,0,7
1990,Ward,TX,48475,17,15,0,0,2,1,1,0,0,0,16,14,0,2
1990,Washington,TX,48477,33,23,4,0,6,8,2,4,0,2,25,21,0,4
1990,Webb,TX,48479,238,91,18,1,128,33,15,16,1,1,205,76,2,127
1990,Wharton,TX,48481,44,30,4,0,10,8,5,3,0,0,36,25,1,10
1990,Wheeler,TX,48483,6,4,0,1,1,2,0,0,1,1,4,4,0,0
1990,Wichita,TX,48485,234,162,7,0,65,27,11,6,0,10,207,151,1,55
1990,Wilbarger,TX,48487,22,18,2,0,2,2,0,2,0,0,20,18,0,2
1990,Willacy,TX,48489,10,1,0,0,9,2,0,0,0,2,8,1,0,7
1990,Williamson,TX,48491,708,477,19,0,212,37,21,9,0,7,671,456,10,205
1990,Wilson,TX,48493,40,29,1,0,10,3,2,1,0,0,37,27,0,10
1990,Winkler,TX,48495,6,6,0,0,0,0,0,0,0,0,6,6,0,0
1990,Wise,TX,48497,60,43,0,0,17,8,7,0,0,1,52,36,0,16
1990,Wood,TX,48499,48,34,2,0,12,15,11,2,0,2,33,23,0,10
1990,Yoakum,TX,48501,7,7,0,0,0,4,4,0,0,0,3,3,0,0
1990,Young,TX,48503,36,18,2,2,14,13,6,2,2,3,23,12,0,11
1990,Zapata,TX,48505,11,1,0,0,10,0,0,0,0,0,11,1,0,10
1990,Zavala,TX,48507,4,1,3,0,0,2,0,2,0,0,2,1,1,0
1990,Beaver,UT,49001,11,5,3,1,2,2,0,0,1,1,9,5,3,1
1990,Box Elder,UT,49003,118,110,0,0,8,6,4,0,0,2,112,106,0,6
1990,Cache,UT,49005,149,128,1,0,20,22,20,1,0,1,127,108,0,19
1990,Carbon,UT,49007,54,34,0,0,20,6,4,0,0,2,48,30,0,18
1990,Daggett,UT,49009,1,0,0,0,1,0,0,0,0,0,1,0,0,1
1990,Davis,UT,49011,832,606,10,0,216,74,51,9,0,14,758,555,1,202
1990,Duchesne,UT,49013,34,23,1,0,10,4,2,0,0,2,30,21,1,8
1990,Emery,UT,49015,21,17,0,0,4,1,1,0,0,0,20,16,0,4
1990,Garfield,UT,49017,8,4,0,0,4,0,0,0,0,0,8,4,0,4
1990,Grand,UT,49019,15,14,0,0,1,1,1,0,0,0,14,13,0,1
1990,Iron,UT,49021,50,38,4,1,7,13,6,3,1,3,37,32,1,4
1990,Juab,UT,49023,6,6,0,0,0,2,2,0,0,0,4,4,0,0
1990,Kane,UT,49025,6,4,0,0,2,1,0,0,0,1,5,4,0,1
1990,Millard,UT,49027,24,18,1,0,5,5,2,1,0,2,19,16,0,3
1990,Morgan,UT,49029,7,5,0,0,2,3,2,0,0,1,4,3,0,1
1990,Piute,UT,49031,1,1,0,0,0,0,0,0,0,0,1,1,0,0
1990,Salt Lake,UT,49035,4570,2973,87,0,1510,480,292,76,0,112,4090,2681,11,1398
1990,San Juan,UT,49037,6,4,0,0,2,0,0,0,0,0,6,4,0,2
1990,Sanpete,UT,49039,39,21,2,2,14,12,5,2,2,3,27,16,0,11
1990,Sevier,UT,49041,36,17,0,0,19,1,1,0,0,0,35,16,0,19
1990,Summit,UT,49043,49,34,3,0,12,17,13,3,0,1,32,21,0,11
1990,Tooele,UT,49045,140,95,1,0,44,4,3,1,0,0,136,92,0,44
1990,Uintah,UT,49047,47,30,3,0,14,8,3,3,0,2,39,27,0,12
1990,Utah,UT,49049,678,504,14,1,158,112,71,12,1,27,566,433,2,131
1990,Wasatch,UT,49051,27,19,0,0,8,2,2,0,0,0,25,17,0,8
1990,Washington,UT,49053,103,78,4,0,21,30,19,4,0,7,73,59,0,14
1990,Wayne,UT,49055,2,0,0,0,0,2,0,0,2,0,0,0,0,0
1990,Weber,UT,49057,808,690,17,0,101,70,42,17,0,11,738,648,0,90
1990,Addison,VT,50001,25,22,1,0,2,6,5,1,0,0,19,17,0,2
1990,Bennington,VT,50003,49,42,0,1,6,13,11,0,1,1,36,31,0,5
1990,Caledonia,VT,50005,19,14,2,0,3,7,3,2,0,2,12,11,0,1
1990,Chittenden,VT,50007,163,142,4,0,17,26,19,4,0,3,137,123,0,14
1990,Essex,VT,50009,4,4,0,0,0,2,2,0,0,0,2,2,0,0
1990,Franklin,VT,50011,35,27,0,4,4,7,3,0,4,0,28,24,0,4
1990,Grand Isle,VT,50013,9,7,0,0,2,0,0,0,0,0,9,7,0,2
1990,Lamoille,VT,50015,25,18,1,0,6,12,7,1,0,4,13,11,0,2
1990,Orange,VT,50017,30,25,2,0,3,7,5,2,0,0,23,20,0,3
1990,Orleans,VT,50019,22,18,1,0,3,5,3,1,0,1,17,15,0,2
1990,Rutland,VT,50021,114,96,1,0,17,29,23,1,0,5,85,73,0,12
1990,Washington,VT,50023,88,74,8,0,6,21,12,8,0,1,67,62,0,5
1990,Windham,VT,50025,44,38,1,0,5,12,9,1,0,2,32,29,0,3
1990,Windsor,VT,50027,75,54,13,0,7,29,12,12,0,4,46,42,1,3
1990,Accomack,VA,51001,73,51,2,0,20,12,8,2,0,2,61,43,0,18
1990,Albemarle,VA,51003,200,166,3,0,31,15,10,3,0,2,185,156,0,29
1990,Alexandria city,VA,51005,58,52,2,0,4,7,5,2,0,0,51,47,0,4
1990,Alleghany,VA,51007,38,36,0,0,2,2,2,0,0,0,36,34,0,2
1990,Amelia,VA,51009,135,86,0,0,49,8,3,0,0,5,127,83,0,44
1990,Amherst,VA,51011,47,28,0,0,19,0,0,0,0,0,47,28,0,19
1990,Appomattox,VA,51013,267,229,12,0,26,27,14,12,0,1,240,215,0,25
1990,Arlington,VA,51015,135,127,0,1,7,16,14,0,1,1,119,113,0,6
1990,Augusta,VA,51017,10,10,0,0,0,1,1,0,0,0,9,9,0,0
1990,Bath,VA,51019,165,134,4,1,26,12,7,4,1,0,153,127,0,26
1990,Bedford city,VA,51021,16,14,0,0,2,3,3,0,0,0,13,11,0,2
1990,Bedford,VA,51023,86,80,1,0,5,10,8,1,0,1,76,72,0,4
1990,Bland,VA,51025,20,17,0,0,3,0,0,0,0,0,20,17,0,3
1990,Botetourt,VA,51027,58,46,3,0,9,14,10,3,0,1,44,36,0,8
1990,Bristol city,VA,51029,28,24,1,0,3,0,0,0,0,0,28,24,1,3
1990,Brunswick,VA,51031,174,128,1,0,45,4,3,1,0,0,170,125,0,45
1990,Buchanan,VA,51033,59,48,0,0,11,9,8,0,0,1,50,40,0,10
1990,Buckingham,VA,51035,73,60,1,0,12,14,10,1,0,3,59,50,0,9
1990,Buena Vista city,VA,51036,16,12,0,0,4,1,1,0,0,0,15,11,0,4
1990,Campbell,VA,51037,19,14,0,0,5,1,1,0,0,0,18,13,0,5
1990,Caroline,VA,51041,931,739,11,0,181,147,125,11,0,11,784,614,0,170
1990,Carroll,VA,51043,16,15,0,0,1,9,9,0,0,0,7,6,0,1
1990,Charles City,VA,51045,14,13,0,0,1,2,1,0,0,1,12,12,0,0
1990,Charlotte,VA,51047,51,44,0,0,7,5,5,0,0,0,46,39,0,7
1990,Charlottesville city,VA,51049,23,22,0,0,1,0,0,0,0,0,23,22,0,1
1990,Chesapeake city,VA,51051,27,26,0,0,1,6,6,0,0,0,21,20,0,1
1990,Chesterfield,VA,51053,74,57,0,0,17,5,5,0,0,0,69,52,0,17
1990,Clarke,VA,51057,18,15,1,0,2,3,2,1,0,0,15,13,0,2
1990,Colonial Heights city,VA,51061,98,79,10,0,9,17,8,9,0,0,81,71,1,9
1990,Covington city,VA,51063,26,23,0,1,2,7,6,0,1,0,19,17,0,2
1990,Craig,VA,51065,29,27,0,0,2,2,2,0,0,0,27,25,0,2
1990,Culpeper,VA,51067,101,87,3,0,11,23,15,3,0,5,78,72,0,6
1990,Cumberland,VA,51069,66,62,0,0,4,17,16,0,0,1,49,46,0,3
1990,Danville city,VA,51071,51,46,2,0,3,5,3,2,0,0,46,43,0,3
1990,Dickenson,VA,51073,127,104,0,0,23,29,23,0,0,6,98,81,0,17
1990,Dinwiddie,VA,51075,33,28,0,0,5,5,5,0,0,0,28,23,0,5
1990,Emporia city,VA,51077,34,22,2,0,10,4,1,2,0,1,30,21,0,9
1990,Essex,VA,51079,26,22,0,0,4,0,0,0,0,0,26,22,0,4
1990,Fairfax city,VA,51081,34,30,0,0,4,5,5,0,0,0,29,25,0,4
1990,Fairfax,VA,51083,72,64,0,0,8,2,2,0,0,0,70,62,0,8
1990,Falls Church city,VA,51085,140,125,2,0,13,24,20,2,0,2,116,105,0,11
1990,Fauquier,VA,51087,882,720,12,0,150,121,97,11,0,13,761,623,1,137
1990,Floyd,VA,51089,180,156,1,0,23,9,6,1,0,2,171,150,0,21
1990,Fluvanna,VA,51091,1,1,0,0,0,0,0,0,0,0,1,1,0,0
1990,Franklin city,VA,51093,112,78,1,0,33,15,8,1,0,6,97,70,0,27
1990,Franklin,VA,51095,81,68,3,0,10,27,20,3,0,4,54,48,0,6
1990,Frederick,VA,51097,15,13,1,0,1,3,2,1,0,0,12,11,0,1
1990,Fredericksburg city,VA,51099,24,23,0,0,1,2,2,0,0,0,22,21,0,1
1990,Galax city,VA,51101,20,15,0,0,5,3,3,0,0,0,17,12,0,5
1990,Giles,VA,51103,11,11,0,0,0,5,5,0,0,0,6,6,0,0
1990,Gloucester,VA,51105,52,47,1,0,4,12,10,1,0,1,40,37,0,3
1990,Goochland,VA,51107,246,190,22,0,34,42,21,19,0,2,204,169,3,32
1990,Grayson,VA,51109,17,15,0,0,2,0,0,0,0,0,17,15,0,2
1990,Greene,VA,51111,20,16,1,1,2,4,2,1,1,0,16,14,0,2
1990,Greensville,VA,51113,12,7,0,0,5,2,0,0,0,2,10,7,0,3
1990,Halifax,VA,51115,22,16,1,0,5,7,5,1,0,1,15,11,0,4
1990,Hampton city,VA,51117,54,51,1,0,2,8,6,1,0,1,46,45,0,1
1990,Hanover,VA,51119,16,11,1,0,4,5,1,1,0,3,11,10,0,1
1990,Harrisonburg city,VA,51121,233,214,2,0,17,27,19,2,0,6,206,195,0,11
1990,Henrico,VA,51125,35,30,0,0,5,1,1,0,0,0,34,29,0,5
1990,Henry,VA,51127,26,18,0,0,8,1,1,0,0,0,25,17,0,8
1990,Highland,VA,51131,20,12,2,0,6,9,6,2,0,1,11,6,0,5
1990,Hopewell city,VA,51133,9,6,0,0,3,4,4,0,0,0,5,2,0,3
1990,Isle of Wight,VA,51135,27,24,0,0,3,7,7,0,0,0,20,17,0,3
1990,James City,VA,51137,44,36,1,0,7,3,2,1,0,0,41,34,0,7
1990,King and Queen,VA,51139,52,52,0,0,0,8,8,0,0,0,44,44,0,0
1990,King George,VA,51141,29,27,0,0,2,2,2,0,0,0,27,25,0,2
1990,King William,VA,51143,133,106,0,0,27,2,1,0,0,1,131,105,0,26
1990,Lancaster,VA,51145,34,26,0,1,7,5,3,0,1,1,29,23,0,6
1990,Lee,VA,51147,24,19,0,0,5,4,3,0,0,1,20,16,0,4
1990,Lexington city,VA,51149,96,82,0,0,14,10,10,0,0,0,86,72,0,14
1990,Loudoun,VA,51153,751,600,36,0,115,78,38,34,0,6,673,562,2,109
1990,Louisa,VA,51155,154,144,1,0,9,11,8,1,0,2,143,136,0,7
1990,Lunenburg,VA,51157,9,8,0,0,1,1,1,0,0,0,8,7,0,1
1990,Lynchburg city,VA,51159,23,18,0,0,5,2,2,0,0,0,21,16,0,5
1990,Madison,VA,51161,281,244,1,0,36,47,41,1,0,5,234,203,0,31
1990,Manassas city,VA,51163,68,66,1,0,1,7,6,1,0,0,61,60,0,1
1990,Manassas Park city,VA,51165,129,128,0,0,1,18,18,0,0,0,111,110,0,1
1990,Martinsville city,VA,51167,54,47,0,0,7,7,7,0,0,0,47,40,0,7
1990,Mathews,VA,51169,49,47,0,0,2,6,6,0,0,0,43,41,0,2
1990,Mecklenburg,VA,51171,55,53,1,0,1,10,8,1,0,1,45,45,0,0
1990,Middlesex,VA,51173,75,64,0,0,11,9,8,0,0,1,66,56,0,10
1990,Montgomery,VA,51175,43,33,1,0,9,8,3,1,0,4,35,30,0,5
1990,Nelson,VA,51177,178,156,2,0,20,28,23,2,0,3,150,133,0,17
1990,New Kent,VA,51179,180,151,5,0,24,21,13,5,0,3,159,138,0,21
1990,Newport News city,VA,51181,16,14,0,0,2,1,0,0,0,1,15,14,0,1
1990,Norfolk city,VA,51183,39,32,0,0,7,3,2,0,0,1,36,30,0,6
1990,Northampton,VA,51185,135,120,6,0,9,24,16,6,0,2,111,104,0,7
1990,Northumberland,VA,51187,50,42,1,0,7,9,6,1,0,2,41,36,0,5
1990,Norton city,VA,51191,117,69,6,0,42,25,10,6,0,9,92,59,0,33
1990,Nottoway,VA,51193,22,14,0,0,8,6,3,0,0,3,16,11,0,5
1990,Orange,VA,51195,121,104,4,0,13,25,19,4,0,2,96,85,0,11
1990,Page,VA,51197,85,73,0,0,12,12,9,0,0,3,73,64,0,9
1990,Patrick,VA,51199,132,96,5,0,31,34,21,4,0,9,98,75,1,22
1990,Petersburg city,VA,51510,150,140,4,0,6,8,4,4,0,0,142,136,0,6
1990,Pittsylvania,VA,51515,13,11,0,0,2,0,0,0,0,0,13,11,0,2
1990,Poquoson city,VA,51520,40,34,0,0,6,7,6,0,0,1,33,28,0,5
1990,Portsmouth city,VA,51530,1,1,0,0,0,0,0,0,0,0,1,1,0,0
1990,Powhatan,VA,51540,106,80,7,0,19,10,2,7,0,1,96,78,0,18
1990,Prince Edward,VA,51550,997,709,21,0,267,172,117,21,0,34,825,592,0,233
1990,Prince George,VA,51560,1,1,0,0,0,0,0,0,0,0,1,1,0,0
1990,Prince William,VA,51570,64,57,0,0,7,6,6,0,0,0,58,51,0,7
1990,Pulaski,VA,51580,3,1,0,0,2,1,0,0,0,1,2,1,0,1
1990,Radford city,VA,51590,117,106,1,0,10,5,4,1,0,0,112,102,0,10
1990,Richmond city,VA,51600,26,20,6,0,0,8,2,6,0,0,18,18,0,0
1990,Richmond,VA,51610,18,17,1,0,0,1,0,1,0,0,17,17,0,0
1990,Roanoke city,VA,51620,60,44,4,0,12,8,1,4,0,3,52,43,0,9
1990,Roanoke,VA,51630,60,54,0,0,6,5,5,0,0,0,55,49,0,6
1990,Rockbridge,VA,51640,9,8,0,0,1,4,4,0,0,0,5,4,0,1
1990,Rockingham,VA,51650,713,474,7,0,232,93,58,7,0,28,620,416,0,204
1990,Russell,VA,51660,37,35,0,0,2,7,7,0,0,0,30,28,0,2
1990,Salem city,VA,51670,91,83,0,0,8,4,4,0,0,0,87,79,0,8
1990,Shenandoah,VA,51680,312,195,3,0,114,18,14,3,0,1,294,181,0,113
1990,Smyth,VA,51683,14,14,0,0,0,1,1,0,0,0,13,13,0,0
1990,Southampton,VA,51685,7,4,2,0,1,2,0,2,0,0,5,4,0,1
1990,Spotsylvania,VA,51690,44,39,0,0,5,3,3,0,0,0,41,36,0,5
1990,Stafford,VA,51700,1032,798,16,0,218,128,89,14,0,25,904,709,2,193
1990,Staunton city,VA,51710,1368,980,26,0,362,140,93,26,0,21,1228,887,0,341
1990,Surry,VA,51730,162,133,1,0,28,13,12,1,0,0,149,121,0,28
1990,Tazewell,VA,51740,557,404,9,0,144,67,41,9,0,17,490,363,0,127
1990,Virginia Beach city,VA,51750,33,29,2,0,2,5,3,2,0,0,28,26,0,2
1990,Warren,VA,51760,890,636,18,0,236,92,60,18,0,14,798,576,0,222
1990,Washington,VA,51770,522,439,8,0,75,57,35,8,0,14,465,404,0,61
1990,Waynesboro city,VA,51775,88,78,3,0,7,5,3,2,0,0,83,75,1,7
1990,Westmoreland,VA,51790,51,50,0,0,1,7,7,0,0,0,44,43,0,1
1990,Williamsburg city,VA,51800,236,158,3,0,75,33,21,3,0,9,203,137,0,66
1990,Winchester city,VA,51810,2891,2168,62,0,661,504,359,61,0,84,2387,1809,1,577
1990,Wise,VA,51820,58,56,1,0,1,11,10,1,0,0,47,46,0,1
1990,Wythe,VA,51830,71,53,2,0,16,16,12,1,0,3,55,41,1,13
1990,York,VA,51840,63,54,7,0,2,17,10,7,0,0,46,44,0,2
1990,Adams,WA,53001,39,31,4,1,3,7,2,4,1,0,32,29,0,3
1990,Asotin,WA,53003,57,42,3,0,12,10,2,3,0,5,47,40,0,7
1990,Benton,WA,53005,471,423,7,1,40,47,27,7,1,12,424,396,0,28
1990,Chelan,WA,53007,143,132,5,2,4,17,10,5,2,0,126,122,0,4
1990,Clallam,WA,53009,119,93,2,0,24,24,15,2,0,7,95,78,0,17
1990,Clark,WA,53011,884,691,14,2,177,30,6,14,2,8,854,685,0,169
1990,Columbia,WA,53013,7,5,1,0,1,1,0,1,0,0,6,5,0,1
1990,Cowlitz,WA,53015,356,226,9,0,121,4,0,4,0,0,352,226,5,121
1990,Douglas,WA,53017,71,69,1,0,1,12,10,1,0,1,59,59,0,0
1990,Ferry,WA,53019,7,6,1,0,0,1,0,1,0,0,6,6,0,0
1990,Franklin,WA,53021,129,112,5,3,9,16,6,5,3,2,113,106,0,7
1990,Garfield,WA,53023,3,2,0,0,1,1,1,0,0,0,2,1,0,1
1990,Grant,WA,53025,167,136,2,8,21,32,17,2,8,5,135,119,0,16
1990,Grays Harbor,WA,53027,249,222,4,0,23,7,4,3,0,0,242,218,1,23
1990,Island,WA,53029,152,140,0,0,12,17,16,0,0,1,135,124,0,11
1990,Jefferson,WA,53031,42,30,0,0,12,7,5,0,0,2,35,25,0,10
1990,King,WA,53033,4382,3208,135,0,1039,758,513,132,0,113,3624,2695,3,926
1990,Kitsap,WA,53035,687,488,7,0,192,97,68,6,0,23,590,420,1,169
1990,Kittitas,WA,53037,44,40,1,0,3,5,3,1,0,1,39,37,0,2
1990,Klickitat,WA,53039,45,40,0,1,4,6,4,0,1,1,39,36,0,3
1990,Lewis,WA,53041,138,115,0,0,23,1,1,0,0,0,137,114,0,23
1990,Lincoln,WA,53043,18,14,0,1,3,2,1,0,1,0,16,13,0,3
1990,Mason,WA,53045,103,86,1,0,16,19,17,1,0,1,84,69,0,15
1990,Okanogan,WA,53047,55,46,3,0,6,11,5,3,0,3,44,41,0,3
1990,Pacific,WA,53049,48,42,2,0,4,2,0,2,0,0,46,42,0,4
1990,Pend Oreille,WA,53051,28,17,2,1,8,8,3,2,1,2,20,14,0,6
1990,Pierce,WA,53053,2338,1806,35,1,496,55,25,27,1,2,2283,1781,8,494
1990,San Juan,WA,53055,9,5,1,0,3,7,5,1,0,1,2,0,0,2
1990,Skagit,WA,53057,196,176,3,0,17,44,37,3,0,4,152,139,0,13
1990,Skamania,WA,53059,13,10,0,0,3,1,1,0,0,0,12,9,0,3
1990,Snohomish,WA,53061,2092,1444,47,1,600,316,199,44,1,72,1776,1245,3,528
1990,Spokane,WA,53063,1647,1161,44,2,440,224,130,44,2,48,1423,1031,0,392
1990,Stevens,WA,53065,112,81,6,0,25,17,8,6,0,3,95,73,0,22
1990,Thurston,WA,53067,643,567,13,0,63,18,7,10,0,1,625,560,3,62
1990,Wahkiakum,WA,53069,12,9,0,0,3,0,0,0,0,0,12,9,0,3
1990,Walla Walla,WA,53071,200,176,3,2,19,15,7,3,2,3,185,169,0,16
1990,Whatcom,WA,53073,197,155,4,1,37,51,37,4,1,9,146,118,0,28
1990,Whitman,WA,53075,31,17,2,3,9,8,2,2,3,1,23,15,0,8
1990,Yakima,WA,53077,578,496,12,9,61,79,47,12,9,11,499,449,0,50
1990,Barbour,WV,54001,14,13,0,0,1,2,2,0,0,0,12,11,0,1
1990,Berkeley,WV,54003,146,140,0,0,6,9,7,0,0,2,137,133,0,4
1990,Boone,WV,54005,47,41,1,0,5,6,5,1,0,0,41,36,0,5
1990,Braxton,WV,54007,19,18,1,0,0,9,8,1,0,0,10,10,0,0
1990,Brooke,WV,54009,32,32,0,0,0,0,0,0,0,0,32,32,0,0
1990,Cabell,WV,54011,233,185,6,0,42,29,19,6,0,4,204,166,0,38
1990,Calhoun,WV,54013,7,6,0,0,1,1,1,0,0,0,6,5,0,1
1990,Clay,WV,54015,13,9,0,0,4,2,2,0,0,0,11,7,0,4
1990,Doddridge,WV,54017,17,13,0,0,4,0,0,0,0,0,17,13,0,4
1990,Fayette,WV,54019,106,102,1,0,3,7,6,1,0,0,99,96,0,3
1990,Gilmer,WV,54021,13,11,0,0,2,0,0,0,0,0,13,11,0,2
1990,Grant,WV,54023,9,8,1,0,0,2,1,1,0,0,7,7,0,0
1990,Greenbrier,WV,54025,81,72,4,1,4,16,11,4,1,0,65,61,0,4
1990,Hampshire,WV,54027,15,15,0,0,0,2,2,0,0,0,13,13,0,0
1990,Hancock,WV,54029,55,53,1,0,1,1,0,1,0,0,54,53,0,1
1990,Hardy,WV,54031,13,10,1,0,2,4,3,1,0,0,9,7,0,2
1990,Harrison,WV,54033,159,129,8,0,22,24,15,8,0,1,135,114,0,21
1990,Jackson,WV,54035,44,40,0,0,4,3,3,0,0,0,41,37,0,4
1990,Jefferson,WV,54037,80,70,6,0,4,11,4,6,0,1,69,66,0,3
1990,Kanawha,WV,54039,630,562,12,0,56,48,34,12,0,2,582,528,0,54
1990,Lewis,WV,54041,39,32,0,0,7,4,4,0,0,0,35,28,0,7
1990,Lincoln,WV,54043,31,28,0,0,3,1,1,0,0,0,30,27,0,3
1990,Logan,WV,54045,92,78,8,0,6,16,8,8,0,0,76,70,0,6
1990,McDowell,WV,54047,32,32,0,0,0,0,0,0,0,0,32,32,0,0
1990,Marion,WV,54049,85,72,1,0,12,13,8,1,0,4,72,64,0,8
1990,Marshall,WV,54051,35,31,1,0,3,4,2,1,0,1,31,29,0,2
1990,Mason,WV,54053,35,30,0,0,5,3,3,0,0,0,32,27,0,5
1990,Mercer,WV,54055,190,183,3,0,4,9,6,3,0,0,181,177,0,4
1990,Mineral,WV,54057,25,25,0,0,0,1,1,0,0,0,24,24,0,0
1990,Mingo,WV,54059,90,76,2,0,12,7,5,2,0,0,83,71,0,12
1990,Monongalia,WV,54061,114,103,5,0,6,9,4,4,0,1,105,99,1,5
1990,Monroe,WV,54063,23,23,0,0,0,0,0,0,0,0,23,23,0,0
1990,Morgan,WV,54065,15,14,0,0,1,0,0,0,0,0,15,14,0,1
1990,Nicholas,WV,54067,87,79,3,0,5,14,11,3,0,0,73,68,0,5
1990,Ohio,WV,54069,65,64,0,0,1,8,8,0,0,0,57,56,0,1
1990,Pendleton,WV,54071,9,8,0,0,1,1,1,0,0,0,8,7,0,1
1990,Pleasants,WV,54073,16,16,0,0,0,2,2,0,0,0,14,14,0,0
1990,Pocahontas,WV,54075,8,6,1,0,1,3,2,1,0,0,5,4,0,1
1990,Preston,WV,54077,67,53,10,0,4,17,6,10,0,1,50,47,0,3
1990,Putnam,WV,54079,85,64,0,0,21,11,9,0,0,2,74,55,0,19
1990,Raleigh,WV,54081,162,147,7,0,8,16,9,7,0,0,146,138,0,8
1990,Randolph,WV,54083,26,26,0,0,0,6,6,0,0,0,20,20,0,0
1990,Ritchie,WV,54085,13,13,0,0,0,1,1,0,0,0,12,12,0,0
1990,Roane,WV,54087,26,22,0,0,4,0,0,0,0,0,26,22,0,4
1990,Summers,WV,54089,24,23,1,0,0,2,1,1,0,0,22,22,0,0
1990,Taylor,WV,54091,38,30,0,0,8,2,2,0,0,0,36,28,0,8
1990,Tucker,WV,54093,15,13,2,0,0,7,5,2,0,0,8,8,0,0
1990,Tyler,WV,54095,6,6,0,0,0,1,1,0,0,0,5,5,0,0
1990,Upshur,WV,54097,42,37,1,0,4,3,3,0,0,0,39,34,1,4
1990,Wayne,WV,54099,79,70,1,0,8,6,5,1,0,0,73,65,0,8
1990,Webster,WV,54101,17,12,0,0,5,3,2,0,0,1,14,10,0,4
1990,Wetzel,WV,54103,20,20,0,0,0,3,3,0,0,0,17,17,0,0
1990,Wirt,WV,54105,14,13,0,0,1,2,2,0,0,0,12,11,0,1
1990,Wood,WV,54107,191,185,3,0,3,15,10,3,0,2,176,175,0,1
1990,Wyoming,WV,54109,63,62,0,0,1,7,6,0,0,1,56,56,0,0
1990,Adams,WI,55001,35,32,1,0,2,6,5,1,0,0,29,27,0,2
1990,Ashland,WI,55003,17,15,1,0,1,6,5,1,0,0,11,10,0,1
1990,Barron,WI,55005,73,71,1,0,1,21,19,1,0,1,52,52,0,0
1990,Bayfield,WI,55007,18,17,1,0,0,7,6,1,0,0,11,11,0,0
1990,Brown,WI,55009,417,403,1,0,13,43,43,0,0,0,374,360,1,13
1990,Buffalo,WI,55011,22,20,0,1,1,3,2,0,1,0,19,18,0,1
1990,Burnett,WI,55013,22,21,0,0,1,5,5,0,0,0,17,16,0,1
1990,Calumet,WI,55015,39,35,0,1,3,5,4,0,1,0,34,31,0,3
1990,Chippewa,WI,55017,79,69,5,0,5,22,16,5,0,1,57,53,0,4
1990,Clark,WI,55019,38,35,1,0,2,20,18,1,0,1,18,17,0,1
1990,Columbia,WI,55021,101,83,2,0,16,23,18,2,0,3,78,65,0,13
1990,Crawford,WI,55023,23,22,0,0,1,8,7,0,0,1,15,15,0,0
1990,Dane,WI,55025,906,633,19,4,250,144,104,18,4,18,762,529,1,232
1990,Dodge,WI,55027,131,127,0,0,4,12,11,0,0,1,119,116,0,3
1990,Door,WI,55029,38,37,0,0,1,5,5,0,0,0,33,32,0,1
1990,Douglas,WI,55031,61,59,2,0,0,11,9,2,0,0,50,50,0,0
1990,Dunn,WI,55033,55,46,4,1,4,22,16,4,1,1,33,30,0,3
1990,Eau Claire,WI,55035,146,125,10,1,10,35,24,10,1,0,111,101,0,10
1990,Florence,WI,55037,4,4,0,0,0,1,1,0,0,0,3,3,0,0
1990,Fond du Lac,WI,55039,202,185,2,1,14,18,14,2,1,1,184,171,0,13
1990,Forest,WI,55041,17,17,0,0,0,0,0,0,0,0,17,17,0,0
1990,Grant,WI,55043,41,37,1,1,2,16,12,1,1,2,25,25,0,0
1990,Green,WI,55045,66,56,0,3,7,17,13,0,3,1,49,43,0,6
1990,Green Lake,WI,55047,42,36,2,2,2,12,8,2,2,0,30,28,0,2
1990,Iowa,WI,55049,29,23,1,1,4,10,7,1,1,1,19,16,0,3
1990,Iron,WI,55051,4,4,0,0,0,1,1,0,0,0,3,3,0,0
1990,Jackson,WI,55053,31,27,1,1,2,12,9,1,1,1,19,18,0,1
1990,Jefferson,WI,55055,150,134,1,0,15,27,26,1,0,0,123,108,0,15
1990,Juneau,WI,55057,50,38,3,4,5,15,7,3,4,1,35,31,0,4
1990,Kenosha,WI,55059,383,322,3,0,58,23,19,2,0,2,360,303,1,56
1990,Kewaunee,WI,55061,22,21,0,1,0,3,2,0,1,0,19,19,0,0
1990,La Crosse,WI,55063,198,182,6,1,9,30,22,6,1,1,168,160,0,8
1990,Lafayette,WI,55065,19,17,0,0,2,7,7,0,0,0,12,10,0,2
1990,Langlade,WI,55067,31,26,3,0,2,6,3,3,0,0,25,23,0,2
1990,Lincoln,WI,55069,43,41,1,0,1,12,11,1,0,0,31,30,0,1
1990,Manitowoc,WI,55071,106,99,1,1,5,14,13,0,1,0,92,86,1,5
1990,Marathon,WI,55073,140,127,0,1,12,33,28,0,1,4,107,99,0,8
1990,Marinette,WI,55075,58,57,0,0,1,11,11,0,0,0,47,46,0,1
1990,Marquette,WI,55077,23,20,0,0,3,4,4,0,0,0,19,16,0,3
1990,Menominee,WI,55078,3,1,0,0,2,2,0,0,0,2,1,1,0,0
1990,Milwaukee,WI,55079,3189,2632,25,0,532,162,109,24,0,29,3027,2523,1,503
1990,Monroe,WI,55081,54,48,0,0,6,10,10,0,0,0,44,38,0,6
1990,Oconto,WI,55083,54,46,3,3,2,8,4,1,3,0,46,42,2,2
1990,Oneida,WI,55085,88,85,0,0,3,15,13,0,0,2,73,72,0,1
1990,Outagamie,WI,55087,241,228,4,0,9,23,19,2,0,2,218,209,2,7
1990,Ozaukee,WI,55089,94,79,3,0,12,11,5,3,0,3,83,74,0,9
1990,Pepin,WI,55091,6,4,1,1,0,3,1,1,1,0,3,3,0,0
1990,Pierce,WI,55093,80,69,5,0,6,25,18,5,0,2,55,51,0,4
1990,Polk,WI,55095,87,79,3,1,4,24,18,3,1,2,63,61,0,2
1990,Portage,WI,55097,65,57,2,1,5,28,22,2,1,3,37,35,0,2
1990,Price,WI,55099,21,17,4,0,0,11,7,4,0,0,10,10,0,0
1990,Racine,WI,55101,531,417,4,0,110,29,14,4,0,11,502,403,0,99
1990,Richland,WI,55103,19,16,2,1,0,12,9,2,1,0,7,7,0,0
1990,Rock,WI,55105,396,314,2,3,77,60,47,2,3,8,336,267,0,69
1990,Rusk,WI,55107,19,17,1,0,1,9,7,1,0,1,10,10,0,0
1990,St. Croix,WI,55109,114,95,4,0,15,34,25,4,0,5,80,70,0,10
1990,Sauk,WI,55111,91,81,0,1,9,15,14,0,1,0,76,67,0,9
1990,Sawyer,WI,55113,21,20,0,0,1,5,5,0,0,0,16,15,0,1
1990,Shawano,WI,55115,59,56,0,0,3,10,9,0,0,1,49,47,0,2
1990,Sheboygan,WI,55117,253,235,2,1,15,21,17,2,1,1,232,218,0,14
1990,Taylor,WI,55119,11,11,0,0,0,5,5,0,0,0,6,6,0,0
1990,Trempealeau,WI,55121,40,36,3,1,0,9,5,3,1,0,31,31,0,0
1990,Vernon,WI,55123,42,34,2,6,0,13,5,2,6,0,29,29,0,0
1990,Vilas,WI,55125,29,29,0,0,0,10,10,0,0,0,19,19,0,0
1990,Walworth,WI,55127,134,125,1,2,6,15,13,0,2,0,119,112,1,6
1990,Washburn,WI,55129,24,23,0,0,1,4,4,0,0,0,20,19,0,1
1990,Washington,WI,55131,128,119,0,0,9,8,8,0,0,0,120,111,0,9
1990,Waukesha,WI,55133,482,428,13,0,41,58,43,12,0,3,424,385,1,38
1990,Waupaca,WI,55135,108,104,1,0,3,8,7,1,0,0,100,97,0,3
1990,Waushara,WI,55137,36,36,0,0,0,3,3,0,0,0,33,33,0,0
1990,Winnebago,WI,55139,272,251,5,0,16,24,19,5,0,0,248,232,0,16
1990,Wood,WI,55141,103,96,1,3,3,26,21,1,3,1,77,75,0,2
1990,Albany,WY,56001,65,59,1,0,5,4,4,0,0,0,61,55,1,5
1990,Big Horn,WY,56003,26,17,3,1,5,5,1,3,1,0,21,16,0,5
1990,Campbell,WY,56005,111,99,3,0,8,9,5,3,1,0,102,94,0,8
1990,Carbon,WY,56007,46,35,1,0,10,2,0,1,0,1,44,35,0,9
1990,Converse,WY,56009,34,29,0,0,5,4,3,0,0,1,30,26,0,4
1990,Crook,WY,56011,9,8,0,1,0,2,1,0,1,0,7,7,0,0
1990,Fremont,WY,56013,67,64,2,0,1,9,7,2,0,0,58,57,0,1
1990,Goshen,WY,56015,31,26,1,3,1,6,2,1,3,0,25,24,0,1
1990,Hot Springs,WY,56017,9,9,0,0,0,1,1,0,0,0,8,8,0,0
1990,Johnson,WY,56019,9,7,0,1,1,3,2,0,1,0,6,5,0,1
1990,Laramie,WY,56021,318,257,4,0,57,13,7,4,0,2,305,250,0,55
1990,Lincoln,WY,56023,25,25,0,0,0,0,0,0,0,0,25,25,0,0
1990,Natrona,WY,56025,250,216,8,0,26,23,12,7,0,4,227,204,1,22
1990,Niobrara,WY,56027,6,5,0,1,0,2,1,0,1,0,4,4,0,0
1990,Park,WY,56029,38,26,3,0,9,7,2,2,0,3,31,24,1,6
1990,Platte,WY,56031,30,23,4,0,3,7,2,3,0,2,23,21,1,1
1990,Sheridan,WY,56033,46,41,3,0,2,14,11,3,0,0,32,30,0,2
1990,Sublette,WY,56035,6,6,0,0,0,1,1,0,0,0,5,5,0,0
1990,Sweetwater,WY,56037,153,138,1,0,14,1,1,0,0,0,152,137,1,14
1990,Teton,WY,56039,22,19,1,0,2,5,4,0,0,1,17,15,1,1
1990,Uinta,WY,56041,65,62,0,0,3,4,4,0,0,0,61,58,0,3
1990,Washakie,WY,56043,22,19,2,0,1,6,3,2,0,1,16,16,0,0
1990,Weston,WY,56045,17,13,2,0,2,4,2,2,0,0,13,11,0,2
