STATE,DISTRICT,DISTRICT_NS,CIRCUIT,TOTAL_FILINGS,CHAP_7,CHAP_11,CHAP_12,CHAP_13,TOTAL_BUSINESS_FILINGS,BCHAP_7,BCHAP_11,BCHAP_12,BCHAP_13,TOTAL_NON_BUSINESS_FILINGS,NBCHAP_7,NBCHAP_11,NBCHAP_13,QTR_ENDED,DATE,FISCAL_YEAR
DISTRICT OF COLUMBIA,DISTRICT OF COLUMBIA,DC,DC CIRCUIT,2413,1555,66,0,791,109,35,50,0,23,2304,1520,16,768,09/30/97,1997-09-30,1997
MAINE,MAINE,ME,FIRST CIRCUIT,3990,3596,16,2,376,315,220,16,2,77,3675,3376,0,299,09/30/97,1997-09-30,1997
MASSACHUSETTS,MASSACHUSETTS,MA,FIRST CIRCUIT,23401,19955,323,0,3122,1000,573,312,0,114,22401,19382,11,3008,09/30/97,1997-09-30,1997
NEW HAMPSHIRE,NEW HAMPSHIRE,NH,FIRST CIRCUIT,4586,4261,42,3,280,103,58,39,3,3,4483,4203,3,277,09/30/97,1997-09-30,1997
RHODE ISLAND,RHODE ISLAND,RI,FIRST CIRCUIT,5273,5037,24,0,212,177,135,24,0,18,5096,4902,0,194,09/30/97,1997-09-30,1997
PUERTO RICO,PUERTO RICO,PR,FIRST CIRCUIT,14164,4226,106,3,9829,161,79,75,3,4,14003,4147,31,9825,09/30/97,1997-09-30,1997
CONNECTICUT,CONNECTICUT,CT,SECOND CIRCUIT,13160,11550,138,3,1469,206,97,104,3,2,12954,11453,34,1467,09/30/97,1997-09-30,1997
NEW YORK,NEW YORK NORTHERN,NYN,SECOND CIRCUIT,15837,13262,91,32,2451,772,483,90,32,166,15065,12779,1,2285,09/30/97,1997-09-30,1997
NEW YORK,NEW YORK EASTERN,NYE,SECOND CIRCUIT,28535,23098,404,0,5033,530,205,319,0,6,28005,22893,85,5027,09/30/97,1997-09-30,1997
NEW YORK,NEW YORK SOUTHERN,NYS,SECOND CIRCUIT,15693,13337,622,1,1726,868,265,570,1,25,14825,13072,52,1701,09/30/97,1997-09-30,1997
NEW YORK,NEW YORK WESTERN,NYW,SECOND CIRCUIT,12620,9413,87,8,3112,983,642,84,8,249,11637,8771,3,2863,09/30/97,1997-09-30,1997
VERMONT,VERMONT,VT,SECOND CIRCUIT,1812,1661,27,4,120,157,106,24,4,23,1655,1555,3,97,09/30/97,1997-09-30,1997
DELAWARE,DELAWARE,DE,THIRD CIRCUIT,2545,1567,227,1,750,252,25,226,1,0,2293,1542,1,750,09/30/97,1997-09-30,1997
NEW JERSEY,NEW JERSEY,NJ,THIRD CIRCUIT,40872,28445,671,1,11753,1124,554,542,1,25,39748,27891,129,11728,09/30/97,1997-09-30,1997
PENNSYLVANIA,PENNSYLVANIA EASTERN,PAE,THIRD CIRCUIT,20873,13085,294,13,7480,583,264,270,13,35,20290,12821,24,7445,09/30/97,1997-09-30,1997
PENNSYLVANIA,PENNSYLVANIA MIDDLE,PAM,THIRD CIRCUIT,8968,7532,93,7,1336,836,495,87,7,247,8132,7037,6,1089,09/30/97,1997-09-30,1997
PENNSYLVANIA,PENNSYLVANIA WESTERN,PAW,THIRD CIRCUIT,11050,9795,163,7,1085,471,290,142,7,32,10579,9505,21,1053,09/30/97,1997-09-30,1997
VIRGIN ISLANDS,VIRGIN ISLANDS,VI,THIRD CIRCUIT,69,46,10,0,13,20,10,10,0,0,49,36,0,13,09/30/97,1997-09-30,1997
MARYLAND,MARYLAND,MD,FOURTH CIRCUIT,30508,22351,304,5,7848,1632,1037,292,5,298,28876,21314,12,7550,09/30/97,1997-09-30,1997
NORTH CAROLINA,NORTH CAROLINA EASTERN,NCE,FOURTH CIRCUIT,9577,4520,60,10,4987,435,220,57,10,148,9142,4300,3,4839,09/30/97,1997-09-30,1997
NORTH CAROLINA,NORTH CAROLINA MIDDLE,NCM,FOURTH CIRCUIT,9025,2405,27,1,6592,178,131,26,1,20,8847,2274,1,6572,09/30/97,1997-09-30,1997
NORTH CAROLINA,NORTH CAROLINA WESTERN,NCW,FOURTH CIRCUIT,7069,2987,32,2,4048,83,49,31,2,1,6986,2938,1,4047,09/30/97,1997-09-30,1997
SOUTH CAROLINA,SOUTH CAROLINA,SC,FOURTH CIRCUIT,11076,5956,101,5,5014,335,125,87,5,118,10741,5831,14,4896,09/30/97,1997-09-30,1997
VIRGINIA,VIRGINIA EASTERN,VAE,FOURTH CIRCUIT,31223,22698,260,3,8262,800,419,225,3,153,30423,22279,35,8109,09/30/97,1997-09-30,1997
VIRGINIA,VIRGINIA WESTERN,VAW,FOURTH CIRCUIT,11032,9038,69,4,1921,604,452,66,4,82,10428,8586,3,1839,09/30/97,1997-09-30,1997
WEST VIRGINIA,WEST VIRGINIA NORTHERN,WVN,FOURTH CIRCUIT,3279,3067,18,1,193,155,112,18,1,24,3124,2955,0,169,09/30/97,1997-09-30,1997
WEST VIRGINIA,WEST VIRGINIA SOUTHERN,WVS,FOURTH CIRCUIT,4849,4506,27,0,316,189,133,26,0,30,4660,4373,1,286,09/30/97,1997-09-30,1997
LOUISIANA,LOUISIANA EASTERN,LAE,FIFTH CIRCUIT,7392,4782,72,2,2536,120,54,62,2,2,7272,4728,10,2534,09/30/97,1997-09-30,1997
LOUISIANA,LOUISIANA MIDDLE,LAM,FIFTH CIRCUIT,2882,1837,26,1,1018,60,30,25,1,4,2822,1807,1,1014,09/30/97,1997-09-30,1997
LOUISIANA,LOUISIANA WESTERN,LAW,FIFTH CIRCUIT,12830,5407,45,69,7309,508,263,43,69,133,12322,5144,2,7176,09/30/97,1997-09-30,1997
MISSISSIPPI,MISSISSIPPI NORTHERN,MSN,FIFTH CIRCUIT,6410,3822,22,15,2550,138,71,21,15,30,6272,3751,1,2520,09/30/97,1997-09-30,1997
MISSISSIPPI,MISSISSIPPI SOUTHERN,MSS,FIFTH CIRCUIT,12515,6862,42,6,5605,134,67,40,6,21,12381,6795,2,5584,09/30/97,1997-09-30,1997
TEXAS,TEXAS NORTHERN,TXN,FIFTH CIRCUIT,24740,12003,261,55,12420,1542,690,247,55,549,23198,11313,14,11871,09/30/97,1997-09-30,1997
TEXAS,TEXAS EASTERN,TXE,FIFTH CIRCUIT,9572,4229,61,16,5266,534,205,57,16,256,9038,4024,4,5010,09/30/97,1997-09-30,1997
TEXAS,TEXAS SOUTHERN,TXS,FIFTH CIRCUIT,19205,10193,261,11,8740,724,287,225,11,201,18481,9906,36,8539,09/30/97,1997-09-30,1997
TEXAS,TEXAS WESTERN,TXW,FIFTH CIRCUIT,17587,9278,192,11,8106,668,319,175,11,163,16919,8959,17,7943,09/30/97,1997-09-30,1997
KENTUCKY,KENTUCKY EASTERN,KYE,SIXTH CIRCUIT,9425,8167,27,3,1228,273,200,26,3,44,9152,7967,1,1184,09/30/97,1997-09-30,1997
KENTUCKY,KENTUCKY WESTERN,KYW,SIXTH CIRCUIT,11763,9355,47,5,2356,180,115,47,5,13,11583,9240,0,2343,09/30/97,1997-09-30,1997
MICHIGAN,MICHIGAN EASTERN,MIE,SIXTH CIRCUIT,26163,19273,253,13,6624,650,338,244,13,55,25513,18935,9,6569,09/30/97,1997-09-30,1997
MICHIGAN,MICHIGAN WESTERN,MIW,SIXTH CIRCUIT,11720,8615,83,14,3008,505,284,82,14,125,11215,8331,1,2883,09/30/97,1997-09-30,1997
OHIO,OHIO NORTHERN,OHN,SIXTH CIRCUIT,25329,20734,79,10,4506,494,320,76,10,88,24835,20414,3,4418,09/30/97,1997-09-30,1997
OHIO,OHIO SOUTHERN,OHS,SIXTH CIRCUIT,26947,20089,112,8,6738,549,327,107,8,107,26398,19762,5,6631,09/30/97,1997-09-30,1997
TENNESSEE,TENNESSEE EASTERN,TNE,SIXTH CIRCUIT,16320,8138,59,8,8115,416,182,56,8,170,15904,7956,3,7945,09/30/97,1997-09-30,1997
TENNESSEE,TENNESSEE MIDDLE,TNM,SIXTH CIRCUIT,12599,6569,115,2,5913,497,232,108,2,155,12102,6337,7,5758,09/30/97,1997-09-30,1997
TENNESSEE,TENNESSEE WESTERN,TNW,SIXTH CIRCUIT,24223,5679,77,3,18463,191,71,66,3,50,24032,5608,11,18413,09/30/97,1997-09-30,1997
ILLINOIS,ILLINOIS NORTHERN,ILN,SEVENTH CIRCUIT,43237,32020,274,0,10942,832,526,257,0,48,42405,31494,17,10894,09/30/97,1997-09-30,1997
ILLINOIS,ILLINOIS CENTRAL,ILC,SEVENTH CIRCUIT,12347,10743,28,20,1556,364,270,28,20,46,11983,10473,0,1510,09/30/97,1997-09-30,1997
ILLINOIS,ILLINOIS SOUTHERN,ILS,SEVENTH CIRCUIT,6783,5041,23,5,1714,593,442,23,5,123,6190,4599,0,1591,09/30/97,1997-09-30,1997
INDIANA,INDIANA NORTHERN,INN,SEVENTH CIRCUIT,13037,11213,55,7,1762,215,131,53,7,24,12822,11082,2,1738,09/30/97,1997-09-30,1997
INDIANA,INDIANA SOUTHERN,INS,SEVENTH CIRCUIT,22475,18706,95,10,3664,483,311,91,10,71,21992,18395,4,3593,09/30/97,1997-09-30,1997
WISCONSIN,WISCONSIN EASTERN,WIE,SEVENTH CIRCUIT,12464,10426,23,7,2008,374,292,23,7,52,12090,10134,0,1956,09/30/97,1997-09-30,1997
WISCONSIN,WISCONSIN WESTERN,WIW,SEVENTH CIRCUIT,6197,5600,60,25,512,860,702,57,25,76,5337,4898,3,436,09/30/97,1997-09-30,1997
ARKANSAS,ARKANSAS EASTERN,ARE,EIGHTH CIRCUIT,9808,4962,42,7,4797,282,132,41,7,102,9526,4830,1,4695,09/30/97,1997-09-30,1997
ARKANSAS,ARKANSAS WESTERN,ARW,EIGHTH CIRCUIT,5452,3525,23,11,1893,245,125,19,11,90,5207,3400,4,1803,09/30/97,1997-09-30,1997
IOWA,IOWA NORTHERN,IAN,EIGHTH CIRCUIT,3950,3782,14,9,145,247,202,14,9,22,3703,3580,0,123,09/30/97,1997-09-30,1997
IOWA,IOWA SOUTHERN,IAS,EIGHTH CIRCUIT,5839,5250,18,5,566,308,257,17,5,29,5531,4993,1,537,09/30/97,1997-09-30,1997
MINNESOTA,MINNESOTA,MN,EIGHTH CIRCUIT,20248,15321,82,22,4823,2486,1846,82,22,536,17762,13475,0,4287,09/30/97,1997-09-30,1997
MISSOURI,MISSOURI EASTERN,MOE,EIGHTH CIRCUIT,14380,8702,59,3,5616,315,200,57,3,55,14065,8502,2,5561,09/30/97,1997-09-30,1997
MISSOURI,MISSOURI WESTERN,MOW,EIGHTH CIRCUIT,10774,9194,73,12,1495,440,273,70,12,85,10334,8921,3,1410,09/30/97,1997-09-30,1997
NEBRASKA,NEBRASKA,NE,EIGHTH CIRCUIT,5835,4807,19,55,952,281,163,17,55,44,5554,4644,2,908,09/30/97,1997-09-30,1997
NORTH DAKOTA,NORTH DAKOTA,ND,EIGHTH CIRCUIT,1895,1765,8,45,77,167,99,7,45,16,1728,1666,1,61,09/30/97,1997-09-30,1997
SOUTH DAKOTA,SOUTH DAKOTA,SD,EIGHTH CIRCUIT,2247,2061,17,34,135,233,141,17,34,41,2014,1920,0,94,09/30/97,1997-09-30,1997
ALASKA,ALASKA,AK,NINTH CIRCUIT,1361,1222,20,0,119,159,101,19,0,39,1202,1121,1,80,09/30/97,1997-09-30,1997
ARIZONA,ARIZONA,AZ,NINTH CIRCUIT,24534,18920,307,7,5299,868,447,275,7,138,23666,18473,32,5161,09/30/97,1997-09-30,1997
CALIFORNIA,CALIFORNIA NORTHERN,CAN,NINTH CIRCUIT,34559,24914,338,1,9304,2200,1095,273,1,829,32359,23819,65,8475,09/30/97,1997-09-30,1997
CALIFORNIA,CALIFORNIA EASTERN,CAE,NINTH CIRCUIT,36080,30649,175,35,5219,2608,1711,161,35,699,33472,28938,14,4520,09/30/97,1997-09-30,1997
CALIFORNIA,CALIFORNIA CENTRAL,CAC,NINTH CIRCUIT,115686,94091,946,7,20641,6189,4328,787,7,1066,109497,89763,159,19575,09/30/97,1997-09-30,1997
CALIFORNIA,CALIFORNIA SOUTHERN,CAS,NINTH CIRCUIT,19159,14314,104,1,4740,231,142,73,1,15,18928,14172,31,4725,09/30/97,1997-09-30,1997
HAWAII,HAWAII,HI,NINTH CIRCUIT,4161,3702,50,0,409,189,121,45,0,23,3972,3581,5,386,09/30/97,1997-09-30,1997
IDAHO,IDAHO,ID,NINTH CIRCUIT,6604,5028,38,40,1498,514,282,35,40,157,6090,4746,3,1341,09/30/97,1997-09-30,1997
MONTANA,MONTANA,MT,NINTH CIRCUIT,3379,2582,25,23,749,267,139,20,23,85,3112,2443,5,664,09/30/97,1997-09-30,1997
NEVADA,NEVADA,NV,NINTH CIRCUIT,12896,9160,175,2,3556,429,180,169,2,75,12467,8980,6,3481,09/30/97,1997-09-30,1997
OREGON,OREGON,OR,NINTH CIRCUIT,18044,14404,48,5,3587,1082,758,46,5,273,16962,13646,2,3314,09/30/97,1997-09-30,1997
WASHINGTON,WASHINGTON EASTERN,WAE,NINTH CIRCUIT,6898,5715,67,9,1107,518,333,66,9,110,6380,5382,1,997,09/30/97,1997-09-30,1997
WASHINGTON,WASHINGTON WESTERN,WAW,NINTH CIRCUIT,25674,20443,270,4,4957,913,499,244,4,166,24761,19944,26,4791,09/30/97,1997-09-30,1997
GUAM,GUAM,GUAM,NINTH CIRCUIT,111,88,2,0,21,23,21,2,0,0,88,67,0,21,09/30/97,1997-09-30,1997
NORTHERN MARIANA ISLANDS,NORTHERN MARIANAS,NMI,NINTH CIRCUIT,4,4,0,0,0,2,2,0,0,0,2,2,0,0,09/30/97,1997-09-30,1997
COLORADO,COLORADO,CO,TENTH CIRCUIT,18722,15168,123,23,3406,625,432,119,23,49,18097,14736,4,3357,09/30/97,1997-09-30,1997
KANSAS,KANSAS,KS,TENTH CIRCUIT,12856,10110,72,22,2652,416,229,66,22,99,12440,9881,6,2553,09/30/97,1997-09-30,1997
NEW MEXICO,NEW MEXICO,NM,TENTH CIRCUIT,7259,5152,59,7,2041,404,230,54,7,113,6855,4922,5,1928,09/30/97,1997-09-30,1997
OKLAHOMA,OKLAHOMA NORTHERN,OKN,TENTH CIRCUIT,5955,4898,42,5,1010,648,483,39,5,121,5307,4415,3,889,09/30/97,1997-09-30,1997
OKLAHOMA,OKLAHOMA EASTERN,OKE,TENTH CIRCUIT,3231,2905,18,16,291,157,96,18,16,26,3074,2809,0,265,09/30/97,1997-09-30,1997
OKLAHOMA,OKLAHOMA WESTERN,OKW,TENTH CIRCUIT,12645,9961,64,33,2587,605,391,63,33,118,12040,9570,1,2469,09/30/97,1997-09-30,1997
UTAH,UTAH,UT,TENTH CIRCUIT,11442,6426,66,7,4943,411,229,63,7,112,11031,6197,3,4831,09/30/97,1997-09-30,1997
WYOMING,WYOMING,WY,TENTH CIRCUIT,2054,1802,15,3,234,94,52,14,3,25,1960,1750,1,209,09/30/97,1997-09-30,1997
ALABAMA,ALABAMA NORTHERN,ALN,ELEVENTH CIRCUIT,22518,8226,95,2,14195,438,171,87,2,178,22080,8055,8,14017,09/30/97,1997-09-30,1997
ALABAMA,ALABAMA MIDDLE,ALM,ELEVENTH CIRCUIT,6634,2602,27,8,3997,276,131,27,8,110,6358,2471,0,3887,09/30/97,1997-09-30,1997
ALABAMA,ALABAMA SOUTHERN,ALS,ELEVENTH CIRCUIT,4822,2141,31,1,2649,185,72,28,1,84,4637,2069,3,2565,09/30/97,1997-09-30,1997
FLORIDA,FLORIDA NORTHERN,FLN,ELEVENTH CIRCUIT,4563,3739,41,1,782,125,56,37,1,31,4438,3683,4,751,09/30/97,1997-09-30,1997
FLORIDA,FLORIDA MIDDLE,FLM,ELEVENTH CIRCUIT,41253,32785,338,10,8119,1213,641,302,10,259,40040,32144,36,7860,09/30/97,1997-09-30,1997
FLORIDA,FLORIDA SOUTHERN,FLS,ELEVENTH CIRCUIT,24867,18876,331,3,5654,774,441,303,3,24,24093,18435,28,5630,09/30/97,1997-09-30,1997
GEORGIA,GEORGIA NORTHERN,GAN,ELEVENTH CIRCUIT,34257,12888,209,4,21156,1173,487,192,4,490,33084,12401,17,20666,09/30/97,1997-09-30,1997
GEORGIA,GEORGIA MIDDLE,GAM,ELEVENTH CIRCUIT,14782,5288,43,33,9418,180,55,41,33,51,14602,5233,2,9367,09/30/97,1997-09-30,1997
GEORGIA,GEORGIA SOUTHERN,GAS,ELEVENTH CIRCUIT,12265,2743,33,9,9480,350,126,32,9,183,11915,2617,1,9297,09/30/97,1997-09-30,1997
DISTRICT OF COLUMBIA,DISTRICT OF COLUMBIA,DC,DC CIRCUIT,2852,1928,55,0,869,85,28,47,0,10,2767,1900,8,859,09/30/98,1998-09-30,1998
MAINE,MAINE,ME,FIRST CIRCUIT,4511,4118,18,2,373,247,171,18,2,56,4264,3947,0,317,09/30/98,1998-09-30,1998
MASSACHUSETTS,MASSACHUSETTS,MA,FIRST CIRCUIT,22140,19011,235,1,2892,808,495,233,1,78,21332,18516,2,2814,09/30/98,1998-09-30,1998
NEW HAMPSHIRE,NEW HAMPSHIRE,NH,FIRST CIRCUIT,4986,4641,32,0,313,414,366,31,0,17,4572,4275,1,296,09/30/98,1998-09-30,1998
RHODE ISLAND,RHODE ISLAND,RI,FIRST CIRCUIT,5446,5162,16,0,268,145,119,15,0,11,5301,5043,1,257,09/30/98,1998-09-30,1998
PUERTO RICO,PUERTO RICO,PR,FIRST CIRCUIT,18072,5528,83,0,12461,141,80,60,0,1,17931,5448,23,12460,09/30/98,1998-09-30,1998
CONNECTICUT,CONNECTICUT,CT,SECOND CIRCUIT,13876,12346,108,2,1419,178,89,83,2,3,13698,12257,25,1416,09/30/98,1998-09-30,1998
NEW YORK,NEW YORK NORTHERN,NYN,SECOND CIRCUIT,16571,14124,61,18,2368,596,395,56,18,127,15975,13729,5,2241,09/30/98,1998-09-30,1998
NEW YORK,NEW YORK EASTERN,NYE,SECOND CIRCUIT,31047,25332,304,0,5410,509,235,262,0,11,30538,25097,42,5399,09/30/98,1998-09-30,1998
NEW YORK,NEW YORK SOUTHERN,NYS,SECOND CIRCUIT,16639,14465,437,1,1724,651,227,396,1,15,15988,14238,41,1709,09/30/98,1998-09-30,1998
NEW YORK,NEW YORK WESTERN,NYW,SECOND CIRCUIT,13322,9971,69,11,3271,740,485,64,11,180,12582,9486,5,3091,09/30/98,1998-09-30,1998
VERMONT,VERMONT,VT,SECOND CIRCUIT,1938,1760,15,12,151,101,58,15,12,16,1837,1702,0,135,09/30/98,1998-09-30,1998
DELAWARE,DELAWARE,DE,THIRD CIRCUIT,2841,1763,329,0,749,337,11,326,0,0,2504,1752,3,749,09/30/98,1998-09-30,1998
NEW JERSEY,NEW JERSEY,NJ,THIRD CIRCUIT,45347,31878,493,3,12972,916,490,412,3,10,44431,31388,81,12962,09/30/98,1998-09-30,1998
PENNSYLVANIA,PENNSYLVANIA EASTERN,PAE,THIRD CIRCUIT,22822,14393,175,6,8248,420,231,152,6,31,22402,14162,23,8217,09/30/98,1998-09-30,1998
PENNSYLVANIA,PENNSYLVANIA MIDDLE,PAM,THIRD CIRCUIT,10607,9036,71,8,1492,858,527,66,8,257,9749,8509,5,1235,09/30/98,1998-09-30,1998
PENNSYLVANIA,PENNSYLVANIA WESTERN,PAW,THIRD CIRCUIT,12496,11068,141,6,1281,467,308,118,6,35,12029,10760,23,1246,09/30/98,1998-09-30,1998
VIRGIN ISLANDS,VIRGIN ISLANDS,VI,THIRD CIRCUIT,71,59,3,0,9,10,7,3,0,0,61,52,0,9,09/30/98,1998-09-30,1998
MARYLAND,MARYLAND,MD,FOURTH CIRCUIT,35023,25639,227,5,9152,1398,925,209,5,259,33625,24714,18,8893,09/30/98,1998-09-30,1998
NORTH CAROLINA,NORTH CAROLINA EASTERN,NCE,FOURTH CIRCUIT,10593,4963,43,13,5574,362,162,43,13,144,10231,4801,0,5430,09/30/98,1998-09-30,1998
NORTH CAROLINA,NORTH CAROLINA MIDDLE,NCM,FOURTH CIRCUIT,9163,2863,28,2,6270,183,142,27,2,12,8980,2721,1,6258,09/30/98,1998-09-30,1998
NORTH CAROLINA,NORTH CAROLINA WESTERN,NCW,FOURTH CIRCUIT,7101,3238,37,1,3825,77,37,37,1,2,7024,3201,0,3823,09/30/98,1998-09-30,1998
SOUTH CAROLINA,SOUTH CAROLINA,SC,FOURTH CIRCUIT,11451,6158,59,11,5223,276,138,50,11,77,11175,6020,9,5146,09/30/98,1998-09-30,1998
VIRGINIA,VIRGINIA EASTERN,VAE,FOURTH CIRCUIT,32391,23794,205,4,8388,613,340,170,4,99,31778,23454,35,8289,09/30/98,1998-09-30,1998
VIRGINIA,VIRGINIA WESTERN,VAW,FOURTH CIRCUIT,11094,9172,54,4,1864,590,438,51,4,97,10504,8734,3,1767,09/30/98,1998-09-30,1998
WEST VIRGINIA,WEST VIRGINIA NORTHERN,WVN,FOURTH CIRCUIT,3586,3381,22,1,182,198,150,22,1,25,3388,3231,0,157,09/30/98,1998-09-30,1998
WEST VIRGINIA,WEST VIRGINIA SOUTHERN,WVS,FOURTH CIRCUIT,5238,4914,27,0,297,165,115,26,0,24,5073,4799,1,273,09/30/98,1998-09-30,1998
LOUISIANA,LOUISIANA EASTERN,LAE,FIFTH CIRCUIT,7069,4744,65,5,2255,135,71,56,5,3,6934,4673,9,2252,09/30/98,1998-09-30,1998
LOUISIANA,LOUISIANA MIDDLE,LAM,FIFTH CIRCUIT,2896,1982,23,0,891,47,25,20,0,2,2849,1957,3,889,09/30/98,1998-09-30,1998
LOUISIANA,LOUISIANA WESTERN,LAW,FIFTH CIRCUIT,13002,5798,43,23,7138,430,233,42,23,132,12572,5565,1,7006,09/30/98,1998-09-30,1998
MISSISSIPPI,MISSISSIPPI NORTHERN,MSN,FIFTH CIRCUIT,6342,3854,37,14,2437,148,72,37,14,25,6194,3782,0,2412,09/30/98,1998-09-30,1998
MISSISSIPPI,MISSISSIPPI SOUTHERN,MSS,FIFTH CIRCUIT,12576,7348,37,4,5187,139,98,32,4,5,12437,7250,5,5182,09/30/98,1998-09-30,1998
TEXAS,TEXAS NORTHERN,TXN,FIFTH CIRCUIT,25093,13106,220,49,11717,1293,665,206,49,372,23800,12441,14,11345,09/30/98,1998-09-30,1998
TEXAS,TEXAS EASTERN,TXE,FIFTH CIRCUIT,9872,4795,47,8,5022,379,174,43,8,154,9493,4621,4,4868,09/30/98,1998-09-30,1998
TEXAS,TEXAS SOUTHERN,TXS,FIFTH CIRCUIT,19260,11408,196,8,7648,667,315,170,8,174,18593,11093,26,7474,09/30/98,1998-09-30,1998
TEXAS,TEXAS WESTERN,TXW,FIFTH CIRCUIT,17795,10143,132,11,7509,518,296,121,11,90,17277,9847,11,7419,09/30/98,1998-09-30,1998
KENTUCKY,KENTUCKY EASTERN,KYE,SIXTH CIRCUIT,9627,8330,22,5,1270,210,147,21,5,37,9417,8183,1,1233,09/30/98,1998-09-30,1998
KENTUCKY,KENTUCKY WESTERN,KYW,SIXTH CIRCUIT,12655,10132,44,12,2467,178,97,44,12,25,12477,10035,0,2442,09/30/98,1998-09-30,1998
MICHIGAN,MICHIGAN EASTERN,MIE,SIXTH CIRCUIT,28628,21310,143,8,7167,391,221,137,8,25,28237,21089,6,7142,09/30/98,1998-09-30,1998
MICHIGAN,MICHIGAN WESTERN,MIW,SIXTH CIRCUIT,12615,9542,55,16,3002,404,252,50,16,86,12211,9290,5,2916,09/30/98,1998-09-30,1998
OHIO,OHIO NORTHERN,OHN,SIXTH CIRCUIT,27677,22780,56,9,4832,558,392,55,9,102,27119,22388,1,4730,09/30/98,1998-09-30,1998
OHIO,OHIO SOUTHERN,OHS,SIXTH CIRCUIT,28325,21413,80,11,6821,488,313,73,11,91,27837,21100,7,6730,09/30/98,1998-09-30,1998
TENNESSEE,TENNESSEE EASTERN,TNE,SIXTH CIRCUIT,16122,8611,44,9,7458,377,175,44,9,149,15745,8436,0,7309,09/30/98,1998-09-30,1998
TENNESSEE,TENNESSEE MIDDLE,TNM,SIXTH CIRCUIT,12437,6860,110,11,5456,333,161,90,11,71,12104,6699,20,5385,09/30/98,1998-09-30,1998
TENNESSEE,TENNESSEE WESTERN,TNW,SIXTH CIRCUIT,23477,6173,49,4,17251,226,109,43,4,70,23251,6064,6,17181,09/30/98,1998-09-30,1998
ILLINOIS,ILLINOIS NORTHERN,ILN,SEVENTH CIRCUIT,45170,32886,225,3,12056,730,485,217,3,25,44440,32401,8,12031,09/30/98,1998-09-30,1998
ILLINOIS,ILLINOIS CENTRAL,ILC,SEVENTH CIRCUIT,12766,11076,33,21,1636,132,72,32,21,7,12634,11004,1,1629,09/30/98,1998-09-30,1998
ILLINOIS,ILLINOIS SOUTHERN,ILS,SEVENTH CIRCUIT,7401,5666,23,6,1706,699,507,23,6,163,6702,5159,0,1543,09/30/98,1998-09-30,1998
INDIANA,INDIANA NORTHERN,INN,SEVENTH CIRCUIT,14409,12443,41,16,1909,200,125,38,16,21,14209,12318,3,1888,09/30/98,1998-09-30,1998
INDIANA,INDIANA SOUTHERN,INS,SEVENTH CIRCUIT,24485,20017,73,10,4384,415,282,71,10,51,24070,19735,2,4333,09/30/98,1998-09-30,1998
WISCONSIN,WISCONSIN EASTERN,WIE,SEVENTH CIRCUIT,12996,10950,23,8,2015,289,225,23,8,33,12707,10725,0,1982,09/30/98,1998-09-30,1998
WISCONSIN,WISCONSIN WESTERN,WIW,SEVENTH CIRCUIT,6407,5831,53,30,493,850,698,50,30,72,5557,5133,3,421,09/30/98,1998-09-30,1998
ARKANSAS,ARKANSAS EASTERN,ARE,EIGHTH CIRCUIT,10535,5839,31,9,4656,253,128,27,9,89,10282,5711,4,4567,09/30/98,1998-09-30,1998
ARKANSAS,ARKANSAS WESTERN,ARW,EIGHTH CIRCUIT,6251,4438,18,6,1789,219,120,15,6,78,6032,4318,3,1711,09/30/98,1998-09-30,1998
IOWA,IOWA NORTHERN,IAN,EIGHTH CIRCUIT,3896,3760,12,6,118,198,163,10,6,19,3698,3597,2,99,09/30/98,1998-09-30,1998
IOWA,IOWA SOUTHERN,IAS,EIGHTH CIRCUIT,5713,5216,14,2,481,114,94,12,2,6,5599,5122,2,475,09/30/98,1998-09-30,1998
MINNESOTA,MINNESOTA,MN,EIGHTH CIRCUIT,19172,14689,44,26,4413,2152,1641,44,26,441,17020,13048,0,3972,09/30/98,1998-09-30,1998
MISSOURI,MISSOURI EASTERN,MOE,EIGHTH CIRCUIT,16021,10249,31,5,5736,260,185,29,5,41,15761,10064,2,5695,09/30/98,1998-09-30,1998
MISSOURI,MISSOURI WESTERN,MOW,EIGHTH CIRCUIT,11847,10098,46,9,1693,247,156,42,9,39,11600,9942,4,1654,09/30/98,1998-09-30,1998
NEBRASKA,NEBRASKA,NE,EIGHTH CIRCUIT,6159,5206,17,53,883,179,93,16,53,17,5980,5113,1,866,09/30/98,1998-09-30,1998
NORTH DAKOTA,NORTH DAKOTA,ND,EIGHTH CIRCUIT,2157,2039,3,39,76,98,48,3,39,8,2059,1991,0,68,09/30/98,1998-09-30,1998
SOUTH DAKOTA,SOUTH DAKOTA,SD,EIGHTH CIRCUIT,2303,2137,10,37,119,178,96,10,37,35,2125,2041,0,84,09/30/98,1998-09-30,1998
ALASKA,ALASKA,AK,NINTH CIRCUIT,1466,1310,13,0,143,138,96,12,0,30,1328,1214,1,113,09/30/98,1998-09-30,1998
ARIZONA,ARIZONA,AZ,NINTH CIRCUIT,24163,19225,306,8,4624,733,349,266,8,110,23430,18876,40,4514,09/30/98,1998-09-30,1998
CALIFORNIA,CALIFORNIA NORTHERN,CAN,NINTH CIRCUIT,34279,25135,250,1,8891,1719,858,204,1,654,32560,24277,46,8237,09/30/98,1998-09-30,1998
CALIFORNIA,CALIFORNIA EASTERN,CAE,NINTH CIRCUIT,38468,33209,152,32,5074,2211,1541,137,32,500,36257,31668,15,4574,09/30/98,1998-09-30,1998
CALIFORNIA,CALIFORNIA CENTRAL,CAC,NINTH CIRCUIT,120548,98674,651,2,21217,5269,3803,561,2,899,115279,94871,90,20318,09/30/98,1998-09-30,1998
CALIFORNIA,CALIFORNIA SOUTHERN,CAS,NINTH CIRCUIT,19027,14364,69,0,4593,158,100,54,0,3,18869,14264,15,4590,09/30/98,1998-09-30,1998
HAWAII,HAWAII,HI,NINTH CIRCUIT,5522,4972,27,0,521,127,92,25,0,8,5395,4880,2,513,09/30/98,1998-09-30,1998
IDAHO,IDAHO,ID,NINTH CIRCUIT,7545,5844,59,47,1595,478,217,57,47,157,7067,5627,2,1438,09/30/98,1998-09-30,1998
MONTANA,MONTANA,MT,NINTH CIRCUIT,3777,3075,16,13,673,180,135,13,13,19,3597,2940,3,654,09/30/98,1998-09-30,1998
NEVADA,NEVADA,NV,NINTH CIRCUIT,15221,11034,169,1,4016,443,205,164,1,72,14778,10829,5,3944,09/30/98,1998-09-30,1998
OREGON,OREGON,OR,NINTH CIRCUIT,17881,14549,53,5,3273,2456,1788,50,5,612,15425,12761,3,2661,09/30/98,1998-09-30,1998
WASHINGTON,WASHINGTON EASTERN,WAE,NINTH CIRCUIT,7562,6263,46,6,1247,381,240,42,6,93,7181,6023,4,1154,09/30/98,1998-09-30,1998
WASHINGTON,WASHINGTON WESTERN,WAW,NINTH CIRCUIT,25902,21177,198,4,4523,681,394,173,4,110,25221,20783,25,4413,09/30/98,1998-09-30,1998
GUAM,GUAM,GUAM,NINTH CIRCUIT,108,87,4,0,17,22,17,3,0,2,86,70,1,15,09/30/98,1998-09-30,1998
NORTHERN MARIANA ISLANDS,NORTHERN MARIANAS,NMI,NINTH CIRCUIT,9,7,2,0,0,5,3,2,0,0,4,4,0,0,09/30/98,1998-09-30,1998
COLORADO,COLORADO,CO,TENTH CIRCUIT,18480,15601,63,10,2806,407,301,63,10,33,18073,15300,0,2773,09/30/98,1998-09-30,1998
KANSAS,KANSAS,KS,TENTH CIRCUIT,13190,10419,68,25,2678,295,170,57,25,43,12895,10249,11,2635,09/30/98,1998-09-30,1998
NEW MEXICO,NEW MEXICO,NM,TENTH CIRCUIT,7851,5735,34,4,2078,297,187,32,4,74,7554,5548,2,2004,09/30/98,1998-09-30,1998
OKLAHOMA,OKLAHOMA NORTHERN,OKN,TENTH CIRCUIT,5464,4610,35,2,817,522,395,31,2,94,4942,4215,4,723,09/30/98,1998-09-30,1998
OKLAHOMA,OKLAHOMA EASTERN,OKE,TENTH CIRCUIT,3797,3546,11,6,234,144,114,10,6,14,3653,3432,1,220,09/30/98,1998-09-30,1998
OKLAHOMA,OKLAHOMA WESTERN,OKW,TENTH CIRCUIT,12862,10126,31,21,2684,306,214,31,21,40,12556,9912,0,2644,09/30/98,1998-09-30,1998
UTAH,UTAH,UT,TENTH CIRCUIT,13854,7898,67,10,5878,471,274,65,10,121,13383,7624,2,5757,09/30/98,1998-09-30,1998
WYOMING,WYOMING,WY,TENTH CIRCUIT,2154,1903,21,4,226,94,50,20,4,20,2060,1853,1,206,09/30/98,1998-09-30,1998
ALABAMA,ALABAMA NORTHERN,ALN,ELEVENTH CIRCUIT,21642,7746,98,5,13792,396,162,87,5,141,21246,7584,11,13651,09/30/98,1998-09-30,1998
ALABAMA,ALABAMA MIDDLE,ALM,ELEVENTH CIRCUIT,6697,2934,15,6,3742,203,123,14,6,60,6494,2811,1,3682,09/30/98,1998-09-30,1998
ALABAMA,ALABAMA SOUTHERN,ALS,ELEVENTH CIRCUIT,4770,2216,15,0,2539,69,36,9,0,24,4701,2180,6,2515,09/30/98,1998-09-30,1998
FLORIDA,FLORIDA NORTHERN,FLN,ELEVENTH CIRCUIT,5287,4406,15,5,861,110,64,15,5,26,5177,4342,0,835,09/30/98,1998-09-30,1998
FLORIDA,FLORIDA MIDDLE,FLM,ELEVENTH CIRCUIT,44363,34415,317,8,9623,1137,642,288,8,199,43226,33773,29,9424,09/30/98,1998-09-30,1998
FLORIDA,FLORIDA SOUTHERN,FLS,ELEVENTH CIRCUIT,28476,21400,295,3,6776,751,446,269,3,31,27725,20954,26,6745,09/30/98,1998-09-30,1998
GEORGIA,GEORGIA NORTHERN,GAN,ELEVENTH CIRCUIT,34606,14052,153,4,20397,914,368,129,4,413,33692,13684,24,19984,09/30/98,1998-09-30,1998
GEORGIA,GEORGIA MIDDLE,GAM,ELEVENTH CIRCUIT,14955,5673,24,38,9220,164,62,23,38,41,14791,5611,1,9179,09/30/98,1998-09-30,1998
GEORGIA,GEORGIA SOUTHERN,GAS,ELEVENTH CIRCUIT,12658,2955,41,5,9657,225,80,40,5,100,12433,2875,1,9557,09/30/98,1998-09-30,1998
DISTRICT OF COLUMBIA,DISTRICT OF COLUMBIA,DC,DC CIRCUIT,2709,1823,41,0,845,88,40,37,0,11,2621,1783,4,834,09/30/99,1999-09-30,1999
MAINE,MAINE,ME,FIRST CIRCUIT,4299,3963,9,2,325,217,155,9,2,51,4082,3808,0,274,09/30/99,1999-09-30,1999
MASSACHUSETTS,MASSACHUSETTS,MA,FIRST CIRCUIT,19732,17008,199,0,2523,596,349,198,0,47,19136,16659,1,2476,09/30/99,1999-09-30,1999
NEW HAMPSHIRE,NEW HAMPSHIRE,NH,FIRST CIRCUIT,4375,4045,25,0,303,383,324,25,0,32,3992,3721,0,271,09/30/99,1999-09-30,1999
RHODE ISLAND,RHODE ISLAND,RI,FIRST CIRCUIT,5177,4856,12,0,309,110,94,11,0,5,5067,4762,1,304,09/30/99,1999-09-30,1999
PUERTO RICO,PUERTO RICO,PR,FIRST CIRCUIT,17427,5283,76,0,12068,147,71,57,0,19,17280,5212,19,12049,09/30/99,1999-09-30,1999
CONNECTICUT,CONNECTICUT,CT,SECOND CIRCUIT,12395,10844,88,2,1461,142,74,66,2,0,12253,10770,22,1461,09/30/99,1999-09-30,1999
NEW YORK,NEW YORK NORTHERN,NYN,SECOND CIRCUIT,15176,12752,41,14,2368,396,255,37,14,89,14780,12497,4,2279,09/30/99,1999-09-30,1999
NEW YORK,NEW YORK EASTERN,NYE,SECOND CIRCUIT,28260,22564,235,0,5461,383,172,202,0,9,27877,22392,33,5452,09/30/99,1999-09-30,1999
NEW YORK,NEW YORK SOUTHERN,NYS,SECOND CIRCUIT,15831,13696,401,3,1722,589,206,360,3,11,15242,13490,41,1711,09/30/99,1999-09-30,1999
NEW YORK,NEW YORK WESTERN,NYW,SECOND CIRCUIT,11878,8934,46,6,2892,600,405,45,6,144,11278,8529,1,2748,09/30/99,1999-09-30,1999
VERMONT,VERMONT,VT,SECOND CIRCUIT,1837,1678,16,9,133,86,50,16,9,10,1751,1628,0,123,09/30/99,1999-09-30,1999
DELAWARE,DELAWARE,DE,THIRD CIRCUIT,4168,1700,1700,0,768,1703,24,1678,0,1,2465,1676,22,767,09/30/99,1999-09-30,1999
NEW JERSEY,NEW JERSEY,NJ,THIRD CIRCUIT,42449,28644,449,3,13352,890,491,390,3,5,41559,28153,59,13347,09/30/99,1999-09-30,1999
PENNSYLVANIA,PENNSYLVANIA EASTERN,PAE,THIRD CIRCUIT,22329,13276,129,4,8919,352,207,118,4,22,21977,13069,11,8897,09/30/99,1999-09-30,1999
PENNSYLVANIA,PENNSYLVANIA MIDDLE,PAM,THIRD CIRCUIT,10175,8322,53,3,1797,700,454,50,3,193,9475,7868,3,1604,09/30/99,1999-09-30,1999
PENNSYLVANIA,PENNSYLVANIA WESTERN,PAW,THIRD CIRCUIT,12127,10625,124,8,1370,403,265,108,8,22,11724,10360,16,1348,09/30/99,1999-09-30,1999
VIRGIN ISLANDS,VIRGIN ISLANDS,VI,THIRD CIRCUIT,75,51,9,0,15,13,5,8,0,0,62,46,1,15,09/30/99,1999-09-30,1999
MARYLAND,MARYLAND,MD,FOURTH CIRCUIT,32931,23247,156,2,9526,827,512,136,2,177,32104,22735,20,9349,09/30/99,1999-09-30,1999
NORTH CAROLINA,NORTH CAROLINA EASTERN,NCE,FOURTH CIRCUIT,10697,4839,24,8,5826,250,138,20,8,84,10447,4701,4,5742,09/30/99,1999-09-30,1999
NORTH CAROLINA,NORTH CAROLINA MIDDLE,NCM,FOURTH CIRCUIT,8587,2867,14,1,5705,111,93,13,1,4,8476,2774,1,5701,09/30/99,1999-09-30,1999
NORTH CAROLINA,NORTH CAROLINA WESTERN,NCW,FOURTH CIRCUIT,6919,3122,20,3,3774,62,40,19,3,0,6857,3082,1,3774,09/30/99,1999-09-30,1999
SOUTH CAROLINA,SOUTH CAROLINA,SC,FOURTH CIRCUIT,11479,5783,70,8,5618,203,105,60,8,30,11276,5678,10,5588,09/30/99,1999-09-30,1999
VIRGINIA,VIRGINIA EASTERN,VAE,FOURTH CIRCUIT,29286,21103,150,5,8028,361,199,117,5,40,28925,20904,33,7988,09/30/99,1999-09-30,1999
VIRGINIA,VIRGINIA WESTERN,VAW,FOURTH CIRCUIT,10353,8522,29,3,1799,489,389,27,3,70,9864,8133,2,1729,09/30/99,1999-09-30,1999
WEST VIRGINIA,WEST VIRGINIA NORTHERN,WVN,FOURTH CIRCUIT,3329,3138,12,0,179,111,89,10,0,12,3218,3049,2,167,09/30/99,1999-09-30,1999
WEST VIRGINIA,WEST VIRGINIA SOUTHERN,WVS,FOURTH CIRCUIT,4844,4561,40,0,243,138,91,34,0,13,4706,4470,6,230,09/30/99,1999-09-30,1999
LOUISIANA,LOUISIANA EASTERN,LAE,FIFTH CIRCUIT,7514,4860,70,2,2582,113,48,63,2,0,7401,4812,7,2582,09/30/99,1999-09-30,1999
LOUISIANA,LOUISIANA MIDDLE,LAM,FIFTH CIRCUIT,2749,1937,12,0,800,29,15,12,0,2,2720,1922,0,798,09/30/99,1999-09-30,1999
LOUISIANA,LOUISIANA WESTERN,LAW,FIFTH CIRCUIT,12576,5804,33,18,6721,424,254,29,18,123,12152,5550,4,6598,09/30/99,1999-09-30,1999
MISSISSIPPI,MISSISSIPPI NORTHERN,MSN,FIFTH CIRCUIT,5993,3671,26,24,2272,141,78,24,24,15,5852,3593,2,2257,09/30/99,1999-09-30,1999
MISSISSIPPI,MISSISSIPPI SOUTHERN,MSS,FIFTH CIRCUIT,11890,6900,28,0,4962,57,38,18,0,1,11833,6862,10,4961,09/30/99,1999-09-30,1999
TEXAS,TEXAS NORTHERN,TXN,FIFTH CIRCUIT,22205,11748,213,38,10206,981,551,211,38,181,21224,11197,2,10025,09/30/99,1999-09-30,1999
TEXAS,TEXAS EASTERN,TXE,FIFTH CIRCUIT,9339,4601,53,10,4674,294,143,51,10,89,9045,4458,2,4585,09/30/99,1999-09-30,1999
TEXAS,TEXAS SOUTHERN,TXS,FIFTH CIRCUIT,18103,10574,205,9,7315,633,301,196,9,127,17470,10273,9,7188,09/30/99,1999-09-30,1999
TEXAS,TEXAS WESTERN,TXW,FIFTH CIRCUIT,16952,9751,126,9,7064,429,244,122,9,52,16523,9507,4,7012,09/30/99,1999-09-30,1999
KENTUCKY,KENTUCKY EASTERN,KYE,SIXTH CIRCUIT,9102,7892,26,5,1179,155,101,26,5,23,8947,7791,0,1156,09/30/99,1999-09-30,1999
KENTUCKY,KENTUCKY WESTERN,KYW,SIXTH CIRCUIT,11899,9567,33,16,2283,144,85,32,16,11,11755,9482,1,2272,09/30/99,1999-09-30,1999
MICHIGAN,MICHIGAN EASTERN,MIE,SIXTH CIRCUIT,25962,18776,149,7,7030,377,206,142,7,22,25585,18570,7,7008,09/30/99,1999-09-30,1999
MICHIGAN,MICHIGAN WESTERN,MIW,SIXTH CIRCUIT,11609,8699,51,9,2850,282,162,50,9,61,11327,8537,1,2789,09/30/99,1999-09-30,1999
OHIO,OHIO NORTHERN,OHN,SIXTH CIRCUIT,28100,22930,41,2,5127,740,571,40,2,127,27360,22359,1,5000,09/30/99,1999-09-30,1999
OHIO,OHIO SOUTHERN,OHS,SIXTH CIRCUIT,26544,20174,57,9,6304,421,245,55,9,112,26123,19929,2,6192,09/30/99,1999-09-30,1999
TENNESSEE,TENNESSEE EASTERN,TNE,SIXTH CIRCUIT,14934,8408,60,6,6460,277,147,58,6,66,14657,8261,2,6394,09/30/99,1999-09-30,1999
TENNESSEE,TENNESSEE MIDDLE,TNM,SIXTH CIRCUIT,11032,6358,113,5,4556,255,132,85,5,33,10777,6226,28,4523,09/30/99,1999-09-30,1999
TENNESSEE,TENNESSEE WESTERN,TNW,SIXTH CIRCUIT,20894,5519,200,2,15173,325,85,193,2,45,20569,5434,7,15128,09/30/99,1999-09-30,1999
ILLINOIS,ILLINOIS NORTHERN,ILN,SEVENTH CIRCUIT,46038,31591,186,6,14255,551,366,167,6,12,45487,31225,19,14243,09/30/99,1999-09-30,1999
ILLINOIS,ILLINOIS CENTRAL,ILC,SEVENTH CIRCUIT,11831,10187,17,46,1581,151,79,17,46,9,11680,10108,0,1572,09/30/99,1999-09-30,1999
ILLINOIS,ILLINOIS SOUTHERN,ILS,SEVENTH CIRCUIT,7407,5496,23,16,1872,692,506,21,16,149,6715,4990,2,1723,09/30/99,1999-09-30,1999
INDIANA,INDIANA NORTHERN,INN,SEVENTH CIRCUIT,14406,12349,35,9,2013,160,97,32,9,22,14246,12252,3,1991,09/30/99,1999-09-30,1999
INDIANA,INDIANA SOUTHERN,INS,SEVENTH CIRCUIT,24020,19394,83,6,4537,372,259,73,6,34,23648,19135,10,4503,09/30/99,1999-09-30,1999
WISCONSIN,WISCONSIN EASTERN,WIE,SEVENTH CIRCUIT,12637,10623,23,5,1986,222,170,23,5,24,12415,10453,0,1962,09/30/99,1999-09-30,1999
WISCONSIN,WISCONSIN WESTERN,WIW,SEVENTH CIRCUIT,6008,5463,40,22,482,704,565,36,22,80,5304,4898,4,402,09/30/99,1999-09-30,1999
ARKANSAS,ARKANSAS EASTERN,ARE,EIGHTH CIRCUIT,10423,5730,20,3,4670,154,76,18,3,57,10269,5654,2,4613,09/30/99,1999-09-30,1999
ARKANSAS,ARKANSAS WESTERN,ARW,EIGHTH CIRCUIT,6200,4397,14,5,1784,144,87,13,5,39,6056,4310,1,1745,09/30/99,1999-09-30,1999
IOWA,IOWA NORTHERN,IAN,EIGHTH CIRCUIT,3557,3417,7,10,123,124,101,6,10,7,3433,3316,1,116,09/30/99,1999-09-30,1999
IOWA,IOWA SOUTHERN,IAS,EIGHTH CIRCUIT,5079,4643,6,7,423,84,67,6,7,4,4995,4576,0,419,09/30/99,1999-09-30,1999
MINNESOTA,MINNESOTA,MN,EIGHTH CIRCUIT,16573,13016,40,22,3495,1585,1248,40,22,275,14988,11768,0,3220,09/30/99,1999-09-30,1999
MISSOURI,MISSOURI EASTERN,MOE,EIGHTH CIRCUIT,16402,10381,38,7,5976,217,138,35,7,37,16185,10243,3,5939,09/30/99,1999-09-30,1999
MISSOURI,MISSOURI WESTERN,MOW,EIGHTH CIRCUIT,11244,9456,48,8,1732,138,73,48,8,9,11106,9383,0,1723,09/30/99,1999-09-30,1999
NEBRASKA,NEBRASKA,NE,EIGHTH CIRCUIT,5662,4732,31,73,826,139,34,27,73,5,5523,4698,4,821,09/30/99,1999-09-30,1999
NORTH DAKOTA,NORTH DAKOTA,ND,EIGHTH CIRCUIT,2120,2000,6,32,82,93,47,6,32,8,2027,1953,0,74,09/30/99,1999-09-30,1999
SOUTH DAKOTA,SOUTH DAKOTA,SD,EIGHTH CIRCUIT,2264,2135,2,35,92,173,118,2,35,18,2091,2017,0,74,09/30/99,1999-09-30,1999
ALASKA,ALASKA,AK,NINTH CIRCUIT,1513,1370,15,0,128,119,79,15,0,25,1394,1291,0,103,09/30/99,1999-09-30,1999
ARIZONA,ARIZONA,AZ,NINTH CIRCUIT,23205,18835,243,2,4125,725,391,212,2,120,22480,18444,31,4005,09/30/99,1999-09-30,1999
CALIFORNIA,CALIFORNIA NORTHERN,CAN,NINTH CIRCUIT,29007,21270,230,7,7498,1242,636,198,7,399,27765,20634,32,7099,09/30/99,1999-09-30,1999
CALIFORNIA,CALIFORNIA EASTERN,CAE,NINTH CIRCUIT,36174,31078,110,23,4962,1287,896,103,23,264,34887,30182,7,4698,09/30/99,1999-09-30,1999
CALIFORNIA,CALIFORNIA CENTRAL,CAC,NINTH CIRCUIT,107873,87683,512,2,19676,2901,2115,448,2,336,104972,85568,64,19340,09/30/99,1999-09-30,1999
CALIFORNIA,CALIFORNIA SOUTHERN,CAS,NINTH CIRCUIT,16751,12894,61,1,3795,193,130,53,1,9,16558,12764,8,3786,09/30/99,1999-09-30,1999
HAWAII,HAWAII,HI,NINTH CIRCUIT,5725,5204,31,0,489,98,65,28,0,4,5627,5139,3,485,09/30/99,1999-09-30,1999
IDAHO,IDAHO,ID,NINTH CIRCUIT,7287,5779,40,24,1443,338,198,37,24,78,6949,5581,3,1365,09/30/99,1999-09-30,1999
MONTANA,MONTANA,MT,NINTH CIRCUIT,3469,2952,8,5,504,113,101,5,5,2,3356,2851,3,502,09/30/99,1999-09-30,1999
NEVADA,NEVADA,NV,NINTH CIRCUIT,15043,11059,107,5,3872,315,171,97,5,42,14728,10888,10,3830,09/30/99,1999-09-30,1999
OREGON,OREGON,OR,NINTH CIRCUIT,18401,15220,47,2,3131,2944,2188,46,2,707,15457,13032,1,2424,09/30/99,1999-09-30,1999
WASHINGTON,WASHINGTON EASTERN,WAE,NINTH CIRCUIT,7791,6134,39,14,1604,344,250,37,14,43,7447,5884,2,1561,09/30/99,1999-09-30,1999
WASHINGTON,WASHINGTON WESTERN,WAW,NINTH CIRCUIT,24071,19237,175,1,4658,355,162,160,1,32,23716,19075,15,4626,09/30/99,1999-09-30,1999
GUAM,GUAM,GUAM,NINTH CIRCUIT,111,96,2,0,13,20,16,2,0,2,91,80,0,11,09/30/99,1999-09-30,1999
NORTHERN MARIANA ISLANDS,NORTHERN MARIANAS,NMI,NINTH CIRCUIT,18,17,1,0,0,8,7,1,0,0,10,10,0,0,09/30/99,1999-09-30,1999
COLORADO,COLORADO,CO,TENTH CIRCUIT,16809,14149,75,18,2567,360,253,74,18,15,16449,13896,1,2552,09/30/99,1999-09-30,1999
KANSAS,KANSAS,KS,TENTH CIRCUIT,11862,9436,31,25,2370,199,126,24,25,24,11663,9310,7,2346,09/30/99,1999-09-30,1999
NEW MEXICO,NEW MEXICO,NM,TENTH CIRCUIT,7494,6255,36,5,1198,546,430,32,5,79,6948,5825,4,1119,09/30/99,1999-09-30,1999
OKLAHOMA,OKLAHOMA NORTHERN,OKN,TENTH CIRCUIT,5220,4467,12,1,740,333,264,12,1,56,4887,4203,0,684,09/30/99,1999-09-30,1999
OKLAHOMA,OKLAHOMA EASTERN,OKE,TENTH CIRCUIT,3652,3343,9,13,287,103,66,9,13,15,3549,3277,0,272,09/30/99,1999-09-30,1999
OKLAHOMA,OKLAHOMA WESTERN,OKW,TENTH CIRCUIT,11945,9757,33,22,2133,276,188,31,22,35,11669,9569,2,2098,09/30/99,1999-09-30,1999
UTAH,UTAH,UT,TENTH CIRCUIT,13942,8540,51,10,5341,444,250,48,10,136,13498,8290,3,5205,09/30/99,1999-09-30,1999
WYOMING,WYOMING,WY,TENTH CIRCUIT,2090,1927,15,5,143,74,44,14,5,11,2016,1883,1,132,09/30/99,1999-09-30,1999
ALABAMA,ALABAMA NORTHERN,ALN,ELEVENTH CIRCUIT,19346,7516,60,4,11766,292,132,48,4,108,19054,7384,12,11658,09/30/99,1999-09-30,1999
ALABAMA,ALABAMA MIDDLE,ALM,ELEVENTH CIRCUIT,6649,2730,13,3,3903,142,73,13,3,53,6507,2657,0,3850,09/30/99,1999-09-30,1999
ALABAMA,ALABAMA SOUTHERN,ALS,ELEVENTH CIRCUIT,4685,2083,21,1,2580,40,21,17,1,1,4645,2062,4,2579,09/30/99,1999-09-30,1999
FLORIDA,FLORIDA NORTHERN,FLN,ELEVENTH CIRCUIT,5059,4124,24,3,908,61,32,20,3,6,4998,4092,4,902,09/30/99,1999-09-30,1999
FLORIDA,FLORIDA MIDDLE,FLM,ELEVENTH CIRCUIT,43468,32476,300,14,10678,1005,603,269,14,119,42463,31873,31,10559,09/30/99,1999-09-30,1999
FLORIDA,FLORIDA SOUTHERN,FLS,ELEVENTH CIRCUIT,29080,21329,213,2,7533,624,420,190,2,9,28456,20909,23,7524,09/30/99,1999-09-30,1999
GEORGIA,GEORGIA NORTHERN,GAN,ELEVENTH CIRCUIT,32296,13457,123,1,18715,695,324,109,1,261,31601,13133,14,18454,09/30/99,1999-09-30,1999
GEORGIA,GEORGIA MIDDLE,GAM,ELEVENTH CIRCUIT,14330,5678,37,28,8587,168,67,35,28,38,14162,5611,2,8549,09/30/99,1999-09-30,1999
GEORGIA,GEORGIA SOUTHERN,GAS,ELEVENTH CIRCUIT,11898,2771,25,3,9099,131,67,23,3,38,11767,2704,2,9061,09/30/99,1999-09-30,1999
DISTRICT OF COLUMBIA,DISTRICT OF COLUMBIA,DC,DC CIRCUIT,2501,1616,37,0,848,67,21,34,0,12,2434,1595,3,836,09/30/00,2000-09-30,2000
MAINE,MAINE,ME,FIRST CIRCUIT,4036,3724,18,2,292,171,128,18,2,23,3865,3596,0,269,09/30/00,2000-09-30,2000
MASSACHUSETTS,MASSACHUSETTS,MA,FIRST CIRCUIT,16125,13790,144,1,2190,426,264,144,1,17,15699,13526,0,2173,09/30/00,2000-09-30,2000
NEW HAMPSHIRE,NEW HAMPSHIRE,NH,FIRST CIRCUIT,3784,3470,17,1,296,323,296,17,1,9,3461,3174,0,287,09/30/00,2000-09-30,2000
RHODE ISLAND,RHODE ISLAND,RI,FIRST CIRCUIT,4702,4367,17,0,318,87,68,17,0,2,4615,4299,0,316,09/30/00,2000-09-30,2000
PUERTO RICO,PUERTO RICO,PR,FIRST CIRCUIT,15740,4610,59,3,11068,232,83,46,3,100,15508,4527,13,10968,09/30/00,2000-09-30,2000
CONNECTICUT,CONNECTICUT,CT,SECOND CIRCUIT,10968,9491,66,0,1411,118,68,50,0,0,10850,9423,16,1411,09/30/00,2000-09-30,2000
NEW YORK,NEW YORK NORTHERN,NYN,SECOND CIRCUIT,13492,11091,54,16,2330,407,243,49,16,98,13085,10848,5,2232,09/30/00,2000-09-30,2000
NEW YORK,NEW YORK EASTERN,NYE,SECOND CIRCUIT,23022,18114,246,0,4662,352,132,213,0,7,22670,17982,33,4655,09/30/00,2000-09-30,2000
NEW YORK,NEW YORK SOUTHERN,NYS,SECOND CIRCUIT,12690,10637,471,1,1578,628,178,438,1,8,12062,10459,33,1570,09/30/00,2000-09-30,2000
NEW YORK,NEW YORK WESTERN,NYW,SECOND CIRCUIT,10798,8012,41,3,2740,461,327,36,3,93,10337,7685,5,2647,09/30/00,2000-09-30,2000
VERMONT,VERMONT,VT,SECOND CIRCUIT,1497,1354,10,3,130,64,37,10,3,14,1433,1317,0,116,09/30/00,2000-09-30,2000
DELAWARE,DELAWARE,DE,THIRD CIRCUIT,4849,1563,2492,0,794,2527,37,2487,0,3,2322,1526,5,791,09/30/00,2000-09-30,2000
NEW JERSEY,NEW JERSEY,NJ,THIRD CIRCUIT,37956,24205,367,2,13382,708,406,298,2,2,37248,23799,69,13380,09/30/00,2000-09-30,2000
PENNSYLVANIA,PENNSYLVANIA EASTERN,PAE,THIRD CIRCUIT,21255,11753,179,1,9322,328,152,159,1,16,20927,11601,20,9306,09/30/00,2000-09-30,2000
PENNSYLVANIA,PENNSYLVANIA MIDDLE,PAM,THIRD CIRCUIT,10425,8183,74,3,2165,756,470,68,3,215,9669,7713,6,1950,09/30/00,2000-09-30,2000
PENNSYLVANIA,PENNSYLVANIA WESTERN,PAW,THIRD CIRCUIT,12416,10513,131,10,1762,360,224,112,10,14,12056,10289,19,1748,09/30/00,2000-09-30,2000
VIRGIN ISLANDS,VIRGIN ISLANDS,VI,THIRD CIRCUIT,60,47,3,0,10,8,6,1,0,1,52,41,2,9,09/30/00,2000-09-30,2000
MARYLAND,MARYLAND,MD,FOURTH CIRCUIT,30833,20980,168,0,9685,697,438,156,0,103,30136,20542,12,9582,09/30/00,2000-09-30,2000
NORTH CAROLINA,NORTH CAROLINA EASTERN,NCE,FOURTH CIRCUIT,10433,4846,62,5,5520,270,126,55,5,84,10163,4720,7,5436,09/30/00,2000-09-30,2000
NORTH CAROLINA,NORTH CAROLINA MIDDLE,NCM,FOURTH CIRCUIT,9118,3115,20,2,5981,116,90,20,2,4,9002,3025,0,5977,09/30/00,2000-09-30,2000
NORTH CAROLINA,NORTH CAROLINA WESTERN,NCW,FOURTH CIRCUIT,6764,3107,25,3,3629,76,47,23,3,3,6688,3060,2,3626,09/30/00,2000-09-30,2000
SOUTH CAROLINA,SOUTH CAROLINA,SC,FOURTH CIRCUIT,11725,5619,71,2,6033,156,85,58,2,11,11569,5534,13,6022,09/30/00,2000-09-30,2000
VIRGINIA,VIRGINIA EASTERN,VAE,FOURTH CIRCUIT,26590,18860,144,3,7579,314,176,117,3,14,26276,18684,27,7565,09/30/00,2000-09-30,2000
VIRGINIA,VIRGINIA WESTERN,VAW,FOURTH CIRCUIT,9919,8166,39,5,1709,539,409,37,5,88,9380,7757,2,1621,09/30/00,2000-09-30,2000
WEST VIRGINIA,WEST VIRGINIA NORTHERN,WVN,FOURTH CIRCUIT,3395,3165,24,2,204,124,89,22,2,11,3271,3076,2,193,09/30/00,2000-09-30,2000
WEST VIRGINIA,WEST VIRGINIA SOUTHERN,WVS,FOURTH CIRCUIT,5052,4788,29,0,235,141,98,28,0,15,4911,4690,1,220,09/30/00,2000-09-30,2000
LOUISIANA,LOUISIANA EASTERN,LAE,FIFTH CIRCUIT,8146,5103,73,3,2967,138,66,68,3,1,8008,5037,5,2966,09/30/00,2000-09-30,2000
LOUISIANA,LOUISIANA MIDDLE,LAM,FIFTH CIRCUIT,2776,1946,14,1,815,36,22,13,1,0,2740,1924,1,815,09/30/00,2000-09-30,2000
LOUISIANA,LOUISIANA WESTERN,LAW,FIFTH CIRCUIT,11910,6040,57,9,5803,450,274,56,9,110,11460,5766,1,5693,09/30/00,2000-09-30,2000
MISSISSIPPI,MISSISSIPPI NORTHERN,MSN,FIFTH CIRCUIT,6110,3759,21,8,2322,90,50,20,8,12,6020,3709,1,2310,09/30/00,2000-09-30,2000
MISSISSIPPI,MISSISSIPPI SOUTHERN,MSS,FIFTH CIRCUIT,12110,7173,20,12,4905,98,63,19,12,4,12012,7110,1,4901,09/30/00,2000-09-30,2000
TEXAS,TEXAS NORTHERN,TXN,FIFTH CIRCUIT,20504,10578,235,11,9680,936,515,228,11,182,19568,10063,7,9498,09/30/00,2000-09-30,2000
TEXAS,TEXAS EASTERN,TXE,FIFTH CIRCUIT,9022,4582,34,2,4403,341,179,31,2,128,8681,4403,3,4275,09/30/00,2000-09-30,2000
TEXAS,TEXAS SOUTHERN,TXS,FIFTH CIRCUIT,16948,9198,224,10,7515,760,353,209,10,187,16188,8845,15,7328,09/30/00,2000-09-30,2000
TEXAS,TEXAS WESTERN,TXW,FIFTH CIRCUIT,15335,8355,116,7,6857,465,255,108,7,95,14870,8100,8,6762,09/30/00,2000-09-30,2000
KENTUCKY,KENTUCKY EASTERN,KYE,SIXTH CIRCUIT,9008,7856,34,2,1116,177,118,33,2,24,8831,7738,1,1092,09/30/00,2000-09-30,2000
KENTUCKY,KENTUCKY WESTERN,KYW,SIXTH CIRCUIT,11887,9477,46,2,2362,144,90,46,2,6,11743,9387,0,2356,09/30/00,2000-09-30,2000
MICHIGAN,MICHIGAN EASTERN,MIE,SIXTH CIRCUIT,25213,17934,122,5,7150,331,186,118,5,20,24882,17748,4,7130,09/30/00,2000-09-30,2000
MICHIGAN,MICHIGAN WESTERN,MIW,SIXTH CIRCUIT,11362,8414,56,4,2888,245,156,55,4,30,11117,8258,1,2858,09/30/00,2000-09-30,2000
OHIO,OHIO NORTHERN,OHN,SIXTH CIRCUIT,27734,22306,60,5,5363,933,721,56,5,151,26801,21585,4,5212,09/30/00,2000-09-30,2000
OHIO,OHIO SOUTHERN,OHS,SIXTH CIRCUIT,25858,19721,68,13,6056,474,294,65,13,102,25384,19427,3,5954,09/30/00,2000-09-30,2000
TENNESSEE,TENNESSEE EASTERN,TNE,SIXTH CIRCUIT,15416,8748,43,2,6623,209,123,38,2,46,15207,8625,5,6577,09/30/00,2000-09-30,2000
TENNESSEE,TENNESSEE MIDDLE,TNM,SIXTH CIRCUIT,11488,6906,125,0,4457,259,123,96,0,40,11229,6783,29,4417,09/30/00,2000-09-30,2000
TENNESSEE,TENNESSEE WESTERN,TNW,SIXTH CIRCUIT,21234,5513,76,1,15644,160,63,61,1,35,21074,5450,15,15609,09/30/00,2000-09-30,2000
ILLINOIS,ILLINOIS NORTHERN,ILN,SEVENTH CIRCUIT,43068,28907,157,1,14003,531,368,145,1,17,42537,28539,12,13986,09/30/00,2000-09-30,2000
ILLINOIS,ILLINOIS CENTRAL,ILC,SEVENTH CIRCUIT,11503,9697,20,37,1749,134,67,19,37,11,11369,9630,1,1738,09/30/00,2000-09-30,2000
ILLINOIS,ILLINOIS SOUTHERN,ILS,SEVENTH CIRCUIT,7382,5247,25,12,2098,617,425,21,12,159,6765,4822,4,1939,09/30/00,2000-09-30,2000
INDIANA,INDIANA NORTHERN,INN,SEVENTH CIRCUIT,14147,11916,29,4,2198,115,74,25,4,12,14032,11842,4,2186,09/30/00,2000-09-30,2000
INDIANA,INDIANA SOUTHERN,INS,SEVENTH CIRCUIT,23440,18141,56,8,5235,290,199,49,8,34,23150,17942,7,5201,09/30/00,2000-09-30,2000
WISCONSIN,WISCONSIN EASTERN,WIE,SEVENTH CIRCUIT,12249,10094,7,4,2143,174,148,7,4,14,12075,9946,0,2129,09/30/00,2000-09-30,2000
WISCONSIN,WISCONSIN WESTERN,WIW,SEVENTH CIRCUIT,5652,5055,34,7,556,513,417,33,7,56,5139,4638,1,500,09/30/00,2000-09-30,2000
ARKANSAS,ARKANSAS EASTERN,ARE,EIGHTH CIRCUIT,10403,5348,22,6,5027,147,67,20,6,54,10256,5281,2,4973,09/30/00,2000-09-30,2000
ARKANSAS,ARKANSAS WESTERN,ARW,EIGHTH CIRCUIT,6280,4249,13,5,2013,131,75,13,5,38,6149,4174,0,1975,09/30/00,2000-09-30,2000
IOWA,IOWA NORTHERN,IAN,EIGHTH CIRCUIT,3363,3221,13,12,117,154,125,11,12,6,3209,3096,2,111,09/30/00,2000-09-30,2000
IOWA,IOWA SOUTHERN,IAS,EIGHTH CIRCUIT,4882,4454,9,2,417,63,51,9,2,1,4819,4403,0,416,09/30/00,2000-09-30,2000
MINNESOTA,MINNESOTA,MN,EIGHTH CIRCUIT,15320,12140,63,20,3097,1515,1159,63,20,273,13805,10981,0,2824,09/30/00,2000-09-30,2000
MISSOURI,MISSOURI EASTERN,MOE,EIGHTH CIRCUIT,15078,9370,24,5,5678,189,136,21,5,26,14889,9234,3,5652,09/30/00,2000-09-30,2000
MISSOURI,MISSOURI WESTERN,MOW,EIGHTH CIRCUIT,10900,9036,56,9,1799,182,101,51,9,21,10718,8935,5,1778,09/30/00,2000-09-30,2000
NEBRASKA,NEBRASKA,NE,EIGHTH CIRCUIT,5552,4653,35,44,820,123,36,30,44,13,5429,4617,5,807,09/30/00,2000-09-30,2000
NORTH DAKOTA,NORTH DAKOTA,ND,EIGHTH CIRCUIT,1988,1902,4,11,71,90,71,4,11,4,1898,1831,0,67,09/30/00,2000-09-30,2000
SOUTH DAKOTA,SOUTH DAKOTA,SD,EIGHTH CIRCUIT,2099,2002,6,12,79,118,88,6,12,12,1981,1914,0,67,09/30/00,2000-09-30,2000
ALASKA,ALASKA,AK,NINTH CIRCUIT,1412,1285,14,0,113,111,82,14,0,15,1301,1203,0,98,09/30/00,2000-09-30,2000
ARIZONA,ARIZONA,AZ,NINTH CIRCUIT,21205,16970,381,5,3849,803,346,357,5,95,20402,16624,24,3754,09/30/00,2000-09-30,2000
CALIFORNIA,CALIFORNIA NORTHERN,CAN,NINTH CIRCUIT,21176,14925,153,3,6094,1179,626,135,3,414,19997,14299,18,5680,09/30/00,2000-09-30,2000
CALIFORNIA,CALIFORNIA EASTERN,CAE,NINTH CIRCUIT,30920,26091,96,17,4714,1098,730,86,17,263,29822,25361,10,4451,09/30/00,2000-09-30,2000
CALIFORNIA,CALIFORNIA CENTRAL,CAC,NINTH CIRCUIT,85728,68259,547,0,16922,2188,1508,495,0,185,83540,66751,52,16737,09/30/00,2000-09-30,2000
CALIFORNIA,CALIFORNIA SOUTHERN,CAS,NINTH CIRCUIT,13046,10223,54,1,2768,159,109,42,1,7,12887,10114,12,2761,09/30/00,2000-09-30,2000
HAWAII,HAWAII,HI,NINTH CIRCUIT,4667,4148,23,0,495,58,43,12,0,2,4609,4105,11,493,09/30/00,2000-09-30,2000
IDAHO,IDAHO,ID,NINTH CIRCUIT,7155,5692,41,30,1391,283,145,33,30,74,6872,5547,8,1317,09/30/00,2000-09-30,2000
MONTANA,MONTANA,MT,NINTH CIRCUIT,3358,2936,20,11,391,155,94,20,11,30,3203,2842,0,361,09/30/00,2000-09-30,2000
NEVADA,NEVADA,NV,NINTH CIRCUIT,14182,10348,130,2,3702,316,162,124,2,28,13866,10186,6,3674,09/30/00,2000-09-30,2000
OREGON,OREGON,OR,NINTH CIRCUIT,18040,14956,32,6,3046,1935,1182,32,6,715,16105,13774,0,2331,09/30/00,2000-09-30,2000
WASHINGTON,WASHINGTON EASTERN,WAE,NINTH CIRCUIT,8239,6261,46,12,1920,361,268,43,12,38,7878,5993,3,1882,09/30/00,2000-09-30,2000
WASHINGTON,WASHINGTON WESTERN,WAW,NINTH CIRCUIT,23086,17911,154,4,5017,322,145,143,4,30,22764,17766,11,4987,09/30/00,2000-09-30,2000
GUAM,GUAM,GUAM,NINTH CIRCUIT,167,137,4,0,26,32,26,3,0,3,135,111,1,23,09/30/00,2000-09-30,2000
NORTHERN MARIANA ISLANDS,NORTHERN MARIANAS,NMI,NINTH CIRCUIT,16,9,0,0,7,6,0,0,0,6,10,9,0,1,09/30/00,2000-09-30,2000
COLORADO,COLORADO,CO,TENTH CIRCUIT,15458,12987,81,15,2375,365,238,81,15,31,15093,12749,0,2344,09/30/00,2000-09-30,2000
KANSAS,KANSAS,KS,TENTH CIRCUIT,11509,9296,33,10,2170,152,89,32,10,21,11357,9207,1,2149,09/30/00,2000-09-30,2000
NEW MEXICO,NEW MEXICO,NM,TENTH CIRCUIT,7039,5957,32,6,1044,513,403,29,6,75,6526,5554,3,969,09/30/00,2000-09-30,2000
OKLAHOMA,OKLAHOMA NORTHERN,OKN,TENTH CIRCUIT,5014,4409,29,3,573,405,326,27,3,49,4609,4083,2,524,09/30/00,2000-09-30,2000
OKLAHOMA,OKLAHOMA EASTERN,OKE,TENTH CIRCUIT,3619,3362,14,9,234,85,53,14,9,9,3534,3309,0,225,09/30/00,2000-09-30,2000
OKLAHOMA,OKLAHOMA WESTERN,OKW,TENTH CIRCUIT,10449,8591,25,15,1817,327,247,25,15,39,10122,8344,0,1778,09/30/00,2000-09-30,2000
UTAH,UTAH,UT,TENTH CIRCUIT,14738,8865,47,2,5823,461,299,45,2,114,14277,8566,2,5709,09/30/00,2000-09-30,2000
WYOMING,WYOMING,WY,TENTH CIRCUIT,2010,1871,16,2,121,48,32,7,2,7,1962,1839,9,114,09/30/00,2000-09-30,2000
ALABAMA,ALABAMA NORTHERN,ALN,ELEVENTH CIRCUIT,20186,7649,64,3,12470,263,134,51,3,75,19923,7515,13,12395,09/30/00,2000-09-30,2000
ALABAMA,ALABAMA MIDDLE,ALM,ELEVENTH CIRCUIT,6976,2987,25,5,3959,148,75,24,5,44,6828,2912,1,3915,09/30/00,2000-09-30,2000
ALABAMA,ALABAMA SOUTHERN,ALS,ELEVENTH CIRCUIT,5183,2249,18,0,2915,34,16,17,0,0,5149,2233,1,2915,09/30/00,2000-09-30,2000
FLORIDA,FLORIDA NORTHERN,FLN,ELEVENTH CIRCUIT,5123,3977,39,1,1106,74,30,36,1,7,5049,3947,3,1099,09/30/00,2000-09-30,2000
FLORIDA,FLORIDA MIDDLE,FLM,ELEVENTH CIRCUIT,40717,28923,230,3,11561,804,473,214,3,114,39913,28450,16,11447,09/30/00,2000-09-30,2000
FLORIDA,FLORIDA SOUTHERN,FLS,ELEVENTH CIRCUIT,27598,19595,236,1,7762,619,408,206,1,0,26979,19187,30,7762,09/30/00,2000-09-30,2000
GEORGIA,GEORGIA NORTHERN,GAN,ELEVENTH CIRCUIT,31824,12823,189,1,18809,661,312,176,1,170,31163,12511,13,18639,09/30/00,2000-09-30,2000
GEORGIA,GEORGIA MIDDLE,GAM,ELEVENTH CIRCUIT,14452,5947,27,16,8462,133,55,25,16,37,14319,5892,2,8425,09/30/00,2000-09-30,2000
GEORGIA,GEORGIA SOUTHERN,GAS,ELEVENTH CIRCUIT,12298,2939,30,4,9325,179,75,27,4,73,12119,2864,3,9252,09/30/00,2000-09-30,2000
DISTRICT OF COLUMBIA,DISTRICT OF COLUMBIA,DC,DC CIRCUIT,2522,1720,27,0,775,35,9,23,0,3,2487,1711,4,772,09/30/01,2001-09-30,2001
MAINE,MAINE,ME,FIRST CIRCUIT,4400,4052,27,1,320,161,115,27,1,18,4239,3937,0,302,09/30/01,2001-09-30,2001
MASSACHUSETTS,MASSACHUSETTS,MA,FIRST CIRCUIT,17455,14992,149,1,2312,387,231,147,1,7,17068,14761,2,2305,09/30/01,2001-09-30,2001
NEW HAMPSHIRE,NEW HAMPSHIRE,NH,FIRST CIRCUIT,3869,3530,27,0,312,308,272,27,0,9,3561,3258,0,303,09/30/01,2001-09-30,2001
RHODE ISLAND,RHODE ISLAND,RI,FIRST CIRCUIT,4790,4407,14,0,369,73,54,12,0,7,4717,4353,2,362,09/30/01,2001-09-30,2001
PUERTO RICO,PUERTO RICO,PR,FIRST CIRCUIT,14435,4225,121,0,10089,286,152,102,0,32,14149,4073,19,10057,09/30/01,2001-09-30,2001
CONNECTICUT,CONNECTICUT,CT,SECOND CIRCUIT,11523,9925,94,2,1502,172,87,82,2,1,11351,9838,12,1501,09/30/01,2001-09-30,2001
NEW YORK,NEW YORK NORTHERN,NYN,SECOND CIRCUIT,15363,12603,59,7,2693,434,280,57,7,89,14929,12323,2,2604,09/30/01,2001-09-30,2001
NEW YORK,NEW YORK EASTERN,NYE,SECOND CIRCUIT,25299,19813,268,0,5218,388,127,256,0,5,24911,19686,12,5213,09/30/01,2001-09-30,2001
NEW YORK,NEW YORK SOUTHERN,NYS,SECOND CIRCUIT,14380,11801,1013,0,1546,1194,195,972,0,7,13186,11606,41,1539,09/30/01,2001-09-30,2001
NEW YORK,NEW YORK WESTERN,NYW,SECOND CIRCUIT,12495,9610,52,1,2832,423,292,49,1,81,12072,9318,3,2751,09/30/01,2001-09-30,2001
VERMONT,VERMONT,VT,SECOND CIRCUIT,1754,1566,1,1,186,88,62,1,1,24,1666,1504,0,162,09/30/01,2001-09-30,2001
DELAWARE,DELAWARE,DE,THIRD CIRCUIT,3951,1889,1060,0,1002,1133,69,1059,0,5,2818,1820,1,997,09/30/01,2001-09-30,2001
NEW JERSEY,NEW JERSEY,NJ,THIRD CIRCUIT,41059,26537,385,2,14135,716,368,339,2,7,40343,26169,46,14128,09/30/01,2001-09-30,2001
PENNSYLVANIA,PENNSYLVANIA EASTERN,PAE,THIRD CIRCUIT,23526,13787,151,2,9586,329,172,137,2,18,23197,13615,14,9568,09/30/01,2001-09-30,2001
PENNSYLVANIA,PENNSYLVANIA MIDDLE,PAM,THIRD CIRCUIT,11943,9458,73,1,2411,744,471,70,1,202,11199,8987,3,2209,09/30/01,2001-09-30,2001
PENNSYLVANIA,PENNSYLVANIA WESTERN,PAW,THIRD CIRCUIT,15142,12864,142,1,2135,433,281,127,1,24,14709,12583,15,2111,09/30/01,2001-09-30,2001
VIRGIN ISLANDS,VIRGIN ISLANDS,VI,THIRD CIRCUIT,69,48,6,0,15,13,8,5,0,0,56,40,1,15,09/30/01,2001-09-30,2001
MARYLAND,MARYLAND,MD,FOURTH CIRCUIT,34610,23868,174,0,10568,782,496,154,0,132,33828,23372,20,10436,09/30/01,2001-09-30,2001
NORTH CAROLINA,NORTH CAROLINA EASTERN,NCE,FOURTH CIRCUIT,13144,6397,52,7,6687,229,111,47,7,63,12915,6286,5,6624,09/30/01,2001-09-30,2001
NORTH CAROLINA,NORTH CAROLINA MIDDLE,NCM,FOURTH CIRCUIT,10513,4025,47,0,6441,220,136,47,0,37,10293,3889,0,6404,09/30/01,2001-09-30,2001
NORTH CAROLINA,NORTH CAROLINA WESTERN,NCW,FOURTH CIRCUIT,8489,4166,44,2,4277,114,70,41,2,1,8375,4096,3,4276,09/30/01,2001-09-30,2001
SOUTH CAROLINA,SOUTH CAROLINA,SC,FOURTH CIRCUIT,13506,6294,80,2,7130,140,67,62,2,9,13366,6227,18,7121,09/30/01,2001-09-30,2001
VIRGINIA,VIRGINIA EASTERN,VAE,FOURTH CIRCUIT,28145,20156,167,0,7822,301,156,137,0,8,27844,20000,30,7814,09/30/01,2001-09-30,2001
VIRGINIA,VIRGINIA WESTERN,VAW,FOURTH CIRCUIT,12286,10459,40,4,1781,601,485,37,4,73,11685,9974,3,1708,09/30/01,2001-09-30,2001
WEST VIRGINIA,WEST VIRGINIA NORTHERN,WVN,FOURTH CIRCUIT,4042,3784,16,1,241,145,112,16,1,16,3897,3672,0,225,09/30/01,2001-09-30,2001
WEST VIRGINIA,WEST VIRGINIA SOUTHERN,WVS,FOURTH CIRCUIT,6100,5773,40,0,287,191,134,39,0,18,5909,5639,1,269,09/30/01,2001-09-30,2001
LOUISIANA,LOUISIANA EASTERN,LAE,FIFTH CIRCUIT,10003,6674,59,1,3269,134,79,52,1,2,9869,6595,7,3267,09/30/01,2001-09-30,2001
LOUISIANA,LOUISIANA MIDDLE,LAM,FIFTH CIRCUIT,3222,2340,16,0,866,35,20,15,0,0,3187,2320,1,866,09/30/01,2001-09-30,2001
LOUISIANA,LOUISIANA WESTERN,LAW,FIFTH CIRCUIT,13222,6989,62,6,6165,524,302,60,6,156,12698,6687,2,6009,09/30/01,2001-09-30,2001
MISSISSIPPI,MISSISSIPPI NORTHERN,MSN,FIFTH CIRCUIT,7613,4831,23,3,2756,93,61,21,3,8,7520,4770,2,2748,09/30/01,2001-09-30,2001
MISSISSIPPI,MISSISSIPPI SOUTHERN,MSS,FIFTH CIRCUIT,13862,8806,84,2,4970,191,98,78,2,13,13671,8708,6,4957,09/30/01,2001-09-30,2001
TEXAS,TEXAS NORTHERN,TXN,FIFTH CIRCUIT,25140,13055,309,17,11759,1025,574,300,17,134,24115,12481,9,11625,09/30/01,2001-09-30,2001
TEXAS,TEXAS EASTERN,TXE,FIFTH CIRCUIT,10675,5824,69,2,4780,456,237,64,2,153,10219,5587,5,4627,09/30/01,2001-09-30,2001
TEXAS,TEXAS SOUTHERN,TXS,FIFTH CIRCUIT,19437,10875,322,2,8236,977,492,309,2,172,18460,10383,13,8064,09/30/01,2001-09-30,2001
TEXAS,TEXAS WESTERN,TXW,FIFTH CIRCUIT,17484,9751,137,3,7590,518,309,124,3,79,16966,9442,13,7511,09/30/01,2001-09-30,2001
KENTUCKY,KENTUCKY EASTERN,KYE,SIXTH CIRCUIT,11088,9630,94,0,1364,316,195,91,0,30,10772,9435,3,1334,09/30/01,2001-09-30,2001
KENTUCKY,KENTUCKY WESTERN,KYW,SIXTH CIRCUIT,14145,11509,53,1,2582,154,97,53,1,3,13991,11412,0,2579,09/30/01,2001-09-30,2001
MICHIGAN,MICHIGAN EASTERN,MIE,SIXTH CIRCUIT,30731,21993,165,0,8573,386,214,160,0,12,30345,21779,5,8561,09/30/01,2001-09-30,2001
MICHIGAN,MICHIGAN WESTERN,MIW,SIXTH CIRCUIT,13317,10107,59,3,3148,262,177,59,3,23,13055,9930,0,3125,09/30/01,2001-09-30,2001
OHIO,OHIO NORTHERN,OHN,SIXTH CIRCUIT,35023,28807,158,0,6058,1244,903,155,0,186,33779,27904,3,5872,09/30/01,2001-09-30,2001
OHIO,OHIO SOUTHERN,OHS,SIXTH CIRCUIT,32734,25763,127,4,6839,549,334,120,4,90,32185,25429,7,6749,09/30/01,2001-09-30,2001
TENNESSEE,TENNESSEE EASTERN,TNE,SIXTH CIRCUIT,18477,11141,67,2,7267,354,217,61,2,74,18123,10924,6,7193,09/30/01,2001-09-30,2001
TENNESSEE,TENNESSEE MIDDLE,TNM,SIXTH CIRCUIT,13761,8580,111,0,5070,202,104,82,0,16,13559,8476,29,5054,09/30/01,2001-09-30,2001
TENNESSEE,TENNESSEE WESTERN,TNW,SIXTH CIRCUIT,25250,7012,150,0,18088,239,79,126,0,34,25011,6933,24,18054,09/30/01,2001-09-30,2001
ILLINOIS,ILLINOIS NORTHERN,ILN,SEVENTH CIRCUIT,48435,33622,243,1,14569,725,469,231,1,24,47710,33153,12,14545,09/30/01,2001-09-30,2001
ILLINOIS,ILLINOIS CENTRAL,ILC,SEVENTH CIRCUIT,13742,11743,39,18,1942,176,107,38,18,13,13566,11636,1,1929,09/30/01,2001-09-30,2001
ILLINOIS,ILLINOIS SOUTHERN,ILS,SEVENTH CIRCUIT,8573,6157,26,11,2379,586,407,24,11,144,7987,5750,2,2235,09/30/01,2001-09-30,2001
INDIANA,INDIANA NORTHERN,INN,SEVENTH CIRCUIT,17521,14712,60,3,2746,174,98,53,3,20,17347,14614,7,2726,09/30/01,2001-09-30,2001
INDIANA,INDIANA SOUTHERN,INS,SEVENTH CIRCUIT,27621,21591,86,3,5941,346,244,78,3,21,27275,21347,8,5920,09/30/01,2001-09-30,2001
WISCONSIN,WISCONSIN EASTERN,WIE,SEVENTH CIRCUIT,14059,11482,13,1,2563,231,193,13,1,24,13828,11289,0,2539,09/30/01,2001-09-30,2001
WISCONSIN,WISCONSIN WESTERN,WIW,SEVENTH CIRCUIT,7111,6267,54,12,778,485,362,46,12,65,6626,5905,8,713,09/30/01,2001-09-30,2001
ARKANSAS,ARKANSAS EASTERN,ARE,EIGHTH CIRCUIT,13024,6853,26,3,6142,181,74,23,3,81,12843,6779,3,6061,09/30/01,2001-09-30,2001
ARKANSAS,ARKANSAS WESTERN,ARW,EIGHTH CIRCUIT,7452,5119,7,3,2323,113,75,7,3,28,7339,5044,0,2295,09/30/01,2001-09-30,2001
IOWA,IOWA NORTHERN,IAN,EIGHTH CIRCUIT,4230,4067,9,3,151,184,164,9,3,8,4046,3903,0,143,09/30/01,2001-09-30,2001
IOWA,IOWA SOUTHERN,IAS,EIGHTH CIRCUIT,6317,5828,18,4,467,92,67,18,4,3,6225,5761,0,464,09/30/01,2001-09-30,2001
MINNESOTA,MINNESOTA,MN,EIGHTH CIRCUIT,17812,14614,61,8,3129,1845,1485,61,8,291,15967,13129,0,2838,09/30/01,2001-09-30,2001
MISSOURI,MISSOURI EASTERN,MOE,EIGHTH CIRCUIT,16364,10687,93,5,5579,255,141,86,5,23,16109,10546,7,5556,09/30/01,2001-09-30,2001
MISSOURI,MISSOURI WESTERN,MOW,EIGHTH CIRCUIT,13220,10556,50,4,2609,181,96,45,4,35,13039,10460,5,2574,09/30/01,2001-09-30,2001
NEBRASKA,NEBRASKA,NE,EIGHTH CIRCUIT,6888,5787,49,27,1025,145,59,48,27,11,6743,5728,1,1014,09/30/01,2001-09-30,2001
NORTH DAKOTA,NORTH DAKOTA,ND,EIGHTH CIRCUIT,2236,2148,14,8,66,117,87,14,8,8,2119,2061,0,58,09/30/01,2001-09-30,2001
SOUTH DAKOTA,SOUTH DAKOTA,SD,EIGHTH CIRCUIT,2565,2450,12,0,103,171,143,11,0,17,2394,2307,1,86,09/30/01,2001-09-30,2001
ALASKA,ALASKA,AK,NINTH CIRCUIT,1467,1302,17,0,148,112,77,17,0,18,1355,1225,0,130,09/30/01,2001-09-30,2001
ARIZONA,ARIZONA,AZ,NINTH CIRCUIT,24001,19277,302,3,4417,769,399,272,3,95,23232,18878,30,4322,09/30/01,2001-09-30,2001
CALIFORNIA,CALIFORNIA NORTHERN,CAN,NINTH CIRCUIT,19354,13636,264,2,5450,1127,584,252,2,288,18227,13052,12,5162,09/30/01,2001-09-30,2001
CALIFORNIA,CALIFORNIA EASTERN,CAE,NINTH CIRCUIT,31758,27147,118,25,4467,1244,823,106,25,289,30514,26324,12,4178,09/30/01,2001-09-30,2001
CALIFORNIA,CALIFORNIA CENTRAL,CAC,NINTH CIRCUIT,86011,70971,488,3,14546,2386,1779,430,3,171,83625,69192,58,14375,09/30/01,2001-09-30,2001
CALIFORNIA,CALIFORNIA SOUTHERN,CAS,NINTH CIRCUIT,13188,10461,58,1,2666,175,117,49,1,6,13013,10344,9,2660,09/30/01,2001-09-30,2001
HAWAII,HAWAII,HI,NINTH CIRCUIT,4975,4453,30,0,491,75,45,26,0,3,4900,4408,4,488,09/30/01,2001-09-30,2001
IDAHO,IDAHO,ID,NINTH CIRCUIT,8124,6836,76,9,1203,279,157,70,9,43,7845,6679,6,1160,09/30/01,2001-09-30,2001
MONTANA,MONTANA,MT,NINTH CIRCUIT,3823,3379,17,3,424,143,111,13,3,16,3680,3268,4,408,09/30/01,2001-09-30,2001
NEVADA,NEVADA,NV,NINTH CIRCUIT,17265,12808,234,1,4222,443,184,223,1,35,16822,12624,11,4187,09/30/01,2001-09-30,2001
OREGON,OREGON,OR,NINTH CIRCUIT,22008,18757,40,12,3199,1306,584,40,12,670,20702,18173,0,2529,09/30/01,2001-09-30,2001
WASHINGTON,WASHINGTON EASTERN,WAE,NINTH CIRCUIT,9891,7440,49,27,2375,334,215,36,27,56,9557,7225,13,2319,09/30/01,2001-09-30,2001
WASHINGTON,WASHINGTON WESTERN,WAW,NINTH CIRCUIT,25872,20806,152,1,4913,311,155,131,1,24,25561,20651,21,4889,09/30/01,2001-09-30,2001
GUAM,GUAM,GUAM,NINTH CIRCUIT,226,180,10,0,36,26,12,10,0,4,200,168,0,32,09/30/01,2001-09-30,2001
NORTHERN MARIANA ISLANDS,NORTHERN MARIANAS,NMI,NINTH CIRCUIT,20,19,1,0,0,5,4,1,0,0,15,15,0,0,09/30/01,2001-09-30,2001
COLORADO,COLORADO,CO,TENTH CIRCUIT,18117,15664,93,3,2357,440,323,91,3,23,17677,15341,2,2334,09/30/01,2001-09-30,2001
KANSAS,KANSAS,KS,TENTH CIRCUIT,13329,11021,48,16,2244,212,126,44,16,26,13117,10895,4,2218,09/30/01,2001-09-30,2001
NEW MEXICO,NEW MEXICO,NM,TENTH CIRCUIT,8426,7275,62,4,1085,586,438,59,4,85,7840,6837,3,1000,09/30/01,2001-09-30,2001
OKLAHOMA,OKLAHOMA NORTHERN,OKN,TENTH CIRCUIT,5692,5164,23,3,502,508,435,22,3,48,5184,4729,1,454,09/30/01,2001-09-30,2001
OKLAHOMA,OKLAHOMA EASTERN,OKE,TENTH CIRCUIT,4148,3873,12,6,257,99,73,12,6,8,4049,3800,0,249,09/30/01,2001-09-30,2001
OKLAHOMA,OKLAHOMA WESTERN,OKW,TENTH CIRCUIT,12959,10752,40,25,2142,375,274,39,25,37,12584,10478,1,2105,09/30/01,2001-09-30,2001
UTAH,UTAH,UT,TENTH CIRCUIT,18522,11846,75,1,6600,463,290,73,1,99,18059,11556,2,6501,09/30/01,2001-09-30,2001
WYOMING,WYOMING,WY,TENTH CIRCUIT,2489,2337,9,0,143,49,34,8,0,7,2440,2303,1,136,09/30/01,2001-09-30,2001
ALABAMA,ALABAMA NORTHERN,ALN,ELEVENTH CIRCUIT,22985,10009,101,3,12872,218,104,79,3,32,22767,9905,22,12840,09/30/01,2001-09-30,2001
ALABAMA,ALABAMA MIDDLE,ALM,ELEVENTH CIRCUIT,8079,3729,20,0,4330,136,93,17,0,26,7943,3636,3,4304,09/30/01,2001-09-30,2001
ALABAMA,ALABAMA SOUTHERN,ALS,ELEVENTH CIRCUIT,6440,2877,30,1,3532,62,21,27,1,13,6378,2856,3,3519,09/30/01,2001-09-30,2001
FLORIDA,FLORIDA NORTHERN,FLN,ELEVENTH CIRCUIT,5996,4762,47,3,1184,92,41,42,3,6,5904,4721,5,1178,09/30/01,2001-09-30,2001
FLORIDA,FLORIDA MIDDLE,FLM,ELEVENTH CIRCUIT,47017,34075,280,4,12657,973,592,258,4,118,46044,33483,22,12539,09/30/01,2001-09-30,2001
FLORIDA,FLORIDA SOUTHERN,FLS,ELEVENTH CIRCUIT,30572,21545,320,0,8706,724,420,301,0,2,29848,21125,19,8704,09/30/01,2001-09-30,2001
GEORGIA,GEORGIA NORTHERN,GAN,ELEVENTH CIRCUIT,36534,15838,174,1,20520,887,425,162,1,298,35647,15413,12,20222,09/30/01,2001-09-30,2001
GEORGIA,GEORGIA MIDDLE,GAM,ELEVENTH CIRCUIT,16717,7084,35,24,9574,110,36,34,24,16,16607,7048,1,9558,09/30/01,2001-09-30,2001
GEORGIA,GEORGIA SOUTHERN,GAS,ELEVENTH CIRCUIT,14185,3695,40,3,10446,115,54,36,3,22,14070,3641,4,10424,09/30/01,2001-09-30,2001
DISTRICT OF COLUMBIA,DISTRICT OF COLUMBIA,DC,DC CIRCUIT,2521,1770,34,0,717,58,26,29,0,3,2463,1744,5,714,09/30/02,2002-09-30,2002
MAINE,MAINE,ME,FIRST CIRCUIT,4467,4059,18,2,388,101,69,18,2,12,4366,3990,0,376,09/30/02,2002-09-30,2002
MASSACHUSETTS,MASSACHUSETTS,MA,FIRST CIRCUIT,17069,14363,199,3,2503,433,232,195,3,2,16636,14131,4,2501,09/30/02,2002-09-30,2002
NEW HAMPSHIRE,NEW HAMPSHIRE,NH,FIRST CIRCUIT,3903,3517,31,0,355,233,196,29,0,8,3670,3321,2,347,09/30/02,2002-09-30,2002
RHODE ISLAND,RHODE ISLAND,RI,FIRST CIRCUIT,4830,4430,6,0,394,68,60,6,0,2,4762,4370,0,392,09/30/02,2002-09-30,2002
PUERTO RICO,PUERTO RICO,PR,FIRST CIRCUIT,13880,4209,136,2,9533,393,155,110,2,126,13487,4054,26,9407,09/30/02,2002-09-30,2002
CONNECTICUT,CONNECTICUT,CT,SECOND CIRCUIT,11456,9513,122,0,1821,179,69,107,0,3,11277,9444,15,1818,09/30/02,2002-09-30,2002
NEW YORK,NEW YORK NORTHERN,NYN,SECOND CIRCUIT,15941,12688,87,5,3161,357,191,83,5,78,15584,12497,4,3083,09/30/02,2002-09-30,2002
NEW YORK,NEW YORK EASTERN,NYE,SECOND CIRCUIT,25098,19296,182,0,5620,315,140,169,0,6,24783,19156,13,5614,09/30/02,2002-09-30,2002
NEW YORK,NEW YORK SOUTHERN,NYS,SECOND CIRCUIT,15914,12586,1473,1,1827,1635,177,1422,1,8,14279,12409,51,1819,09/30/02,2002-09-30,2002
NEW YORK,NEW YORK WESTERN,NYW,SECOND CIRCUIT,13051,9851,45,4,3150,282,189,41,4,47,12769,9662,4,3103,09/30/02,2002-09-30,2002
VERMONT,VERMONT,VT,SECOND CIRCUIT,1774,1561,7,0,206,101,76,7,0,18,1673,1485,0,188,09/30/02,2002-09-30,2002
DELAWARE,DELAWARE,DE,THIRD CIRCUIT,3966,1960,892,0,1094,981,55,890,0,16,2985,1905,2,1078,09/30/02,2002-09-30,2002
NEW JERSEY,NEW JERSEY,NJ,THIRD CIRCUIT,40708,25611,357,0,14739,702,363,326,0,12,40006,25248,31,14727,09/30/02,2002-09-30,2002
PENNSYLVANIA,PENNSYLVANIA EASTERN,PAE,THIRD CIRCUIT,24390,13541,114,2,10733,304,175,105,2,22,24086,13366,9,10711,09/30/02,2002-09-30,2002
PENNSYLVANIA,PENNSYLVANIA MIDDLE,PAM,THIRD CIRCUIT,12495,9499,66,0,2930,620,391,64,0,165,11875,9108,2,2765,09/30/02,2002-09-30,2002
PENNSYLVANIA,PENNSYLVANIA WESTERN,PAW,THIRD CIRCUIT,16596,13693,192,1,2710,439,227,180,1,31,16157,13466,12,2679,09/30/02,2002-09-30,2002
VIRGIN ISLANDS,VIRGIN ISLANDS,VI,THIRD CIRCUIT,59,29,5,0,25,8,3,4,0,1,51,26,1,24,09/30/02,2002-09-30,2002
MARYLAND,MARYLAND,MD,FOURTH CIRCUIT,34963,23353,171,0,11439,636,393,150,0,93,34327,22960,21,11346,09/30/02,2002-09-30,2002
NORTH CAROLINA,NORTH CAROLINA EASTERN,NCE,FOURTH CIRCUIT,14820,7310,63,6,7441,232,139,55,6,32,14588,7171,8,7409,09/30/02,2002-09-30,2002
NORTH CAROLINA,NORTH CAROLINA MIDDLE,NCM,FOURTH CIRCUIT,11668,4869,26,0,6773,269,201,26,0,42,11399,4668,0,6731,09/30/02,2002-09-30,2002
NORTH CAROLINA,NORTH CAROLINA WESTERN,NCW,FOURTH CIRCUIT,9429,4840,54,0,4535,98,51,46,0,1,9331,4789,8,4534,09/30/02,2002-09-30,2002
SOUTH CAROLINA,SOUTH CAROLINA,SC,FOURTH CIRCUIT,15531,6776,96,0,8659,183,99,82,0,2,15348,6677,14,8657,09/30/02,2002-09-30,2002
VIRGINIA,VIRGINIA EASTERN,VAE,FOURTH CIRCUIT,30141,21168,169,0,8804,391,226,134,0,31,29750,20942,35,8773,09/30/02,2002-09-30,2002
VIRGINIA,VIRGINIA WESTERN,VAW,FOURTH CIRCUIT,12509,10780,35,0,1693,566,460,34,0,71,11943,10320,1,1622,09/30/02,2002-09-30,2002
WEST VIRGINIA,WEST VIRGINIA NORTHERN,WVN,FOURTH CIRCUIT,4200,3912,23,0,265,108,78,20,0,10,4092,3834,3,255,09/30/02,2002-09-30,2002
WEST VIRGINIA,WEST VIRGINIA SOUTHERN,WVS,FOURTH CIRCUIT,5821,5497,45,0,279,218,167,43,0,8,5603,5330,2,271,09/30/02,2002-09-30,2002
LOUISIANA,LOUISIANA EASTERN,LAE,FIFTH CIRCUIT,9579,6478,66,0,3035,177,115,59,0,3,9402,6363,7,3032,09/30/02,2002-09-30,2002
LOUISIANA,LOUISIANA MIDDLE,LAM,FIFTH CIRCUIT,3678,2595,54,0,1029,68,17,50,0,1,3610,2578,4,1028,09/30/02,2002-09-30,2002
LOUISIANA,LOUISIANA WESTERN,LAW,FIFTH CIRCUIT,13583,7269,47,12,6255,470,267,44,12,147,13113,7002,3,6108,09/30/02,2002-09-30,2002
MISSISSIPPI,MISSISSIPPI NORTHERN,MSN,FIFTH CIRCUIT,8080,5372,47,2,2659,122,67,45,2,8,7958,5305,2,2651,09/30/02,2002-09-30,2002
MISSISSIPPI,MISSISSIPPI SOUTHERN,MSS,FIFTH CIRCUIT,14019,8920,85,6,5008,173,87,70,6,10,13846,8833,15,4998,09/30/02,2002-09-30,2002
TEXAS,TEXAS NORTHERN,TXN,FIFTH CIRCUIT,28195,13572,290,13,14319,1142,645,276,13,207,27053,12927,14,14112,09/30/02,2002-09-30,2002
TEXAS,TEXAS EASTERN,TXE,FIFTH CIRCUIT,12243,6555,77,2,5609,358,167,73,2,116,11885,6388,4,5493,09/30/02,2002-09-30,2002
TEXAS,TEXAS SOUTHERN,TXS,FIFTH CIRCUIT,20812,11112,364,3,9332,815,369,325,3,117,19997,10743,39,9215,09/30/02,2002-09-30,2002
TEXAS,TEXAS WESTERN,TXW,FIFTH CIRCUIT,18495,10219,182,9,8083,684,376,160,9,137,17811,9843,22,7946,09/30/02,2002-09-30,2002
KENTUCKY,KENTUCKY EASTERN,KYE,SIXTH CIRCUIT,11905,10310,107,0,1488,246,129,105,0,12,11659,10181,2,1476,09/30/02,2002-09-30,2002
KENTUCKY,KENTUCKY WESTERN,KYW,SIXTH CIRCUIT,14934,11920,57,1,2956,126,67,51,1,7,14808,11853,6,2949,09/30/02,2002-09-30,2002
MICHIGAN,MICHIGAN EASTERN,MIE,SIXTH CIRCUIT,37517,25551,184,3,11779,442,230,177,3,32,37075,25321,7,11747,09/30/02,2002-09-30,2002
MICHIGAN,MICHIGAN WESTERN,MIW,SIXTH CIRCUIT,15012,11326,72,3,3611,325,202,69,3,51,14687,11124,3,3560,09/30/02,2002-09-30,2002
OHIO,OHIO NORTHERN,OHN,SIXTH CIRCUIT,40341,33090,128,0,7123,1035,782,125,0,128,39306,32308,3,6995,09/30/02,2002-09-30,2002
OHIO,OHIO SOUTHERN,OHS,SIXTH CIRCUIT,35781,27532,106,5,8138,557,329,99,5,124,35224,27203,7,8014,09/30/02,2002-09-30,2002
TENNESSEE,TENNESSEE EASTERN,TNE,SIXTH CIRCUIT,19466,11904,74,4,7484,320,189,70,4,57,19146,11715,4,7427,09/30/02,2002-09-30,2002
TENNESSEE,TENNESSEE MIDDLE,TNM,SIXTH CIRCUIT,15360,9500,194,0,5666,273,104,154,0,15,15087,9396,40,5651,09/30/02,2002-09-30,2002
TENNESSEE,TENNESSEE WESTERN,TNW,SIXTH CIRCUIT,27984,8037,124,2,19821,232,96,103,2,31,27752,7941,21,19790,09/30/02,2002-09-30,2002
ILLINOIS,ILLINOIS NORTHERN,ILN,SEVENTH CIRCUIT,55985,39360,385,1,16237,831,466,356,1,6,55154,38894,29,16231,09/30/02,2002-09-30,2002
ILLINOIS,ILLINOIS CENTRAL,ILC,SEVENTH CIRCUIT,15353,13071,41,21,2220,193,125,39,21,8,15160,12946,2,2212,09/30/02,2002-09-30,2002
ILLINOIS,ILLINOIS SOUTHERN,ILS,SEVENTH CIRCUIT,8859,6304,26,8,2521,286,173,23,8,82,8573,6131,3,2439,09/30/02,2002-09-30,2002
INDIANA,INDIANA NORTHERN,INN,SEVENTH CIRCUIT,20591,17239,48,2,3302,215,142,47,2,24,20376,17097,1,3278,09/30/02,2002-09-30,2002
INDIANA,INDIANA SOUTHERN,INS,SEVENTH CIRCUIT,32095,25156,159,0,6780,491,304,153,0,34,31604,24852,6,6746,09/30/02,2002-09-30,2002
WISCONSIN,WISCONSIN EASTERN,WIE,SEVENTH CIRCUIT,16079,13076,16,7,2979,229,186,16,7,20,15850,12890,0,2959,09/30/02,2002-09-30,2002
WISCONSIN,WISCONSIN WESTERN,WIW,SEVENTH CIRCUIT,8163,7177,49,13,924,629,484,43,13,89,7534,6693,6,835,09/30/02,2002-09-30,2002
ARKANSAS,ARKANSAS EASTERN,ARE,EIGHTH CIRCUIT,14546,7646,22,2,6876,131,72,14,2,43,14415,7574,8,6833,09/30/02,2002-09-30,2002
ARKANSAS,ARKANSAS WESTERN,ARW,EIGHTH CIRCUIT,8148,5489,18,1,2639,109,53,15,1,39,8039,5436,3,2600,09/30/02,2002-09-30,2002
IOWA,IOWA NORTHERN,IAN,EIGHTH CIRCUIT,4451,4272,15,2,162,198,173,14,2,9,4253,4099,1,153,09/30/02,2002-09-30,2002
IOWA,IOWA SOUTHERN,IAS,EIGHTH CIRCUIT,7022,6568,11,4,439,136,113,11,4,8,6886,6455,0,431,09/30/02,2002-09-30,2002
MINNESOTA,MINNESOTA,MN,EIGHTH CIRCUIT,19655,16337,56,6,3256,1825,1501,55,6,263,17830,14836,1,2993,09/30/02,2002-09-30,2002
MISSOURI,MISSOURI EASTERN,MOE,EIGHTH CIRCUIT,17538,11651,79,5,5802,216,123,72,5,15,17322,11528,7,5787,09/30/02,2002-09-30,2002
MISSOURI,MISSOURI WESTERN,MOW,EIGHTH CIRCUIT,15270,12319,84,2,2865,226,107,81,2,36,15044,12212,3,2829,09/30/02,2002-09-30,2002
NEBRASKA,NEBRASKA,NE,EIGHTH CIRCUIT,7443,5844,52,19,1528,132,55,44,19,14,7311,5789,8,1514,09/30/02,2002-09-30,2002
NORTH DAKOTA,NORTH DAKOTA,ND,EIGHTH CIRCUIT,2028,1940,8,9,71,108,87,8,9,4,1920,1853,0,67,09/30/02,2002-09-30,2002
SOUTH DAKOTA,SOUTH DAKOTA,SD,EIGHTH CIRCUIT,2673,2535,5,3,130,122,98,5,3,16,2551,2437,0,114,09/30/02,2002-09-30,2002
ALASKA,ALASKA,AK,NINTH CIRCUIT,1432,1291,18,0,123,112,80,16,0,16,1320,1211,2,107,09/30/02,2002-09-30,2002
ARIZONA,ARIZONA,AZ,NINTH CIRCUIT,28738,22788,323,6,5620,733,372,271,6,83,28005,22416,52,5537,09/30/02,2002-09-30,2002
CALIFORNIA,CALIFORNIA NORTHERN,CAN,NINTH CIRCUIT,20719,14512,260,0,5945,1277,706,241,0,329,19442,13806,19,5616,09/30/02,2002-09-30,2002
CALIFORNIA,CALIFORNIA EASTERN,CAE,NINTH CIRCUIT,31455,26584,117,20,4733,1265,823,104,20,317,30190,25761,13,4416,09/30/02,2002-09-30,2002
CALIFORNIA,CALIFORNIA CENTRAL,CAC,NINTH CIRCUIT,84936,70142,614,1,14170,2545,1806,561,1,169,82391,68336,53,14001,09/30/02,2002-09-30,2002
CALIFORNIA,CALIFORNIA SOUTHERN,CAS,NINTH CIRCUIT,12844,10336,64,0,2443,223,159,50,0,13,12621,10177,14,2430,09/30/02,2002-09-30,2002
HAWAII,HAWAII,HI,NINTH CIRCUIT,4684,4181,21,0,482,57,38,19,0,0,4627,4143,2,482,09/30/02,2002-09-30,2002
IDAHO,IDAHO,ID,NINTH CIRCUIT,8686,7440,64,8,1174,287,171,52,8,56,8399,7269,12,1118,09/30/02,2002-09-30,2002
MONTANA,MONTANA,MT,NINTH CIRCUIT,4102,3584,19,8,491,122,87,15,8,12,3980,3497,4,479,09/30/02,2002-09-30,2002
NEVADA,NEVADA,NV,NINTH CIRCUIT,19095,14000,312,0,4782,447,147,281,0,18,18648,13853,31,4764,09/30/02,2002-09-30,2002
OREGON,OREGON,OR,NINTH CIRCUIT,24034,20626,70,10,3327,1515,679,70,10,755,22519,19947,0,2572,09/30/02,2002-09-30,2002
WASHINGTON,WASHINGTON EASTERN,WAE,NINTH CIRCUIT,10059,7596,87,5,2371,295,169,62,5,59,9764,7427,25,2312,09/30/02,2002-09-30,2002
WASHINGTON,WASHINGTON WESTERN,WAW,NINTH CIRCUIT,28349,22980,187,0,5182,409,241,143,0,25,27940,22739,44,5157,09/30/02,2002-09-30,2002
GUAM,GUAM,GUAM,NINTH CIRCUIT,400,350,6,0,44,26,19,5,0,2,374,331,1,42,09/30/02,2002-09-30,2002
NORTHERN MARIANA ISLANDS,NORTHERN MARIANAS,NMI,NINTH CIRCUIT,28,24,1,0,3,6,5,1,0,0,22,19,0,3,09/30/02,2002-09-30,2002
COLORADO,COLORADO,CO,TENTH CIRCUIT,20303,17666,110,4,2523,560,416,107,4,33,19743,17250,3,2490,09/30/02,2002-09-30,2002
KANSAS,KANSAS,KS,TENTH CIRCUIT,14519,11790,48,18,2663,243,148,45,18,32,14276,11642,3,2631,09/30/02,2002-09-30,2002
NEW MEXICO,NEW MEXICO,NM,TENTH CIRCUIT,8975,8084,54,2,835,665,549,51,2,63,8310,7535,3,772,09/30/02,2002-09-30,2002
OKLAHOMA,OKLAHOMA NORTHERN,OKN,TENTH CIRCUIT,6374,5808,24,0,542,322,275,21,0,26,6052,5533,3,516,09/30/02,2002-09-30,2002
OKLAHOMA,OKLAHOMA EASTERN,OKE,TENTH CIRCUIT,4500,4143,10,3,344,79,52,10,3,14,4421,4091,0,330,09/30/02,2002-09-30,2002
OKLAHOMA,OKLAHOMA WESTERN,OKW,TENTH CIRCUIT,12959,10985,41,20,1912,252,173,39,20,19,12707,10812,2,1893,09/30/02,2002-09-30,2002
UTAH,UTAH,UT,TENTH CIRCUIT,21444,13922,116,6,7399,590,347,108,6,128,20854,13575,8,7271,09/30/02,2002-09-30,2002
WYOMING,WYOMING,WY,TENTH CIRCUIT,2232,2090,10,0,132,39,27,9,0,3,2193,2063,1,129,09/30/02,2002-09-30,2002
ALABAMA,ALABAMA NORTHERN,ALN,ELEVENTH CIRCUIT,24514,11336,105,3,13068,194,100,81,3,8,24320,11236,24,13060,09/30/02,2002-09-30,2002
ALABAMA,ALABAMA MIDDLE,ALM,ELEVENTH CIRCUIT,9552,4900,12,0,4640,133,99,10,0,24,9419,4801,2,4616,09/30/02,2002-09-30,2002
ALABAMA,ALABAMA SOUTHERN,ALS,ELEVENTH CIRCUIT,7256,3112,29,0,4115,63,29,28,0,6,7193,3083,1,4109,09/30/02,2002-09-30,2002
FLORIDA,FLORIDA NORTHERN,FLN,ELEVENTH CIRCUIT,6394,5047,36,0,1311,74,40,34,0,0,6320,5007,2,1311,09/30/02,2002-09-30,2002
FLORIDA,FLORIDA MIDDLE,FLM,ELEVENTH CIRCUIT,51706,37314,304,2,14085,961,555,280,2,124,50745,36759,24,13961,09/30/02,2002-09-30,2002
FLORIDA,FLORIDA SOUTHERN,FLS,ELEVENTH CIRCUIT,32230,22789,323,0,9115,840,520,293,0,25,31390,22269,30,9090,09/30/02,2002-09-30,2002
GEORGIA,GEORGIA NORTHERN,GAN,ELEVENTH CIRCUIT,41945,19169,213,0,22563,914,489,186,0,239,41031,18680,27,22324,09/30/02,2002-09-30,2002
GEORGIA,GEORGIA MIDDLE,GAM,ELEVENTH CIRCUIT,17832,7625,60,7,10140,160,72,55,7,26,17672,7553,5,10114,09/30/02,2002-09-30,2002
GEORGIA,GEORGIA SOUTHERN,GAS,ELEVENTH CIRCUIT,15290,4195,31,3,11061,131,73,28,3,27,15159,4122,3,11034,09/30/02,2002-09-30,2002
DISTRICT OF COLUMBIA,DISTRICT OF COLUMBIA,DC,DC CIRCUIT,2381,1683,41,0,657,58,21,34,0,3,2323,1662,7,654,09/30/03,2003-09-30,2003
MAINE,MAINE,ME,FIRST CIRCUIT,4593,4206,12,1,374,100,72,12,1,15,4493,4134,0,359,09/30/03,2003-09-30,2003
MASSACHUSETTS,MASSACHUSETTS,MA,FIRST CIRCUIT,18174,15504,216,0,2454,400,188,210,0,2,17774,15316,6,2452,09/30/03,2003-09-30,2003
NEW HAMPSHIRE,NEW HAMPSHIRE,NH,FIRST CIRCUIT,4390,3928,15,0,447,192,156,14,0,22,4198,3772,1,425,09/30/03,2003-09-30,2003
RHODE ISLAND,RHODE ISLAND,RI,FIRST CIRCUIT,4712,4353,4,0,355,45,40,3,0,2,4667,4313,1,353,09/30/03,2003-09-30,2003
PUERTO RICO,PUERTO RICO,PR,FIRST CIRCUIT,14178,4132,140,10,9896,261,137,102,10,12,13917,3995,38,9884,09/30/03,2003-09-30,2003
CONNECTICUT,CONNECTICUT,CT,SECOND CIRCUIT,12272,10119,103,4,2045,188,91,87,4,6,12084,10028,16,2039,09/30/03,2003-09-30,2003
NEW YORK,NEW YORK NORTHERN,NYN,SECOND CIRCUIT,17391,13712,73,14,3591,340,195,70,14,61,17051,13517,3,3530,09/30/03,2003-09-30,2003
NEW YORK,NEW YORK EASTERN,NYE,SECOND CIRCUIT,25931,20010,213,1,5707,307,107,192,1,7,25624,19903,21,5700,09/30/03,2003-09-30,2003
NEW YORK,NEW YORK SOUTHERN,NYS,SECOND CIRCUIT,17298,14262,924,1,2061,1097,163,876,1,7,16201,14099,48,2054,09/30/03,2003-09-30,2003
NEW YORK,NEW YORK WESTERN,NYW,SECOND CIRCUIT,14729,11056,56,7,3610,314,196,54,7,57,14415,10860,2,3553,09/30/03,2003-09-30,2003
VERMONT,VERMONT,VT,SECOND CIRCUIT,1919,1674,6,1,238,84,60,6,1,17,1835,1614,0,221,09/30/03,2003-09-30,2003
DELAWARE,DELAWARE,DE,THIRD CIRCUIT,3978,2074,475,0,1424,551,46,475,0,25,3427,2028,0,1399,09/30/03,2003-09-30,2003
NEW JERSEY,NEW JERSEY,NJ,THIRD CIRCUIT,42921,27574,348,1,14998,699,376,303,1,19,42222,27198,45,14979,09/30/03,2003-09-30,2003
PENNSYLVANIA,PENNSYLVANIA EASTERN,PAE,THIRD CIRCUIT,25752,14302,139,4,11306,338,167,125,4,42,25414,14135,14,11264,09/30/03,2003-09-30,2003
PENNSYLVANIA,PENNSYLVANIA MIDDLE,PAM,THIRD CIRCUIT,13659,10332,58,2,3267,286,161,55,2,68,13373,10171,3,3199,09/30/03,2003-09-30,2003
PENNSYLVANIA,PENNSYLVANIA WESTERN,PAW,THIRD CIRCUIT,19082,15548,200,7,3327,548,314,171,7,56,18534,15234,29,3271,09/30/03,2003-09-30,2003
VIRGIN ISLANDS,VIRGIN ISLANDS,VI,THIRD CIRCUIT,53,37,1,0,15,4,2,1,0,1,49,35,0,14,09/30/03,2003-09-30,2003
MARYLAND,MARYLAND,MD,FOURTH CIRCUIT,35173,23102,434,5,11632,806,332,411,5,58,34367,22770,23,11574,09/30/03,2003-09-30,2003
NORTH CAROLINA,NORTH CAROLINA EASTERN,NCE,FOURTH CIRCUIT,15896,8129,71,15,7681,196,110,62,15,9,15700,8019,9,7672,09/30/03,2003-09-30,2003
NORTH CAROLINA,NORTH CAROLINA MIDDLE,NCM,FOURTH CIRCUIT,12539,5599,25,0,6915,200,145,25,0,30,12339,5454,0,6885,09/30/03,2003-09-30,2003
NORTH CAROLINA,NORTH CAROLINA WESTERN,NCW,FOURTH CIRCUIT,10376,5458,88,2,4826,126,43,79,2,0,10250,5415,9,4826,09/30/03,2003-09-30,2003
SOUTH CAROLINA,SOUTH CAROLINA,SC,FOURTH CIRCUIT,16335,7079,64,4,9187,140,88,45,4,3,16195,6991,19,9184,09/30/03,2003-09-30,2003
VIRGINIA,VIRGINIA EASTERN,VAE,FOURTH CIRCUIT,30840,21115,173,1,9551,392,226,143,1,22,30448,20889,30,9529,09/30/03,2003-09-30,2003
VIRGINIA,VIRGINIA WESTERN,VAW,FOURTH CIRCUIT,13002,10711,32,2,2257,564,458,30,2,74,12438,10253,2,2183,09/30/03,2003-09-30,2003
WEST VIRGINIA,WEST VIRGINIA NORTHERN,WVN,FOURTH CIRCUIT,4729,4403,40,0,286,127,73,40,0,14,4602,4330,0,272,09/30/03,2003-09-30,2003
WEST VIRGINIA,WEST VIRGINIA SOUTHERN,WVS,FOURTH CIRCUIT,6373,6040,26,1,306,193,149,26,1,17,6180,5891,0,289,09/30/03,2003-09-30,2003
LOUISIANA,LOUISIANA EASTERN,LAE,FIFTH CIRCUIT,10168,6905,59,2,3202,145,96,47,2,0,10023,6809,12,3202,09/30/03,2003-09-30,2003
LOUISIANA,LOUISIANA MIDDLE,LAM,FIFTH CIRCUIT,3926,2840,16,0,1070,31,18,12,0,1,3895,2822,4,1069,09/30/03,2003-09-30,2003
LOUISIANA,LOUISIANA WESTERN,LAW,FIFTH CIRCUIT,15070,8174,51,40,6805,337,144,47,40,106,14733,8030,4,6699,09/30/03,2003-09-30,2003
MISSISSIPPI,MISSISSIPPI NORTHERN,MSN,FIFTH CIRCUIT,8465,5857,38,31,2539,142,65,37,31,9,8323,5792,1,2530,09/30/03,2003-09-30,2003
MISSISSIPPI,MISSISSIPPI SOUTHERN,MSS,FIFTH CIRCUIT,14391,9590,62,2,4737,160,88,53,2,17,14231,9502,9,4720,09/30/03,2003-09-30,2003
TEXAS,TEXAS NORTHERN,TXN,FIFTH CIRCUIT,30777,15399,431,26,14921,1250,591,414,26,219,29527,14808,17,14702,09/30/03,2003-09-30,2003
TEXAS,TEXAS EASTERN,TXE,FIFTH CIRCUIT,12927,7401,77,9,5440,309,177,69,9,54,12618,7224,8,5386,09/30/03,2003-09-30,2003
TEXAS,TEXAS SOUTHERN,TXS,FIFTH CIRCUIT,25263,13050,468,4,11740,884,352,440,4,87,24379,12698,28,11653,09/30/03,2003-09-30,2003
TEXAS,TEXAS WESTERN,TXW,FIFTH CIRCUIT,20502,11597,144,10,8750,746,417,136,10,182,19756,11180,8,8568,09/30/03,2003-09-30,2003
KENTUCKY,KENTUCKY EASTERN,KYE,SIXTH CIRCUIT,13283,11369,103,2,1809,237,127,102,2,6,13046,11242,1,1803,09/30/03,2003-09-30,2003
KENTUCKY,KENTUCKY WESTERN,KYW,SIXTH CIRCUIT,16376,12952,45,9,3369,178,115,42,9,11,16198,12837,3,3358,09/30/03,2003-09-30,2003
MICHIGAN,MICHIGAN EASTERN,MIE,SIXTH CIRCUIT,45230,30537,178,3,14508,427,236,158,3,26,44803,30301,20,14482,09/30/03,2003-09-30,2003
MICHIGAN,MICHIGAN WESTERN,MIW,SIXTH CIRCUIT,17075,13154,63,3,3855,331,221,59,3,48,16744,12933,4,3807,09/30/03,2003-09-30,2003
OHIO,OHIO NORTHERN,OHN,SIXTH CIRCUIT,47289,38953,125,8,8203,882,635,119,8,120,46407,38318,6,8083,09/30/03,2003-09-30,2003
OHIO,OHIO SOUTHERN,OHS,SIXTH CIRCUIT,40544,30632,100,14,9798,562,325,97,14,126,39982,30307,3,9672,09/30/03,2003-09-30,2003
TENNESSEE,TENNESSEE EASTERN,TNE,SIXTH CIRCUIT,20466,12940,54,4,7468,234,138,51,4,41,20232,12802,3,7427,09/30/03,2003-09-30,2003
TENNESSEE,TENNESSEE MIDDLE,TNM,SIXTH CIRCUIT,16515,10212,142,0,6161,226,97,109,0,20,16289,10115,33,6141,09/30/03,2003-09-30,2003
TENNESSEE,TENNESSEE WESTERN,TNW,SIXTH CIRCUIT,28993,8969,103,0,19921,155,58,88,0,9,28838,8911,15,19912,09/30/03,2003-09-30,2003
ILLINOIS,ILLINOIS NORTHERN,ILN,SEVENTH CIRCUIT,60370,43532,315,3,16520,723,430,280,3,10,59647,43102,35,16510,09/30/03,2003-09-30,2003
ILLINOIS,ILLINOIS CENTRAL,ILC,SEVENTH CIRCUIT,16458,14106,48,28,2276,184,103,48,28,5,16274,14003,0,2271,09/30/03,2003-09-30,2003
ILLINOIS,ILLINOIS SOUTHERN,ILS,SEVENTH CIRCUIT,9974,7264,28,7,2675,146,95,18,7,26,9828,7169,10,2649,09/30/03,2003-09-30,2003
INDIANA,INDIANA NORTHERN,INN,SEVENTH CIRCUIT,21232,17719,56,4,3453,211,130,52,4,25,21021,17589,4,3428,09/30/03,2003-09-30,2003
INDIANA,INDIANA SOUTHERN,INS,SEVENTH CIRCUIT,34373,26772,119,7,7475,438,285,113,7,33,33935,26487,6,7442,09/30/03,2003-09-30,2003
WISCONSIN,WISCONSIN EASTERN,WIE,SEVENTH CIRCUIT,19073,15475,33,6,3559,212,149,32,6,25,18861,15326,1,3534,09/30/03,2003-09-30,2003
WISCONSIN,WISCONSIN WESTERN,WIW,SEVENTH CIRCUIT,9342,8158,43,13,1128,539,443,34,13,49,8803,7715,9,1079,09/30/03,2003-09-30,2003
ARKANSAS,ARKANSAS EASTERN,ARE,EIGHTH CIRCUIT,15624,8438,34,6,7146,237,101,27,6,103,15387,8337,7,7043,09/30/03,2003-09-30,2003
ARKANSAS,ARKANSAS WESTERN,ARW,EIGHTH CIRCUIT,8722,6025,18,2,2676,186,99,17,2,67,8536,5926,1,2609,09/30/03,2003-09-30,2003
IOWA,IOWA NORTHERN,IAN,EIGHTH CIRCUIT,4997,4790,9,7,191,202,176,9,7,10,4795,4614,0,181,09/30/03,2003-09-30,2003
IOWA,IOWA SOUTHERN,IAS,EIGHTH CIRCUIT,7580,7114,14,5,447,123,97,14,5,7,7457,7017,0,440,09/30/03,2003-09-30,2003
MINNESOTA,MINNESOTA,MN,EIGHTH CIRCUIT,20483,17127,47,16,3293,1356,1102,46,16,192,19127,16025,1,3101,09/30/03,2003-09-30,2003
MISSOURI,MISSOURI EASTERN,MOE,EIGHTH CIRCUIT,20293,13530,80,7,6676,180,85,75,7,13,20113,13445,5,6663,09/30/03,2003-09-30,2003
MISSOURI,MISSOURI WESTERN,MOW,EIGHTH CIRCUIT,17707,14181,53,7,3465,224,136,50,7,30,17483,14045,3,3435,09/30/03,2003-09-30,2003
NEBRASKA,NEBRASKA,NE,EIGHTH CIRCUIT,8555,6613,41,54,1846,242,124,36,54,27,8313,6489,5,1819,09/30/03,2003-09-30,2003
NORTH DAKOTA,NORTH DAKOTA,ND,EIGHTH CIRCUIT,2276,2161,7,19,89,114,84,7,19,4,2162,2077,0,85,09/30/03,2003-09-30,2003
SOUTH DAKOTA,SOUTH DAKOTA,SD,EIGHTH CIRCUIT,2867,2673,13,6,175,123,90,12,6,15,2744,2583,1,160,09/30/03,2003-09-30,2003
ALASKA,ALASKA,AK,NINTH CIRCUIT,1541,1394,16,0,131,127,93,15,0,19,1414,1301,1,112,09/30/03,2003-09-30,2003
ARIZONA,ARIZONA,AZ,NINTH CIRCUIT,31994,25491,289,5,6209,774,417,252,5,100,31220,25074,37,6109,09/30/03,2003-09-30,2003
CALIFORNIA,CALIFORNIA NORTHERN,CAN,NINTH CIRCUIT,22760,16193,234,1,6332,1109,619,197,1,292,21651,15574,37,6040,09/30/03,2003-09-30,2003
CALIFORNIA,CALIFORNIA EASTERN,CAE,NINTH CIRCUIT,31791,26848,87,43,4812,1133,725,80,43,284,30658,26123,7,4528,09/30/03,2003-09-30,2003
CALIFORNIA,CALIFORNIA CENTRAL,CAC,NINTH CIRCUIT,79250,67690,383,5,11159,2119,1594,349,5,158,77131,66096,34,11001,09/30/03,2003-09-30,2003
CALIFORNIA,CALIFORNIA SOUTHERN,CAS,NINTH CIRCUIT,12329,10043,119,1,2166,312,174,113,1,24,12017,9869,6,2142,09/30/03,2003-09-30,2003
HAWAII,HAWAII,HI,NINTH CIRCUIT,3908,3398,37,0,470,65,30,33,0,1,3843,3368,4,469,09/30/03,2003-09-30,2003
IDAHO,IDAHO,ID,NINTH CIRCUIT,9630,8319,51,21,1239,246,141,45,21,39,9384,8178,6,1200,09/30/03,2003-09-30,2003
MONTANA,MONTANA,MT,NINTH CIRCUIT,4345,3842,21,10,472,106,59,20,10,17,4239,3783,1,455,09/30/03,2003-09-30,2003
NEVADA,NEVADA,NV,NINTH CIRCUIT,20689,15485,140,0,5062,328,179,125,0,23,20361,15306,15,5039,09/30/03,2003-09-30,2003
OREGON,OREGON,OR,NINTH CIRCUIT,25723,21890,40,13,3780,1714,734,37,13,930,24009,21156,3,2850,09/30/03,2003-09-30,2003
WASHINGTON,WASHINGTON EASTERN,WAE,NINTH CIRCUIT,10602,8089,60,23,2429,251,149,47,23,31,10351,7940,13,2398,09/30/03,2003-09-30,2003
WASHINGTON,WASHINGTON WESTERN,WAW,NINTH CIRCUIT,30305,24598,149,2,5556,464,292,120,2,50,29841,24306,29,5506,09/30/03,2003-09-30,2003
GUAM,GUAM,GUAM,NINTH CIRCUIT,343,294,2,0,47,11,10,1,0,0,332,284,1,47,09/30/03,2003-09-30,2003
NORTHERN MARIANA ISLANDS,NORTHERN MARIANAS,NMI,NINTH CIRCUIT,20,16,0,0,4,1,1,0,0,0,19,15,0,4,09/30/03,2003-09-30,2003
COLORADO,COLORADO,CO,TENTH CIRCUIT,25243,22497,90,12,2644,525,399,87,12,27,24718,22098,3,2617,09/30/03,2003-09-30,2003
KANSAS,KANSAS,KS,TENTH CIRCUIT,16177,12909,46,22,3200,294,180,44,22,48,15883,12729,2,3152,09/30/03,2003-09-30,2003
NEW MEXICO,NEW MEXICO,NM,TENTH CIRCUIT,9967,9019,39,5,904,806,663,38,5,100,9161,8356,1,804,09/30/03,2003-09-30,2003
OKLAHOMA,OKLAHOMA NORTHERN,OKN,TENTH CIRCUIT,7545,6898,13,3,631,265,227,12,3,23,7280,6671,1,608,09/30/03,2003-09-30,2003
OKLAHOMA,OKLAHOMA EASTERN,OKE,TENTH CIRCUIT,5123,4713,13,8,389,73,47,12,8,6,5050,4666,1,383,09/30/03,2003-09-30,2003
OKLAHOMA,OKLAHOMA WESTERN,OKW,TENTH CIRCUIT,14069,12323,44,31,1671,288,204,40,31,13,13781,12119,4,1658,09/30/03,2003-09-30,2003
UTAH,UTAH,UT,TENTH CIRCUIT,22444,15321,63,1,7059,496,338,57,1,100,21948,14983,6,6959,09/30/03,2003-09-30,2003
WYOMING,WYOMING,WY,TENTH CIRCUIT,2513,2307,16,1,189,49,23,15,1,10,2464,2284,1,179,09/30/03,2003-09-30,2003
ALABAMA,ALABAMA NORTHERN,ALN,ELEVENTH CIRCUIT,25835,12763,123,2,12947,169,84,79,2,4,25666,12679,44,12943,09/30/03,2003-09-30,2003
ALABAMA,ALABAMA MIDDLE,ALM,ELEVENTH CIRCUIT,8977,4465,21,1,4490,83,54,18,1,10,8894,4411,3,4480,09/30/03,2003-09-30,2003
ALABAMA,ALABAMA SOUTHERN,ALS,ELEVENTH CIRCUIT,7548,3155,34,0,4359,60,22,26,0,12,7488,3133,8,4347,09/30/03,2003-09-30,2003
FLORIDA,FLORIDA NORTHERN,FLN,ELEVENTH CIRCUIT,7049,5649,28,2,1370,55,32,20,2,1,6994,5617,8,1369,09/30/03,2003-09-30,2003
FLORIDA,FLORIDA MIDDLE,FLM,ELEVENTH CIRCUIT,55617,39873,242,7,15494,709,427,199,7,75,54908,39446,43,15419,09/30/03,2003-09-30,2003
FLORIDA,FLORIDA SOUTHERN,FLS,ELEVENTH CIRCUIT,32812,22996,245,1,9564,862,590,222,1,44,31950,22406,23,9520,09/30/03,2003-09-30,2003
GEORGIA,GEORGIA NORTHERN,GAN,ELEVENTH CIRCUIT,45729,23498,210,3,22017,1095,606,192,3,293,44634,22892,18,21724,09/30/03,2003-09-30,2003
GEORGIA,GEORGIA MIDDLE,GAM,ELEVENTH CIRCUIT,18219,8467,52,24,9676,198,80,51,24,43,18021,8387,1,9633,09/30/03,2003-09-30,2003
GEORGIA,GEORGIA SOUTHERN,GAS,ELEVENTH CIRCUIT,16037,4498,43,4,11492,164,70,38,4,52,15873,4428,5,11440,09/30/03,2003-09-30,2003
DISTRICT OF COLUMBIA,DISTRICT OF COLUMBIA,DC,DC CIRCUIT,1987,1455,23,0,509,45,23,20,0,2,1942,1432,3,507,09/30/04,2004-09-30,2004
MAINE,MAINE,ME,FIRST CIRCUIT,4637,4154,43,1,439,144,83,41,1,19,4493,4071,2,420,09/30/04,2004-09-30,2004
MASSACHUSETTS,MASSACHUSETTS,MA,FIRST CIRCUIT,18054,15421,174,0,2459,320,162,156,0,2,17734,15259,18,2457,09/30/04,2004-09-30,2004
NEW HAMPSHIRE,NEW HAMPSHIRE,NH,FIRST CIRCUIT,4573,4108,16,0,449,161,137,13,0,11,4412,3971,3,438,09/30/04,2004-09-30,2004
RHODE ISLAND,RHODE ISLAND,RI,FIRST CIRCUIT,4222,3906,18,0,298,78,58,16,0,4,4144,3848,2,294,09/30/04,2004-09-30,2004
PUERTO RICO,PUERTO RICO,PR,FIRST CIRCUIT,13695,4374,127,6,9188,263,143,85,6,29,13432,4231,42,9159,09/30/04,2004-09-30,2004
CONNECTICUT,CONNECTICUT,CT,SECOND CIRCUIT,11644,9557,96,0,1991,145,69,75,0,1,11499,9488,21,1990,09/30/04,2004-09-30,2004
NEW YORK,NEW YORK NORTHERN,NYN,SECOND CIRCUIT,17474,13410,48,8,4008,307,186,46,8,67,17167,13224,2,3941,09/30/04,2004-09-30,2004
NEW YORK,NEW YORK EASTERN,NYE,SECOND CIRCUIT,27029,21771,163,0,5095,291,139,149,0,3,26738,21632,14,5092,09/30/04,2004-09-30,2004
NEW YORK,NEW YORK SOUTHERN,NYS,SECOND CIRCUIT,20869,15661,2955,1,2177,3198,167,2941,1,14,17671,15494,14,2163,09/30/04,2004-09-30,2004
NEW YORK,NEW YORK WESTERN,NYW,SECOND CIRCUIT,15482,11776,57,3,3645,306,187,54,3,61,15176,11589,3,3584,09/30/04,2004-09-30,2004
VERMONT,VERMONT,VT,SECOND CIRCUIT,1773,1516,13,0,244,88,60,13,0,15,1685,1456,0,229,09/30/04,2004-09-30,2004
DELAWARE,DELAWARE,DE,THIRD CIRCUIT,3740,2065,290,0,1385,351,49,287,0,15,3389,2016,3,1370,09/30/04,2004-09-30,2004
NEW JERSEY,NEW JERSEY,NJ,THIRD CIRCUIT,41262,27224,305,3,13730,704,391,262,3,48,40558,26833,43,13682,09/30/04,2004-09-30,2004
PENNSYLVANIA,PENNSYLVANIA EASTERN,PAE,THIRD CIRCUIT,24658,13835,149,1,10673,396,208,126,1,61,24262,13627,23,10612,09/30/04,2004-09-30,2004
PENNSYLVANIA,PENNSYLVANIA MIDDLE,PAM,THIRD CIRCUIT,14246,10776,44,0,3426,262,158,38,0,66,13984,10618,6,3360,09/30/04,2004-09-30,2004
PENNSYLVANIA,PENNSYLVANIA WESTERN,PAW,THIRD CIRCUIT,20662,16292,197,3,4170,465,260,155,3,47,20197,16032,42,4123,09/30/04,2004-09-30,2004
VIRGIN ISLANDS,VIRGIN ISLANDS,VI,THIRD CIRCUIT,38,17,2,0,19,4,2,2,0,0,34,15,0,19,09/30/04,2004-09-30,2004
MARYLAND,MARYLAND,MD,FOURTH CIRCUIT,30438,20882,141,0,9415,431,256,132,0,43,30007,20626,9,9372,09/30/04,2004-09-30,2004
NORTH CAROLINA,NORTH CAROLINA EASTERN,NCE,FOURTH CIRCUIT,15054,7499,68,10,7477,189,114,56,10,9,14865,7385,12,7468,09/30/04,2004-09-30,2004
NORTH CAROLINA,NORTH CAROLINA MIDDLE,NCM,FOURTH CIRCUIT,12106,5650,38,0,6418,183,97,36,0,50,11923,5553,2,6368,09/30/04,2004-09-30,2004
NORTH CAROLINA,NORTH CAROLINA WESTERN,NCW,FOURTH CIRCUIT,10179,5688,79,1,4411,105,38,66,1,0,10074,5650,13,4411,09/30/04,2004-09-30,2004
SOUTH CAROLINA,SOUTH CAROLINA,SC,FOURTH CIRCUIT,15632,6722,54,0,8855,183,122,30,0,30,15449,6600,24,8825,09/30/04,2004-09-30,2004
VIRGINIA,VIRGINIA EASTERN,VAE,FOURTH CIRCUIT,28921,20091,110,1,8718,335,233,84,1,16,28586,19858,26,8702,09/30/04,2004-09-30,2004
VIRGINIA,VIRGINIA WESTERN,VAW,FOURTH CIRCUIT,12408,10014,39,1,2354,521,412,38,1,70,11887,9602,1,2284,09/30/04,2004-09-30,2004
WEST VIRGINIA,WEST VIRGINIA NORTHERN,WVN,FOURTH CIRCUIT,4584,4331,17,1,235,135,116,12,1,6,4449,4215,5,229,09/30/04,2004-09-30,2004
WEST VIRGINIA,WEST VIRGINIA SOUTHERN,WVS,FOURTH CIRCUIT,6927,6552,38,0,337,127,88,33,0,6,6800,6464,5,331,09/30/04,2004-09-30,2004
LOUISIANA,LOUISIANA EASTERN,LAE,FIFTH CIRCUIT,9982,6741,48,0,3193,127,89,37,0,1,9855,6652,11,3192,09/30/04,2004-09-30,2004
LOUISIANA,LOUISIANA MIDDLE,LAM,FIFTH CIRCUIT,4235,2939,23,1,1272,37,15,19,1,2,4198,2924,4,1270,09/30/04,2004-09-30,2004
LOUISIANA,LOUISIANA WESTERN,LAW,FIFTH CIRCUIT,15768,8753,38,9,6967,431,192,35,9,194,15337,8561,3,6773,09/30/04,2004-09-30,2004
MISSISSIPPI,MISSISSIPPI NORTHERN,MSN,FIFTH CIRCUIT,8382,5751,25,2,2604,70,40,25,2,3,8312,5711,0,2601,09/30/04,2004-09-30,2004
MISSISSIPPI,MISSISSIPPI SOUTHERN,MSS,FIFTH CIRCUIT,12969,8577,38,0,4354,113,64,33,0,16,12856,8513,5,4338,09/30/04,2004-09-30,2004
TEXAS,TEXAS NORTHERN,TXN,FIFTH CIRCUIT,32560,15458,358,8,16733,1267,660,341,8,255,31293,14798,17,16478,09/30/04,2004-09-30,2004
TEXAS,TEXAS EASTERN,TXE,FIFTH CIRCUIT,13204,7719,79,4,5401,367,196,76,4,90,12837,7523,3,5311,09/30/04,2004-09-30,2004
TEXAS,TEXAS SOUTHERN,TXS,FIFTH CIRCUIT,26637,13728,242,0,12667,701,427,208,0,66,25936,13301,34,12601,09/30/04,2004-09-30,2004
TEXAS,TEXAS WESTERN,TXW,FIFTH CIRCUIT,21302,12173,217,2,8910,804,433,198,2,171,20498,11740,19,8739,09/30/04,2004-09-30,2004
KENTUCKY,KENTUCKY EASTERN,KYE,SIXTH CIRCUIT,13089,10955,27,4,2103,146,102,26,4,14,12943,10853,1,2089,09/30/04,2004-09-30,2004
KENTUCKY,KENTUCKY WESTERN,KYW,SIXTH CIRCUIT,15466,12008,97,2,3359,176,73,91,2,10,15290,11935,6,3349,09/30/04,2004-09-30,2004
MICHIGAN,MICHIGAN EASTERN,MIE,SIXTH CIRCUIT,46935,31923,168,2,14839,414,227,156,2,26,46521,31696,12,14813,09/30/04,2004-09-30,2004
MICHIGAN,MICHIGAN WESTERN,MIW,SIXTH CIRCUIT,16947,13473,46,2,3425,232,163,42,2,24,16715,13310,4,3401,09/30/04,2004-09-30,2004
OHIO,OHIO NORTHERN,OHN,SIXTH CIRCUIT,48436,39986,83,2,8365,849,664,78,2,105,47587,39322,5,8260,09/30/04,2004-09-30,2004
OHIO,OHIO SOUTHERN,OHS,SIXTH CIRCUIT,42120,31446,109,4,10561,544,315,102,4,123,41576,31131,7,10438,09/30/04,2004-09-30,2004
TENNESSEE,TENNESSEE EASTERN,TNE,SIXTH CIRCUIT,19926,12663,70,3,7190,263,168,60,3,32,19663,12495,10,7158,09/30/04,2004-09-30,2004
TENNESSEE,TENNESSEE MIDDLE,TNM,SIXTH CIRCUIT,16038,9427,109,2,6500,156,79,65,2,10,15882,9348,44,6490,09/30/04,2004-09-30,2004
TENNESSEE,TENNESSEE WESTERN,TNW,SIXTH CIRCUIT,26497,8340,68,0,18089,132,51,62,0,19,26365,8289,6,18070,09/30/04,2004-09-30,2004
ILLINOIS,ILLINOIS NORTHERN,ILN,SEVENTH CIRCUIT,55100,40295,196,0,14608,599,427,169,0,2,54501,39868,27,14606,09/30/04,2004-09-30,2004
ILLINOIS,ILLINOIS CENTRAL,ILC,SEVENTH CIRCUIT,15763,13498,19,5,2241,158,118,16,5,19,15605,13380,3,2222,09/30/04,2004-09-30,2004
ILLINOIS,ILLINOIS SOUTHERN,ILS,SEVENTH CIRCUIT,9802,6914,21,10,2855,131,81,16,10,22,9671,6833,5,2833,09/30/04,2004-09-30,2004
INDIANA,INDIANA NORTHERN,INN,SEVENTH CIRCUIT,21130,17596,37,3,3494,151,111,33,3,4,20979,17485,4,3490,09/30/04,2004-09-30,2004
INDIANA,INDIANA SOUTHERN,INS,SEVENTH CIRCUIT,34551,26661,79,1,7810,353,253,70,1,29,34198,26408,9,7781,09/30/04,2004-09-30,2004
WISCONSIN,WISCONSIN EASTERN,WIE,SEVENTH CIRCUIT,18222,14786,21,0,3415,194,155,21,0,18,18028,14631,0,3397,09/30/04,2004-09-30,2004
WISCONSIN,WISCONSIN WESTERN,WIW,SEVENTH CIRCUIT,9222,8061,46,3,1112,530,456,34,3,37,8692,7605,12,1075,09/30/04,2004-09-30,2004
ARKANSAS,ARKANSAS EASTERN,ARE,EIGHTH CIRCUIT,15665,8444,35,6,7180,251,124,34,6,87,15414,8320,1,7093,09/30/04,2004-09-30,2004
ARKANSAS,ARKANSAS WESTERN,ARW,EIGHTH CIRCUIT,8731,5926,19,0,2786,153,89,18,0,46,8578,5837,1,2740,09/30/04,2004-09-30,2004
IOWA,IOWA NORTHERN,IAN,EIGHTH CIRCUIT,5046,4854,15,1,176,236,213,14,1,8,4810,4641,1,168,09/30/04,2004-09-30,2004
IOWA,IOWA SOUTHERN,IAS,EIGHTH CIRCUIT,7942,7507,15,2,418,125,103,15,2,5,7817,7404,0,413,09/30/04,2004-09-30,2004
MINNESOTA,MINNESOTA,MN,EIGHTH CIRCUIT,18451,14639,111,10,3691,1375,1031,111,10,223,17076,13608,0,3468,09/30/04,2004-09-30,2004
MISSOURI,MISSOURI EASTERN,MOE,EIGHTH CIRCUIT,19850,13501,39,4,6305,165,113,34,4,13,19685,13388,5,6292,09/30/04,2004-09-30,2004
MISSOURI,MISSOURI WESTERN,MOW,EIGHTH CIRCUIT,17796,14500,38,5,3253,183,125,34,5,19,17613,14375,4,3234,09/30/04,2004-09-30,2004
NEBRASKA,NEBRASKA,NE,EIGHTH CIRCUIT,8906,6954,39,7,1906,191,120,32,7,32,8715,6834,7,1874,09/30/04,2004-09-30,2004
NORTH DAKOTA,NORTH DAKOTA,ND,EIGHTH CIRCUIT,2294,2175,5,5,109,93,73,5,5,10,2201,2102,0,99,09/30/04,2004-09-30,2004
SOUTH DAKOTA,SOUTH DAKOTA,SD,EIGHTH CIRCUIT,2862,2638,14,4,206,97,70,11,4,12,2765,2568,3,194,09/30/04,2004-09-30,2004
ALASKA,ALASKA,AK,NINTH CIRCUIT,1468,1316,9,0,143,73,56,9,0,8,1395,1260,0,135,09/30/04,2004-09-30,2004
ARIZONA,ARIZONA,AZ,NINTH CIRCUIT,31686,25955,213,0,5517,481,252,169,0,60,31205,25703,44,5457,09/30/04,2004-09-30,2004
CALIFORNIA,CALIFORNIA NORTHERN,CAN,NINTH CIRCUIT,22332,16296,180,1,5855,1013,556,142,1,314,21319,15740,38,5541,09/30/04,2004-09-30,2004
CALIFORNIA,CALIFORNIA EASTERN,CAE,NINTH CIRCUIT,29581,24918,103,10,4548,1008,657,99,10,240,28573,24261,4,4308,09/30/04,2004-09-30,2004
CALIFORNIA,CALIFORNIA CENTRAL,CAC,NINTH CIRCUIT,64585,57795,329,4,6455,1758,1343,294,4,115,62827,56452,35,6340,09/30/04,2004-09-30,2004
CALIFORNIA,CALIFORNIA SOUTHERN,CAS,NINTH CIRCUIT,11366,9584,46,0,1736,180,129,34,0,17,11186,9455,12,1719,09/30/04,2004-09-30,2004
HAWAII,HAWAII,HI,NINTH CIRCUIT,3237,2837,23,0,376,51,30,16,0,5,3186,2807,7,371,09/30/04,2004-09-30,2004
IDAHO,IDAHO,ID,NINTH CIRCUIT,9445,8210,25,8,1202,162,111,18,8,25,9283,8099,7,1177,09/30/04,2004-09-30,2004
MONTANA,MONTANA,MT,NINTH CIRCUIT,4376,3897,15,8,456,105,74,14,8,9,4271,3823,1,447,09/30/04,2004-09-30,2004
NEVADA,NEVADA,NV,NINTH CIRCUIT,18397,14281,120,0,3996,276,140,110,0,26,18121,14141,10,3970,09/30/04,2004-09-30,2004
OREGON,OREGON,OR,NINTH CIRCUIT,24589,20629,42,3,3915,948,621,42,3,282,23641,20008,0,3633,09/30/04,2004-09-30,2004
WASHINGTON,WASHINGTON EASTERN,WAE,NINTH CIRCUIT,9693,7618,52,4,2019,219,149,44,4,22,9474,7469,8,1997,09/30/04,2004-09-30,2004
WASHINGTON,WASHINGTON WESTERN,WAW,NINTH CIRCUIT,29522,23617,122,0,5783,445,276,100,0,69,29077,23341,22,5714,09/30/04,2004-09-30,2004
GUAM,GUAM,GUAM,NINTH CIRCUIT,371,334,1,0,36,7,6,1,0,0,364,328,0,36,09/30/04,2004-09-30,2004
NORTHERN MARIANA ISLANDS,NORTHERN MARIANAS,NMI,NINTH CIRCUIT,17,16,0,0,1,3,3,0,0,0,14,13,0,1,09/30/04,2004-09-30,2004
COLORADO,COLORADO,CO,TENTH CIRCUIT,27879,24925,89,2,2862,777,639,80,2,55,27102,24286,9,2807,09/30/04,2004-09-30,2004
KANSAS,KANSAS,KS,TENTH CIRCUIT,16401,13331,48,11,3011,263,186,42,11,24,16138,13145,6,2987,09/30/04,2004-09-30,2004
NEW MEXICO,NEW MEXICO,NM,TENTH CIRCUIT,9360,8481,40,2,837,685,573,33,2,77,8675,7908,7,760,09/30/04,2004-09-30,2004
OKLAHOMA,OKLAHOMA NORTHERN,OKN,TENTH CIRCUIT,7694,6945,18,2,729,243,196,17,2,28,7451,6749,1,701,09/30/04,2004-09-30,2004
OKLAHOMA,OKLAHOMA EASTERN,OKE,TENTH CIRCUIT,5102,4680,16,1,405,83,50,16,1,16,5019,4630,0,389,09/30/04,2004-09-30,2004
OKLAHOMA,OKLAHOMA WESTERN,OKW,TENTH CIRCUIT,14440,12485,30,13,1911,274,209,30,13,21,14166,12276,0,1890,09/30/04,2004-09-30,2004
UTAH,UTAH,UT,TENTH CIRCUIT,21312,14747,83,0,6482,481,305,83,0,93,20831,14442,0,6389,09/30/04,2004-09-30,2004
WYOMING,WYOMING,WY,TENTH CIRCUIT,2438,2228,18,0,192,55,34,12,0,9,2383,2194,6,183,09/30/04,2004-09-30,2004
ALABAMA,ALABAMA NORTHERN,ALN,ELEVENTH CIRCUIT,25807,13388,103,0,12316,177,77,87,0,13,25630,13311,16,12303,09/30/04,2004-09-30,2004
ALABAMA,ALABAMA MIDDLE,ALM,ELEVENTH CIRCUIT,8545,4060,11,1,4473,79,58,9,1,11,8466,4002,2,4462,09/30/04,2004-09-30,2004
ALABAMA,ALABAMA SOUTHERN,ALS,ELEVENTH CIRCUIT,7555,2958,26,1,4570,53,23,20,1,9,7502,2935,6,4561,09/30/04,2004-09-30,2004
FLORIDA,FLORIDA NORTHERN,FLN,ELEVENTH CIRCUIT,6835,5454,40,0,1341,94,53,35,0,6,6741,5401,5,1335,09/30/04,2004-09-30,2004
FLORIDA,FLORIDA MIDDLE,FLM,ELEVENTH CIRCUIT,53535,38842,209,1,14482,509,299,176,1,33,53026,38543,33,14449,09/30/04,2004-09-30,2004
FLORIDA,FLORIDA SOUTHERN,FLS,ELEVENTH CIRCUIT,28000,21515,166,0,6316,599,412,148,0,36,27401,21103,18,6280,09/30/04,2004-09-30,2004
GEORGIA,GEORGIA NORTHERN,GAN,ELEVENTH CIRCUIT,45610,24374,239,0,20996,1898,1039,218,0,640,43712,23335,21,20356,09/30/04,2004-09-30,2004
GEORGIA,GEORGIA MIDDLE,GAM,ELEVENTH CIRCUIT,17835,8149,33,9,9644,135,68,31,9,27,17700,8081,2,9617,09/30/04,2004-09-30,2004
GEORGIA,GEORGIA SOUTHERN,GAS,ELEVENTH CIRCUIT,15854,4244,21,4,11585,132,41,20,4,67,15722,4203,1,11518,09/30/04,2004-09-30,2004
DISTRICT OF COLUMBIA,DISTRICT OF COLUMBIA,DC,DC CIRCUIT,1951,1607,25,0,318,43,21,20,0,1,1908,1586,5,317,09/30/05,2005-09-30,2005
MAINE,MAINE,ME,FIRST CIRCUIT,5459,5033,20,2,402,119,81,20,2,16,5340,4952,0,386,09/30/05,2005-09-30,2005
MASSACHUSETTS,MASSACHUSETTS,MA,FIRST CIRCUIT,21952,19236,140,0,2576,373,232,130,0,11,21579,19004,10,2565,09/30/05,2005-09-30,2005
NEW HAMPSHIRE,NEW HAMPSHIRE,NH,FIRST CIRCUIT,5341,4840,33,1,467,511,421,30,1,59,4830,4419,3,408,09/30/05,2005-09-30,2005
RHODE ISLAND,RHODE ISLAND,RI,FIRST CIRCUIT,4855,4581,16,1,257,89,70,15,1,3,4766,4511,1,254,09/30/05,2005-09-30,2005
PUERTO RICO,PUERTO RICO,PR,FIRST CIRCUIT,12844,3799,119,10,8916,395,140,93,10,152,12449,3659,26,8764,09/30/05,2005-09-30,2005
CONNECTICUT,CONNECTICUT,CT,SECOND CIRCUIT,12777,10985,41,0,1744,104,67,28,0,2,12673,10918,13,1742,09/30/05,2005-09-30,2005
NEW YORK,NEW YORK NORTHERN,NYN,SECOND CIRCUIT,20525,15838,42,7,4637,261,152,40,7,61,20264,15686,2,4576,09/30/05,2005-09-30,2005
NEW YORK,NEW YORK EASTERN,NYE,SECOND CIRCUIT,30481,26835,162,0,3484,290,140,143,0,7,30191,26695,19,3477,09/30/05,2005-09-30,2005
NEW YORK,NEW YORK SOUTHERN,NYS,SECOND CIRCUIT,21705,19394,456,3,1772,701,170,441,3,7,21004,19224,15,1765,09/30/05,2005-09-30,2005
NEW YORK,NEW YORK WESTERN,NYW,SECOND CIRCUIT,17937,13973,58,11,3895,342,227,52,11,52,17595,13746,6,3843,09/30/05,2005-09-30,2005
VERMONT,VERMONT,VT,SECOND CIRCUIT,1948,1690,4,2,252,63,45,2,2,14,1885,1645,2,238,09/30/05,2005-09-30,2005
DELAWARE,DELAWARE,DE,THIRD CIRCUIT,3798,2343,172,0,1281,226,52,170,0,2,3572,2291,2,1279,09/30/05,2005-09-30,2005
NEW JERSEY,NEW JERSEY,NJ,THIRD CIRCUIT,42829,30879,285,0,11665,679,378,235,0,66,42150,30501,50,11599,09/30/05,2005-09-30,2005
PENNSYLVANIA,PENNSYLVANIA EASTERN,PAE,THIRD CIRCUIT,25570,16323,132,1,9114,379,220,113,1,45,25191,16103,19,9069,09/30/05,2005-09-30,2005
PENNSYLVANIA,PENNSYLVANIA MIDDLE,PAM,THIRD CIRCUIT,16337,12600,68,1,3668,359,213,64,1,81,15978,12387,4,3587,09/30/05,2005-09-30,2005
PENNSYLVANIA,PENNSYLVANIA WESTERN,PAW,THIRD CIRCUIT,25180,20705,139,8,4328,476,305,108,8,55,24704,20400,31,4273,09/30/05,2005-09-30,2005
VIRGIN ISLANDS,VIRGIN ISLANDS,VI,THIRD CIRCUIT,47,26,5,0,16,6,1,5,0,0,41,25,0,16,09/30/05,2005-09-30,2005
MARYLAND,MARYLAND,MD,FOURTH CIRCUIT,30448,22585,109,0,7754,616,422,91,0,103,29832,22163,18,7651,09/30/05,2005-09-30,2005
NORTH CAROLINA,NORTH CAROLINA EASTERN,NCE,FOURTH CIRCUIT,15905,8719,43,4,7137,183,111,36,4,30,15722,8608,7,7107,09/30/05,2005-09-30,2005
NORTH CAROLINA,NORTH CAROLINA MIDDLE,NCM,FOURTH CIRCUIT,12527,6596,20,0,5911,308,189,19,0,100,12219,6407,1,5811,09/30/05,2005-09-30,2005
NORTH CAROLINA,NORTH CAROLINA WESTERN,NCW,FOURTH CIRCUIT,11485,7223,36,0,4225,84,48,34,0,1,11401,7175,2,4224,09/30/05,2005-09-30,2005
SOUTH CAROLINA,SOUTH CAROLINA,SC,FOURTH CIRCUIT,15209,6811,53,3,8342,158,100,33,3,22,15051,6711,20,8320,09/30/05,2005-09-30,2005
VIRGINIA,VIRGINIA EASTERN,VAE,FOURTH CIRCUIT,28030,19441,86,1,8502,280,186,74,1,19,27750,19255,12,8483,09/30/05,2005-09-30,2005
VIRGINIA,VIRGINIA WESTERN,VAW,FOURTH CIRCUIT,12557,9906,21,4,2625,144,116,14,4,9,12413,9790,7,2616,09/30/05,2005-09-30,2005
WEST VIRGINIA,WEST VIRGINIA NORTHERN,WVN,FOURTH CIRCUIT,5837,5528,20,0,289,167,134,19,0,14,5670,5394,1,275,09/30/05,2005-09-30,2005
WEST VIRGINIA,WEST VIRGINIA SOUTHERN,WVS,FOURTH CIRCUIT,8645,8315,26,2,302,63,45,14,2,2,8582,8270,12,300,09/30/05,2005-09-30,2005
LOUISIANA,LOUISIANA EASTERN,LAE,FIFTH CIRCUIT,10376,7405,47,1,2923,131,88,41,1,1,10245,7317,6,2922,09/30/05,2005-09-30,2005
LOUISIANA,LOUISIANA MIDDLE,LAM,FIFTH CIRCUIT,4542,3361,24,1,1156,45,23,19,1,2,4497,3338,5,1154,09/30/05,2005-09-30,2005
LOUISIANA,LOUISIANA WESTERN,LAW,FIFTH CIRCUIT,17216,9297,48,13,7857,524,251,45,13,214,16692,9046,3,7643,09/30/05,2005-09-30,2005
MISSISSIPPI,MISSISSIPPI NORTHERN,MSN,FIFTH CIRCUIT,9064,6203,30,8,2823,78,40,30,8,0,8986,6163,0,2823,09/30/05,2005-09-30,2005
MISSISSIPPI,MISSISSIPPI SOUTHERN,MSS,FIFTH CIRCUIT,12778,8532,31,2,4213,103,67,26,2,8,12675,8465,5,4205,09/30/05,2005-09-30,2005
TEXAS,TEXAS NORTHERN,TXN,FIFTH CIRCUIT,35944,19954,230,12,15744,1263,790,218,12,239,34681,19164,12,15505,09/30/05,2005-09-30,2005
TEXAS,TEXAS EASTERN,TXE,FIFTH CIRCUIT,14869,9747,66,2,5054,390,265,58,2,65,14479,9482,8,4989,09/30/05,2005-09-30,2005
TEXAS,TEXAS SOUTHERN,TXS,FIFTH CIRCUIT,30879,18382,250,2,12245,821,535,217,2,67,30058,17847,33,12178,09/30/05,2005-09-30,2005
TEXAS,TEXAS WESTERN,TXW,FIFTH CIRCUIT,23123,15298,87,3,7734,731,487,78,3,162,22392,14811,9,7572,09/30/05,2005-09-30,2005
KENTUCKY,KENTUCKY EASTERN,KYE,SIXTH CIRCUIT,15311,13029,17,8,2257,163,125,17,8,13,15148,12904,0,2244,09/30/05,2005-09-30,2005
KENTUCKY,KENTUCKY WESTERN,KYW,SIXTH CIRCUIT,17792,14056,57,5,3674,174,106,52,5,11,17618,13950,5,3663,09/30/05,2005-09-30,2005
MICHIGAN,MICHIGAN EASTERN,MIE,SIXTH CIRCUIT,55845,42017,227,5,13596,519,289,209,5,16,55326,41728,18,13580,09/30/05,2005-09-30,2005
MICHIGAN,MICHIGAN WESTERN,MIW,SIXTH CIRCUIT,19915,16956,40,9,2910,328,247,38,9,34,19587,16709,2,2876,09/30/05,2005-09-30,2005
OHIO,OHIO NORTHERN,OHN,SIXTH CIRCUIT,59058,49772,83,5,9198,1131,900,75,5,151,57927,48872,8,9047,09/30/05,2005-09-30,2005
OHIO,OHIO SOUTHERN,OHS,SIXTH CIRCUIT,50355,38882,107,0,11366,631,402,104,0,125,49724,38480,3,11241,09/30/05,2005-09-30,2005
TENNESSEE,TENNESSEE EASTERN,TNE,SIXTH CIRCUIT,20708,14168,50,2,6488,162,108,41,2,11,20546,14060,9,6477,09/30/05,2005-09-30,2005
TENNESSEE,TENNESSEE MIDDLE,TNM,SIXTH CIRCUIT,15836,9761,108,3,5964,201,115,65,3,18,15635,9646,43,5946,09/30/05,2005-09-30,2005
TENNESSEE,TENNESSEE WESTERN,TNW,SIXTH CIRCUIT,26514,8930,59,0,17525,147,68,47,0,32,26367,8862,12,17493,09/30/05,2005-09-30,2005
ILLINOIS,ILLINOIS NORTHERN,ILN,SEVENTH CIRCUIT,61548,48334,205,3,13006,677,491,171,3,12,60871,47843,34,12994,09/30/05,2005-09-30,2005
ILLINOIS,ILLINOIS CENTRAL,ILC,SEVENTH CIRCUIT,18244,15762,37,8,2437,182,130,32,8,12,18062,15632,5,2425,09/30/05,2005-09-30,2005
ILLINOIS,ILLINOIS SOUTHERN,ILS,SEVENTH CIRCUIT,11368,7887,18,2,3460,61,44,10,2,4,11307,7843,8,3456,09/30/05,2005-09-30,2005
INDIANA,INDIANA NORTHERN,INN,SEVENTH CIRCUIT,24012,20185,43,3,3780,166,120,35,3,7,23846,20065,8,3773,09/30/05,2005-09-30,2005
INDIANA,INDIANA SOUTHERN,INS,SEVENTH CIRCUIT,39146,30385,100,6,8655,464,335,85,6,38,38682,30050,15,8617,09/30/05,2005-09-30,2005
WISCONSIN,WISCONSIN EASTERN,WIE,SEVENTH CIRCUIT,22021,18562,22,2,3435,244,202,21,2,19,21777,18360,1,3416,09/30/05,2005-09-30,2005
WISCONSIN,WISCONSIN WESTERN,WIW,SEVENTH CIRCUIT,10697,9543,36,11,1107,567,483,29,11,44,10130,9060,7,1063,09/30/05,2005-09-30,2005
ARKANSAS,ARKANSAS EASTERN,ARE,EIGHTH CIRCUIT,17736,9980,21,4,7731,221,131,18,4,68,17515,9849,3,7663,09/30/05,2005-09-30,2005
ARKANSAS,ARKANSAS WESTERN,ARW,EIGHTH CIRCUIT,9872,6839,16,3,3013,148,83,13,3,48,9724,6756,3,2965,09/30/05,2005-09-30,2005
IOWA,IOWA NORTHERN,IAN,EIGHTH CIRCUIT,6314,6075,10,4,225,252,229,10,4,9,6062,5846,0,216,09/30/05,2005-09-30,2005
IOWA,IOWA SOUTHERN,IAS,EIGHTH CIRCUIT,9769,9160,9,2,598,129,110,9,2,8,9640,9050,0,590,09/30/05,2005-09-30,2005
MINNESOTA,MINNESOTA,MN,EIGHTH CIRCUIT,22025,18368,40,4,3613,1579,1329,39,4,207,20446,17039,1,3406,09/30/05,2005-09-30,2005
MISSOURI,MISSOURI EASTERN,MOE,EIGHTH CIRCUIT,22765,16924,25,1,5815,161,121,22,1,17,22604,16803,3,5798,09/30/05,2005-09-30,2005
MISSOURI,MISSOURI WESTERN,MOW,EIGHTH CIRCUIT,21216,17684,37,1,3494,209,152,35,1,21,21007,17532,2,3473,09/30/05,2005-09-30,2005
NEBRASKA,NEBRASKA,NE,EIGHTH CIRCUIT,10515,8414,32,30,2039,272,188,31,30,23,10243,8226,1,2016,09/30/05,2005-09-30,2005
NORTH DAKOTA,NORTH DAKOTA,ND,EIGHTH CIRCUIT,2878,2702,4,10,162,77,60,4,10,3,2801,2642,0,159,09/30/05,2005-09-30,2005
SOUTH DAKOTA,SOUTH DAKOTA,SD,EIGHTH CIRCUIT,3530,3253,6,5,266,159,132,6,5,16,3371,3121,0,250,09/30/05,2005-09-30,2005
ALASKA,ALASKA,AK,NINTH CIRCUIT,1885,1723,14,1,147,71,46,13,1,11,1814,1677,1,136,09/30/05,2005-09-30,2005
ARIZONA,ARIZONA,AZ,NINTH CIRCUIT,35570,30839,162,2,4566,498,311,138,2,46,35072,30528,24,4520,09/30/05,2005-09-30,2005
CALIFORNIA,CALIFORNIA NORTHERN,CAN,NINTH CIRCUIT,24490,18987,137,1,5364,941,586,103,1,250,23549,18401,34,5114,09/30/05,2005-09-30,2005
CALIFORNIA,CALIFORNIA EASTERN,CAE,NINTH CIRCUIT,30649,26955,66,8,3620,846,617,59,8,162,29803,26338,7,3458,09/30/05,2005-09-30,2005
CALIFORNIA,CALIFORNIA CENTRAL,CAC,NINTH CIRCUIT,67721,63436,274,2,4005,1617,1289,244,2,78,66104,62147,30,3927,09/30/05,2005-09-30,2005
CALIFORNIA,CALIFORNIA SOUTHERN,CAS,NINTH CIRCUIT,13012,11292,49,0,1671,196,142,41,0,13,12816,11150,8,1658,09/30/05,2005-09-30,2005
HAWAII,HAWAII,HI,NINTH CIRCUIT,3716,3368,19,0,328,72,52,17,0,2,3644,3316,2,326,09/30/05,2005-09-30,2005
IDAHO,IDAHO,ID,NINTH CIRCUIT,10462,9124,22,8,1308,134,85,19,8,22,10328,9039,3,1286,09/30/05,2005-09-30,2005
MONTANA,MONTANA,MT,NINTH CIRCUIT,4929,4484,18,8,419,117,85,16,8,8,4812,4399,2,411,09/30/05,2005-09-30,2005
NEVADA,NEVADA,NV,NINTH CIRCUIT,18220,14767,115,0,3338,310,177,108,0,25,17910,14590,7,3313,09/30/05,2005-09-30,2005
OREGON,OREGON,OR,NINTH CIRCUIT,27909,23914,29,11,3955,968,703,27,11,227,26941,23211,2,3728,09/30/05,2005-09-30,2005
WASHINGTON,WASHINGTON EASTERN,WAE,NINTH CIRCUIT,10364,8512,37,7,1808,265,195,31,7,32,10099,8317,6,1776,09/30/05,2005-09-30,2005
WASHINGTON,WASHINGTON WESTERN,WAW,NINTH CIRCUIT,30172,25308,99,4,4761,446,317,71,4,54,29726,24991,28,4707,09/30/05,2005-09-30,2005
GUAM,GUAM,GUAM,NINTH CIRCUIT,330,295,2,0,33,10,8,2,0,0,320,287,0,33,09/30/05,2005-09-30,2005
NORTHERN MARIANA ISLANDS,NORTHERN MARIANAS,NMI,NINTH CIRCUIT,32,30,0,0,2,0,0,0,0,0,32,30,0,2,09/30/05,2005-09-30,2005
COLORADO,COLORADO,CO,TENTH CIRCUIT,34772,31769,103,7,2893,879,732,98,7,42,33893,31037,5,2851,09/30/05,2005-09-30,2005
KANSAS,KANSAS,KS,TENTH CIRCUIT,18936,15498,27,24,3387,345,241,21,24,59,18591,15257,6,3328,09/30/05,2005-09-30,2005
NEW MEXICO,NEW MEXICO,NM,TENTH CIRCUIT,10921,10155,45,4,717,784,680,38,4,62,10137,9475,7,655,09/30/05,2005-09-30,2005
OKLAHOMA,OKLAHOMA NORTHERN,OKN,TENTH CIRCUIT,8864,8131,13,0,720,318,274,13,0,31,8546,7857,0,689,09/30/05,2005-09-30,2005
OKLAHOMA,OKLAHOMA EASTERN,OKE,TENTH CIRCUIT,5504,5053,4,5,440,89,71,0,5,11,5415,4982,4,429,09/30/05,2005-09-30,2005
OKLAHOMA,OKLAHOMA WESTERN,OKW,TENTH CIRCUIT,16854,14767,30,9,2048,420,348,27,9,36,16434,14419,3,2012,09/30/05,2005-09-30,2005
UTAH,UTAH,UT,TENTH CIRCUIT,20611,14851,46,2,5712,417,276,42,2,97,20194,14575,4,5615,09/30/05,2005-09-30,2005
WYOMING,WYOMING,WY,TENTH CIRCUIT,2733,2569,12,0,152,67,44,12,0,11,2666,2525,0,141,09/30/05,2005-09-30,2005
ALABAMA,ALABAMA NORTHERN,ALN,ELEVENTH CIRCUIT,28439,15870,74,2,12492,156,97,49,2,7,28283,15773,25,12485,09/30/05,2005-09-30,2005
ALABAMA,ALABAMA MIDDLE,ALM,ELEVENTH CIRCUIT,9132,4714,37,0,4381,98,48,35,0,15,9034,4666,2,4366,09/30/05,2005-09-30,2005
ALABAMA,ALABAMA SOUTHERN,ALS,ELEVENTH CIRCUIT,7313,3255,15,0,4043,37,23,11,0,3,7276,3232,4,4040,09/30/05,2005-09-30,2005
FLORIDA,FLORIDA NORTHERN,FLN,ELEVENTH CIRCUIT,6659,5400,21,0,1238,79,61,15,0,3,6580,5339,6,1235,09/30/05,2005-09-30,2005
FLORIDA,FLORIDA MIDDLE,FLM,ELEVENTH CIRCUIT,56332,43348,207,0,12776,771,526,186,0,58,55561,42822,21,12718,09/30/05,2005-09-30,2005
FLORIDA,FLORIDA SOUTHERN,FLS,ELEVENTH CIRCUIT,30907,25735,138,0,5028,528,397,118,0,10,30379,25338,20,5018,09/30/05,2005-09-30,2005
GEORGIA,GEORGIA NORTHERN,GAN,ELEVENTH CIRCUIT,47865,28096,197,2,19568,1927,1209,167,2,547,45938,26887,30,19021,09/30/05,2005-09-30,2005
GEORGIA,GEORGIA MIDDLE,GAM,ELEVENTH CIRCUIT,17027,8274,35,11,8707,145,85,31,11,18,16882,8189,4,8689,09/30/05,2005-09-30,2005
GEORGIA,GEORGIA SOUTHERN,GAS,ELEVENTH CIRCUIT,14353,4064,37,5,10247,142,56,31,5,50,14211,4008,6,10197,09/30/05,2005-09-30,2005
DISTRICT OF COLUMBIA,DISTRICT OF COLUMBIA,DC,DC CIRCUIT,1313,1080,12,0,221,34,24,9,0,1,1279,1056,3,220,09/30/06,2006-09-30,2006
MAINE,MAINE,ME,FIRST CIRCUIT,3096,2798,16,2,280,116,81,16,2,17,2980,2717,0,263,09/30/06,2006-09-30,2006
MASSACHUSETTS,MASSACHUSETTS,MA,FIRST CIRCUIT,15181,12267,116,2,2796,290,188,98,2,2,14891,12079,18,2794,09/30/06,2006-09-30,2006
NEW HAMPSHIRE,NEW HAMPSHIRE,NH,FIRST CIRCUIT,3214,2669,13,1,531,335,268,11,1,55,2879,2401,2,476,09/30/06,2006-09-30,2006
RHODE ISLAND,RHODE ISLAND,RI,FIRST CIRCUIT,3047,2750,7,0,290,99,88,7,0,4,2948,2662,0,286,09/30/06,2006-09-30,2006
PUERTO RICO,PUERTO RICO,PR,FIRST CIRCUIT,7167,2150,96,18,4903,316,110,80,18,108,6851,2040,16,4795,09/30/06,2006-09-30,2006
CONNECTICUT,CONNECTICUT,CT,SECOND CIRCUIT,8895,7477,122,0,1296,235,120,108,0,7,8660,7357,14,1289,09/30/06,2006-09-30,2006
NEW YORK,NEW YORK NORTHERN,NYN,SECOND CIRCUIT,13123,10114,33,6,2970,241,156,32,6,47,12882,9958,1,2923,09/30/06,2006-09-30,2006
NEW YORK,NEW YORK EASTERN,NYE,SECOND CIRCUIT,18531,15915,130,0,2486,287,164,113,0,10,18244,15751,17,2476,09/30/06,2006-09-30,2006
NEW YORK,NEW YORK SOUTHERN,NYS,SECOND CIRCUIT,13496,11635,716,0,1093,938,189,690,0,7,12558,11446,26,1086,09/30/06,2006-09-30,2006
NEW YORK,NEW YORK WESTERN,NYW,SECOND CIRCUIT,12536,9643,36,2,2855,306,231,34,2,39,12230,9412,2,2816,09/30/06,2006-09-30,2006
VERMONT,VERMONT,VT,SECOND CIRCUIT,1498,1262,1,2,233,55,38,1,2,14,1443,1224,0,219,09/30/06,2006-09-30,2006
DELAWARE,DELAWARE,DE,THIRD CIRCUIT,2562,1641,179,0,742,218,37,179,0,2,2344,1604,0,740,09/30/06,2006-09-30,2006
NEW JERSEY,NEW JERSEY,NJ,THIRD CIRCUIT,25982,18562,173,1,7246,575,394,149,1,31,25407,18168,24,7215,09/30/06,2006-09-30,2006
PENNSYLVANIA,PENNSYLVANIA EASTERN,PAE,THIRD CIRCUIT,15255,10006,67,0,5180,279,183,55,0,41,14976,9823,12,5139,09/30/06,2006-09-30,2006
PENNSYLVANIA,PENNSYLVANIA MIDDLE,PAM,THIRD CIRCUIT,10309,7483,35,8,2783,276,154,35,8,79,10033,7329,0,2704,09/30/06,2006-09-30,2006
PENNSYLVANIA,PENNSYLVANIA WESTERN,PAW,THIRD CIRCUIT,17718,13730,143,5,3840,454,284,123,5,42,17264,13446,20,3798,09/30/06,2006-09-30,2006
VIRGIN ISLANDS,VIRGIN ISLANDS,VI,THIRD CIRCUIT,43,26,8,0,9,9,2,6,0,1,34,24,2,8,09/30/06,2006-09-30,2006
MARYLAND,MARYLAND,MD,FOURTH CIRCUIT,18608,13523,105,0,4980,500,310,92,0,98,18108,13213,13,4882,09/30/06,2006-09-30,2006
NORTH CAROLINA,NORTH CAROLINA EASTERN,NCE,FOURTH CIRCUIT,9451,5218,51,7,4175,192,96,48,7,41,9259,5122,3,4134,09/30/06,2006-09-30,2006
NORTH CAROLINA,NORTH CAROLINA MIDDLE,NCM,FOURTH CIRCUIT,7332,4056,14,2,3259,175,124,14,2,34,7157,3932,0,3225,09/30/06,2006-09-30,2006
NORTH CAROLINA,NORTH CAROLINA WESTERN,NCW,FOURTH CIRCUIT,7740,4989,31,1,2719,100,67,23,1,9,7640,4922,8,2710,09/30/06,2006-09-30,2006
SOUTH CAROLINA,SOUTH CAROLINA,SC,FOURTH CIRCUIT,8527,3457,39,0,5031,121,84,27,0,10,8406,3373,12,5021,09/30/06,2006-09-30,2006
VIRGINIA,VIRGINIA EASTERN,VAE,FOURTH CIRCUIT,15979,11330,87,4,4558,245,159,72,4,10,15734,11171,15,4548,09/30/06,2006-09-30,2006
VIRGINIA,VIRGINIA WESTERN,VAW,FOURTH CIRCUIT,6979,4992,26,1,1960,99,66,26,1,6,6880,4926,0,1954,09/30/06,2006-09-30,2006
WEST VIRGINIA,WEST VIRGINIA NORTHERN,WVN,FOURTH CIRCUIT,3166,2947,8,0,211,124,105,8,0,11,3042,2842,0,200,09/30/06,2006-09-30,2006
WEST VIRGINIA,WEST VIRGINIA SOUTHERN,WVS,FOURTH CIRCUIT,5007,4724,28,2,253,66,36,24,2,4,4941,4688,4,249,09/30/06,2006-09-30,2006
LOUISIANA,LOUISIANA EASTERN,LAE,FIFTH CIRCUIT,5003,4417,75,0,511,150,75,73,0,2,4853,4342,2,509,09/30/06,2006-09-30,2006
LOUISIANA,LOUISIANA MIDDLE,LAM,FIFTH CIRCUIT,2803,2248,13,0,542,33,22,11,0,0,2770,2226,2,542,09/30/06,2006-09-30,2006
LOUISIANA,LOUISIANA WESTERN,LAW,FIFTH CIRCUIT,11929,5939,54,18,5918,355,134,50,18,153,11574,5805,4,5765,09/30/06,2006-09-30,2006
MISSISSIPPI,MISSISSIPPI NORTHERN,MSN,FIFTH CIRCUIT,5517,3576,27,7,1907,99,55,27,7,10,5418,3521,0,1897,09/30/06,2006-09-30,2006
MISSISSIPPI,MISSISSIPPI SOUTHERN,MSS,FIFTH CIRCUIT,7600,5261,22,9,2308,101,63,22,9,7,7499,5198,0,2301,09/30/06,2006-09-30,2006
TEXAS,TEXAS NORTHERN,TXN,FIFTH CIRCUIT,22333,13287,353,6,8686,1138,632,345,6,154,21195,12655,8,8532,09/30/06,2006-09-30,2006
TEXAS,TEXAS EASTERN,TXE,FIFTH CIRCUIT,8668,6202,48,0,2417,349,269,43,0,36,8319,5933,5,2381,09/30/06,2006-09-30,2006
TEXAS,TEXAS SOUTHERN,TXS,FIFTH CIRCUIT,20264,13137,237,10,6880,739,472,203,10,54,19525,12665,34,6826,09/30/06,2006-09-30,2006
TEXAS,TEXAS WESTERN,TXW,FIFTH CIRCUIT,14209,9948,90,3,4167,594,435,84,3,71,13615,9513,6,4096,09/30/06,2006-09-30,2006
KENTUCKY,KENTUCKY EASTERN,KYE,SIXTH CIRCUIT,10271,8622,21,2,1626,147,114,21,2,10,10124,8508,0,1616,09/30/06,2006-09-30,2006
KENTUCKY,KENTUCKY WESTERN,KYW,SIXTH CIRCUIT,12223,9644,32,3,2544,160,114,30,3,13,12063,9530,2,2531,09/30/06,2006-09-30,2006
MICHIGAN,MICHIGAN EASTERN,MIE,SIXTH CIRCUIT,40168,30006,147,10,10002,601,434,123,10,31,39567,29572,24,9971,09/30/06,2006-09-30,2006
MICHIGAN,MICHIGAN WESTERN,MIW,SIXTH CIRCUIT,13186,11346,41,4,1795,313,244,39,4,26,12873,11102,2,1769,09/30/06,2006-09-30,2006
OHIO,OHIO NORTHERN,OHN,SIXTH CIRCUIT,39765,33112,92,5,6556,838,625,84,5,124,38927,32487,8,6432,09/30/06,2006-09-30,2006
OHIO,OHIO SOUTHERN,OHS,SIXTH CIRCUIT,32838,25156,63,1,7618,580,415,59,1,105,32258,24741,4,7513,09/30/06,2006-09-30,2006
TENNESSEE,TENNESSEE EASTERN,TNE,SIXTH CIRCUIT,12832,8231,28,8,4565,159,113,22,8,16,12673,8118,6,4549,09/30/06,2006-09-30,2006
TENNESSEE,TENNESSEE MIDDLE,TNM,SIXTH CIRCUIT,9532,5257,84,5,4186,154,86,57,5,6,9378,5171,27,4180,09/30/06,2006-09-30,2006
TENNESSEE,TENNESSEE WESTERN,TNW,SIXTH CIRCUIT,18421,5817,59,0,12545,158,85,48,0,25,18263,5732,11,12520,09/30/06,2006-09-30,2006
ILLINOIS,ILLINOIS NORTHERN,ILN,SEVENTH CIRCUIT,39011,30830,152,4,8023,633,460,145,4,22,38378,30370,7,8001,09/30/06,2006-09-30,2006
ILLINOIS,ILLINOIS CENTRAL,ILC,SEVENTH CIRCUIT,11085,9380,20,8,1677,170,131,18,8,13,10915,9249,2,1664,09/30/06,2006-09-30,2006
ILLINOIS,ILLINOIS SOUTHERN,ILS,SEVENTH CIRCUIT,6927,4434,22,1,2470,45,25,19,1,0,6882,4409,3,2470,09/30/06,2006-09-30,2006
INDIANA,INDIANA NORTHERN,INN,SEVENTH CIRCUIT,17692,14635,43,3,3011,166,115,32,3,16,17526,14520,11,2995,09/30/06,2006-09-30,2006
INDIANA,INDIANA SOUTHERN,INS,SEVENTH CIRCUIT,27214,20664,83,7,6460,459,331,76,7,45,26755,20333,7,6415,09/30/06,2006-09-30,2006
WISCONSIN,WISCONSIN EASTERN,WIE,SEVENTH CIRCUIT,13185,10832,19,3,2331,192,150,17,3,22,12993,10682,2,2309,09/30/06,2006-09-30,2006
WISCONSIN,WISCONSIN WESTERN,WIW,SEVENTH CIRCUIT,6646,5884,32,9,721,203,158,22,9,14,6443,5726,10,707,09/30/06,2006-09-30,2006
ARKANSAS,ARKANSAS EASTERN,ARE,EIGHTH CIRCUIT,9897,5931,20,15,3931,225,142,19,15,49,9672,5789,1,3882,09/30/06,2006-09-30,2006
ARKANSAS,ARKANSAS WESTERN,ARW,EIGHTH CIRCUIT,5865,4028,14,8,1814,117,77,12,8,19,5748,3951,2,1795,09/30/06,2006-09-30,2006
IOWA,IOWA NORTHERN,IAN,EIGHTH CIRCUIT,3535,3344,5,3,183,192,181,3,3,5,3343,3163,2,178,09/30/06,2006-09-30,2006
IOWA,IOWA SOUTHERN,IAS,EIGHTH CIRCUIT,5588,5112,6,1,469,125,108,6,1,10,5463,5004,0,459,09/30/06,2006-09-30,2006
MINNESOTA,MINNESOTA,MN,EIGHTH CIRCUIT,13631,11422,34,3,2170,758,652,28,3,73,12873,10770,6,2097,09/30/06,2006-09-30,2006
MISSOURI,MISSOURI EASTERN,MOE,EIGHTH CIRCUIT,14319,11015,29,4,3271,155,111,24,4,16,14164,10904,5,3255,09/30/06,2006-09-30,2006
MISSOURI,MISSOURI WESTERN,MOW,EIGHTH CIRCUIT,14546,11687,30,11,2818,203,139,28,11,25,14343,11548,2,2793,09/30/06,2006-09-30,2006
NEBRASKA,NEBRASKA,NE,EIGHTH CIRCUIT,6678,5216,25,26,1410,220,150,21,26,22,6458,5066,4,1388,09/30/06,2006-09-30,2006
NORTH DAKOTA,NORTH DAKOTA,ND,EIGHTH CIRCUIT,1726,1598,1,2,125,53,48,1,2,2,1673,1550,0,123,09/30/06,2006-09-30,2006
SOUTH DAKOTA,SOUTH DAKOTA,SD,EIGHTH CIRCUIT,1920,1707,1,3,209,96,79,1,3,13,1824,1628,0,196,09/30/06,2006-09-30,2006
ALASKA,ALASKA,AK,NINTH CIRCUIT,1300,1184,7,0,109,60,49,7,0,4,1240,1135,0,105,09/30/06,2006-09-30,2006
ARIZONA,ARIZONA,AZ,NINTH CIRCUIT,17457,15584,149,1,1722,339,190,130,1,17,17118,15394,19,1705,09/30/06,2006-09-30,2006
CALIFORNIA,CALIFORNIA NORTHERN,CAN,NINTH CIRCUIT,15468,11645,107,0,3714,709,470,70,0,167,14759,11175,37,3547,09/30/06,2006-09-30,2006
CALIFORNIA,CALIFORNIA EASTERN,CAE,NINTH CIRCUIT,19526,16907,56,6,2554,581,414,47,6,111,18945,16493,9,2443,09/30/06,2006-09-30,2006
CALIFORNIA,CALIFORNIA CENTRAL,CAC,NINTH CIRCUIT,41929,38425,286,3,3213,1425,1105,254,3,61,40504,37320,32,3152,09/30/06,2006-09-30,2006
CALIFORNIA,CALIFORNIA SOUTHERN,CAS,NINTH CIRCUIT,8300,7186,42,2,1070,254,201,35,2,16,8046,6985,7,1054,09/30/06,2006-09-30,2006
HAWAII,HAWAII,HI,NINTH CIRCUIT,2233,2016,11,0,205,43,32,9,0,1,2190,1984,2,204,09/30/06,2006-09-30,2006
IDAHO,IDAHO,ID,NINTH CIRCUIT,5865,5108,18,11,728,91,55,14,11,11,5774,5053,4,717,09/30/06,2006-09-30,2006
MONTANA,MONTANA,MT,NINTH CIRCUIT,3246,2935,14,8,289,66,41,12,8,5,3180,2894,2,284,09/30/06,2006-09-30,2006
NEVADA,NEVADA,NV,NINTH CIRCUIT,12759,10535,82,0,2142,214,123,78,0,13,12545,10412,4,2129,09/30/06,2006-09-30,2006
OREGON,OREGON,OR,NINTH CIRCUIT,16236,13717,15,7,2497,629,431,14,7,177,15607,13286,1,2320,09/30/06,2006-09-30,2006
WASHINGTON,WASHINGTON EASTERN,WAE,NINTH CIRCUIT,5928,4847,17,14,1050,176,111,16,14,35,5752,4736,1,1015,09/30/06,2006-09-30,2006
WASHINGTON,WASHINGTON WESTERN,WAW,NINTH CIRCUIT,17836,14488,87,3,3256,362,239,68,3,50,17474,14249,19,3206,09/30/06,2006-09-30,2006
GUAM,GUAM,GUAM,NINTH CIRCUIT,220,203,0,0,17,7,7,0,0,0,213,196,0,17,09/30/06,2006-09-30,2006
NORTHERN MARIANA ISLANDS,NORTHERN MARIANAS,NMI,NINTH CIRCUIT,21,21,0,0,0,2,2,0,0,0,19,19,0,0,09/30/06,2006-09-30,2006
COLORADO,COLORADO,CO,TENTH CIRCUIT,22207,20210,76,4,1917,752,636,68,4,44,21455,19574,8,1873,09/30/06,2006-09-30,2006
KANSAS,KANSAS,KS,TENTH CIRCUIT,12179,9820,17,12,2330,248,176,17,12,43,11931,9644,0,2287,09/30/06,2006-09-30,2006
NEW MEXICO,NEW MEXICO,NM,TENTH CIRCUIT,5559,5170,28,2,359,303,256,26,2,19,5256,4914,2,340,09/30/06,2006-09-30,2006
OKLAHOMA,OKLAHOMA NORTHERN,OKN,TENTH CIRCUIT,5395,5026,10,1,358,197,171,10,1,15,5198,4855,0,343,09/30/06,2006-09-30,2006
OKLAHOMA,OKLAHOMA EASTERN,OKE,TENTH CIRCUIT,3467,3213,4,2,248,69,58,4,2,5,3398,3155,0,243,09/30/06,2006-09-30,2006
OKLAHOMA,OKLAHOMA WESTERN,OKW,TENTH CIRCUIT,10657,9282,14,7,1354,195,167,11,7,10,10462,9115,3,1344,09/30/06,2006-09-30,2006
UTAH,UTAH,UT,TENTH CIRCUIT,10015,7639,32,1,2343,268,197,28,1,42,9747,7442,4,2301,09/30/06,2006-09-30,2006
WYOMING,WYOMING,WY,TENTH CIRCUIT,1611,1490,8,0,113,67,57,6,0,4,1544,1433,2,109,09/30/06,2006-09-30,2006
ALABAMA,ALABAMA NORTHERN,ALN,ELEVENTH CIRCUIT,17595,9457,60,1,8077,175,100,48,1,26,17420,9357,12,8051,09/30/06,2006-09-30,2006
ALABAMA,ALABAMA MIDDLE,ALM,ELEVENTH CIRCUIT,6001,2673,19,0,3309,68,43,17,0,8,5933,2630,2,3301,09/30/06,2006-09-30,2006
ALABAMA,ALABAMA SOUTHERN,ALS,ELEVENTH CIRCUIT,4142,2140,21,0,1981,42,26,12,0,4,4100,2114,9,1977,09/30/06,2006-09-30,2006
FLORIDA,FLORIDA NORTHERN,FLN,ELEVENTH CIRCUIT,3658,2986,17,0,655,98,77,16,0,5,3560,2909,1,650,09/30/06,2006-09-30,2006
FLORIDA,FLORIDA MIDDLE,FLM,ELEVENTH CIRCUIT,31092,23872,153,4,7062,733,541,136,4,51,30359,23331,17,7011,09/30/06,2006-09-30,2006
FLORIDA,FLORIDA SOUTHERN,FLS,ELEVENTH CIRCUIT,17396,14652,111,0,2633,451,331,100,0,20,16945,14321,11,2613,09/30/06,2006-09-30,2006
GEORGIA,GEORGIA NORTHERN,GAN,ELEVENTH CIRCUIT,32429,18733,182,0,13514,1075,614,160,0,301,31354,18119,22,13213,09/30/06,2006-09-30,2006
GEORGIA,GEORGIA MIDDLE,GAM,ELEVENTH CIRCUIT,9500,4314,25,10,5151,148,86,21,10,31,9352,4228,4,5120,09/30/06,2006-09-30,2006
GEORGIA,GEORGIA SOUTHERN,GAS,ELEVENTH CIRCUIT,8533,2300,21,11,6201,121,50,18,11,42,8412,2250,3,6159,09/30/06,2006-09-30,2006
DISTRICT OF COLUMBIA,DISTRICT OF COLUMBIA,DC,DC CIRCUIT,670,340,15,0,315,32,16,14,0,2,638,324,1,313,09/30/07,2007-09-30,2007
MAINE,MAINE,ME,FIRST CIRCUIT,2143,1687,15,1,440,130,96,15,1,18,2013,1591,0,422,09/30/07,2007-09-30,2007
MASSACHUSETTS,MASSACHUSETTS,MA,FIRST CIRCUIT,13011,8463,156,2,4390,339,191,138,2,8,12672,8272,18,4382,09/30/07,2007-09-30,2007
NEW HAMPSHIRE,NEW HAMPSHIRE,NH,FIRST CIRCUIT,2804,1977,21,3,803,331,228,20,3,80,2473,1749,1,723,09/30/07,2007-09-30,2007
RHODE ISLAND,RHODE ISLAND,RI,FIRST CIRCUIT,2521,1931,11,0,579,82,66,10,0,6,2439,1865,1,573,09/30/07,2007-09-30,2007
PUERTO RICO,PUERTO RICO,PR,FIRST CIRCUIT,7502,1735,86,8,5673,256,83,73,8,92,7246,1652,13,5581,09/30/07,2007-09-30,2007
CONNECTICUT,CONNECTICUT,CT,SECOND CIRCUIT,5572,3919,65,1,1587,210,139,59,1,11,5362,3780,6,1576,09/30/07,2007-09-30,2007
NEW YORK,NEW YORK NORTHERN,NYN,SECOND CIRCUIT,11262,7658,38,15,3551,270,151,37,15,67,10992,7507,1,3484,09/30/07,2007-09-30,2007
NEW YORK,NEW YORK EASTERN,NYE,SECOND CIRCUIT,11800,8591,175,0,3034,348,163,164,0,21,11452,8428,11,3013,09/30/07,2007-09-30,2007
NEW YORK,NEW YORK SOUTHERN,NYS,SECOND CIRCUIT,7251,5461,265,0,1492,475,181,249,0,13,6776,5280,16,1479,09/30/07,2007-09-30,2007
NEW YORK,NEW YORK WESTERN,NYW,SECOND CIRCUIT,8510,5887,29,4,2588,217,146,26,4,39,8293,5741,3,2549,09/30/07,2007-09-30,2007
VERMONT,VERMONT,VT,SECOND CIRCUIT,849,608,1,3,237,67,44,1,3,19,782,564,0,218,09/30/07,2007-09-30,2007
DELAWARE,DELAWARE,DE,THIRD CIRCUIT,1897,947,220,0,727,288,62,219,0,4,1609,885,1,723,09/30/07,2007-09-30,2007
NEW JERSEY,NEW JERSEY,NJ,THIRD CIRCUIT,18702,11388,387,3,6924,802,381,360,3,58,17900,11007,27,6866,09/30/07,2007-09-30,2007
PENNSYLVANIA,PENNSYLVANIA EASTERN,PAE,THIRD CIRCUIT,9778,4992,66,0,4720,274,172,63,0,39,9504,4820,3,4681,09/30/07,2007-09-30,2007
PENNSYLVANIA,PENNSYLVANIA MIDDLE,PAM,THIRD CIRCUIT,7332,4506,27,8,2791,197,109,27,8,53,7135,4397,0,2738,09/30/07,2007-09-30,2007
PENNSYLVANIA,PENNSYLVANIA WESTERN,PAW,THIRD CIRCUIT,12001,8035,136,7,3823,464,249,127,7,81,11537,7786,9,3742,09/30/07,2007-09-30,2007
VIRGIN ISLANDS,VIRGIN ISLANDS,VI,THIRD CIRCUIT,25,16,5,0,4,11,6,5,0,0,14,10,0,4,09/30/07,2007-09-30,2007
MARYLAND,MARYLAND,MD,FOURTH CIRCUIT,12509,6448,135,1,5925,389,225,105,1,58,12120,6223,30,5867,09/30/07,2007-09-30,2007
NORTH CAROLINA,NORTH CAROLINA EASTERN,NCE,FOURTH CIRCUIT,7703,2974,52,3,4674,182,99,49,3,31,7521,2875,3,4643,09/30/07,2007-09-30,2007
NORTH CAROLINA,NORTH CAROLINA MIDDLE,NCM,FOURTH CIRCUIT,5907,2554,25,3,3325,182,102,25,3,52,5725,2452,0,3273,09/30/07,2007-09-30,2007
NORTH CAROLINA,NORTH CAROLINA WESTERN,NCW,FOURTH CIRCUIT,5810,3162,47,0,2601,166,121,39,0,6,5644,3041,8,2595,09/30/07,2007-09-30,2007
SOUTH CAROLINA,SOUTH CAROLINA,SC,FOURTH CIRCUIT,7139,2292,49,1,4795,124,78,38,1,6,7015,2214,11,4789,09/30/07,2007-09-30,2007
VIRGINIA,VIRGINIA EASTERN,VAE,FOURTH CIRCUIT,12528,7026,84,2,5416,363,264,69,2,28,12165,6762,15,5388,09/30/07,2007-09-30,2007
VIRGINIA,VIRGINIA WESTERN,VAW,FOURTH CIRCUIT,5365,3415,12,1,1937,144,120,12,1,11,5221,3295,0,1926,09/30/07,2007-09-30,2007
WEST VIRGINIA,WEST VIRGINIA NORTHERN,WVN,FOURTH CIRCUIT,1646,1429,8,1,208,82,66,7,1,8,1564,1363,1,200,09/30/07,2007-09-30,2007
WEST VIRGINIA,WEST VIRGINIA SOUTHERN,WVS,FOURTH CIRCUIT,2584,2307,18,1,258,55,38,15,1,1,2529,2269,3,257,09/30/07,2007-09-30,2007
LOUISIANA,LOUISIANA EASTERN,LAE,FIFTH CIRCUIT,2523,1262,23,10,1228,90,60,18,10,2,2433,1202,5,1226,09/30/07,2007-09-30,2007
LOUISIANA,LOUISIANA MIDDLE,LAM,FIFTH CIRCUIT,1785,846,10,0,929,40,25,10,0,5,1745,821,0,924,09/30/07,2007-09-30,2007
LOUISIANA,LOUISIANA WESTERN,LAW,FIFTH CIRCUIT,9226,2529,62,26,6609,337,80,59,26,172,8889,2449,3,6437,09/30/07,2007-09-30,2007
MISSISSIPPI,MISSISSIPPI NORTHERN,MSN,FIFTH CIRCUIT,4807,2167,15,5,2620,123,86,15,5,17,4684,2081,0,2603,09/30/07,2007-09-30,2007
MISSISSIPPI,MISSISSIPPI SOUTHERN,MSS,FIFTH CIRCUIT,5982,2540,30,5,3406,123,74,27,5,16,5859,2466,3,3390,09/30/07,2007-09-30,2007
TEXAS,TEXAS NORTHERN,TXN,FIFTH CIRCUIT,14917,6004,189,5,8719,836,522,185,5,124,14081,5482,4,8595,09/30/07,2007-09-30,2007
TEXAS,TEXAS EASTERN,TXE,FIFTH CIRCUIT,5775,2950,44,9,2772,363,281,41,9,32,5412,2669,3,2740,09/30/07,2007-09-30,2007
TEXAS,TEXAS SOUTHERN,TXS,FIFTH CIRCUIT,12551,5037,174,9,7330,655,414,164,9,67,11896,4623,10,7263,09/30/07,2007-09-30,2007
TEXAS,TEXAS WESTERN,TXW,FIFTH CIRCUIT,9244,4541,94,3,4606,486,327,90,3,66,8758,4214,4,4540,09/30/07,2007-09-30,2007
KENTUCKY,KENTUCKY EASTERN,KYE,SIXTH CIRCUIT,7281,5117,33,1,2130,145,99,33,1,12,7136,5018,0,2118,09/30/07,2007-09-30,2007
KENTUCKY,KENTUCKY WESTERN,KYW,SIXTH CIRCUIT,8935,6231,14,1,2689,125,90,14,1,20,8810,6141,0,2669,09/30/07,2007-09-30,2007
MICHIGAN,MICHIGAN EASTERN,MIE,SIXTH CIRCUIT,33799,22301,140,12,11346,739,551,130,12,46,33060,21750,10,11300,09/30/07,2007-09-30,2007
MICHIGAN,MICHIGAN WESTERN,MIW,SIXTH CIRCUIT,10007,8125,32,3,1847,371,301,32,3,35,9636,7824,0,1812,09/30/07,2007-09-30,2007
OHIO,OHIO NORTHERN,OHN,SIXTH CIRCUIT,26417,18089,63,0,8265,663,493,59,0,111,25754,17596,4,8154,09/30/07,2007-09-30,2007
OHIO,OHIO SOUTHERN,OHS,SIXTH CIRCUIT,22110,13852,64,2,8192,566,388,62,2,114,21544,13464,2,8078,09/30/07,2007-09-30,2007
TENNESSEE,TENNESSEE EASTERN,TNE,SIXTH CIRCUIT,11377,5996,34,3,5344,200,141,31,3,25,11177,5855,3,5319,09/30/07,2007-09-30,2007
TENNESSEE,TENNESSEE MIDDLE,TNM,SIXTH CIRCUIT,9476,4279,82,5,5110,191,111,60,5,15,9285,4168,22,5095,09/30/07,2007-09-30,2007
TENNESSEE,TENNESSEE WESTERN,TNW,SIXTH CIRCUIT,16926,3812,38,1,13075,157,97,29,1,30,16769,3715,9,13045,09/30/07,2007-09-30,2007
ILLINOIS,ILLINOIS NORTHERN,ILN,SEVENTH CIRCUIT,26807,16997,160,0,9650,650,490,144,0,16,26157,16507,16,9634,09/30/07,2007-09-30,2007
ILLINOIS,ILLINOIS CENTRAL,ILC,SEVENTH CIRCUIT,7257,5478,22,2,1755,180,138,21,2,19,7077,5340,1,1736,09/30/07,2007-09-30,2007
ILLINOIS,ILLINOIS SOUTHERN,ILS,SEVENTH CIRCUIT,5083,2450,9,4,2620,121,64,9,4,44,4962,2386,0,2576,09/30/07,2007-09-30,2007
INDIANA,INDIANA NORTHERN,INN,SEVENTH CIRCUIT,11231,8090,50,4,3087,196,136,43,4,13,11035,7954,7,3074,09/30/07,2007-09-30,2007
INDIANA,INDIANA SOUTHERN,INS,SEVENTH CIRCUIT,18425,12207,54,3,6160,330,247,48,3,31,18095,11960,6,6129,09/30/07,2007-09-30,2007
WISCONSIN,WISCONSIN EASTERN,WIE,SEVENTH CIRCUIT,9947,7057,20,4,2866,203,160,18,4,21,9744,6897,2,2845,09/30/07,2007-09-30,2007
WISCONSIN,WISCONSIN WESTERN,WIW,SEVENTH CIRCUIT,5005,4154,21,14,816,179,120,16,14,29,4826,4034,5,787,09/30/07,2007-09-30,2007
ARKANSAS,ARKANSAS EASTERN,ARE,EIGHTH CIRCUIT,7344,3440,22,9,3873,191,124,19,9,39,7153,3316,3,3834,09/30/07,2007-09-30,2007
ARKANSAS,ARKANSAS WESTERN,ARW,EIGHTH CIRCUIT,4150,2219,22,3,1906,155,102,22,3,28,3995,2117,0,1878,09/30/07,2007-09-30,2007
IOWA,IOWA NORTHERN,IAN,EIGHTH CIRCUIT,2354,2177,5,4,168,110,97,5,4,4,2244,2080,0,164,09/30/07,2007-09-30,2007
IOWA,IOWA SOUTHERN,IAS,EIGHTH CIRCUIT,4306,3709,7,1,589,121,103,7,1,10,4185,3606,0,579,09/30/07,2007-09-30,2007
MINNESOTA,MINNESOTA,MN,EIGHTH CIRCUIT,11139,8749,42,9,2339,507,427,41,9,30,10632,8322,1,2309,09/30/07,2007-09-30,2007
MISSOURI,MISSOURI EASTERN,MOE,EIGHTH CIRCUIT,9919,6145,16,3,3755,153,119,15,3,16,9766,6026,1,3739,09/30/07,2007-09-30,2007
MISSOURI,MISSOURI WESTERN,MOW,EIGHTH CIRCUIT,10222,7074,32,4,3112,177,119,31,4,23,10045,6955,1,3089,09/30/07,2007-09-30,2007
NEBRASKA,NEBRASKA,NE,EIGHTH CIRCUIT,5204,3569,20,12,1603,203,153,17,12,21,5001,3416,3,1582,09/30/07,2007-09-30,2007
NORTH DAKOTA,NORTH DAKOTA,ND,EIGHTH CIRCUIT,1090,951,1,6,132,58,45,1,6,6,1032,906,0,126,09/30/07,2007-09-30,2007
SOUTH DAKOTA,SOUTH DAKOTA,SD,EIGHTH CIRCUIT,1302,1097,4,1,200,84,62,4,1,17,1218,1035,0,183,09/30/07,2007-09-30,2007
ALASKA,ALASKA,AK,NINTH CIRCUIT,696,562,13,1,120,64,40,13,1,10,632,522,0,110,09/30/07,2007-09-30,2007
ARIZONA,ARIZONA,AZ,NINTH CIRCUIT,9749,7405,202,0,2141,398,192,183,0,22,9351,7213,19,2119,09/30/07,2007-09-30,2007
CALIFORNIA,CALIFORNIA NORTHERN,CAN,NINTH CIRCUIT,11214,6416,169,2,4624,611,381,114,2,111,10603,6035,55,4513,09/30/07,2007-09-30,2007
CALIFORNIA,CALIFORNIA EASTERN,CAE,NINTH CIRCUIT,15594,11328,84,11,4170,691,471,73,11,135,14903,10857,11,4035,09/30/07,2007-09-30,2007
CALIFORNIA,CALIFORNIA CENTRAL,CAC,NINTH CIRCUIT,29106,22196,287,0,6621,1507,1166,249,0,90,27599,21030,38,6531,09/30/07,2007-09-30,2007
CALIFORNIA,CALIFORNIA SOUTHERN,CAS,NINTH CIRCUIT,7037,5497,43,0,1497,304,247,38,0,19,6733,5250,5,1478,09/30/07,2007-09-30,2007
HAWAII,HAWAII,HI,NINTH CIRCUIT,1281,1035,14,1,230,46,28,13,1,4,1235,1007,1,226,09/30/07,2007-09-30,2007
IDAHO,IDAHO,ID,NINTH CIRCUIT,3716,2961,18,6,731,99,69,16,6,8,3617,2892,2,723,09/30/07,2007-09-30,2007
MONTANA,MONTANA,MT,NINTH CIRCUIT,1934,1597,12,8,317,53,34,10,8,1,1881,1563,2,316,09/30/07,2007-09-30,2007
NEVADA,NEVADA,NV,NINTH CIRCUIT,9445,5747,103,0,3595,273,161,98,0,14,9172,5586,5,3581,09/30/07,2007-09-30,2007
OREGON,OREGON,OR,NINTH CIRCUIT,8993,6572,26,2,2393,281,191,22,2,66,8712,6381,4,2327,09/30/07,2007-09-30,2007
WASHINGTON,WASHINGTON EASTERN,WAE,NINTH CIRCUIT,4192,3154,21,3,1014,151,98,19,3,31,4041,3056,2,983,09/30/07,2007-09-30,2007
WASHINGTON,WASHINGTON WESTERN,WAW,NINTH CIRCUIT,10440,7141,77,4,3218,294,185,63,4,42,10146,6956,14,3176,09/30/07,2007-09-30,2007
GUAM,GUAM,GUAM,NINTH CIRCUIT,126,113,2,0,11,7,5,2,0,0,119,108,0,11,09/30/07,2007-09-30,2007
NORTHERN MARIANA ISLANDS,NORTHERN MARIANAS,NMI,NINTH CIRCUIT,18,16,0,0,2,3,3,0,0,0,15,13,0,2,09/30/07,2007-09-30,2007
COLORADO,COLORADO,CO,TENTH CIRCUIT,14238,11855,73,1,2309,586,480,68,1,37,13652,11375,5,2272,09/30/07,2007-09-30,2007
KANSAS,KANSAS,KS,TENTH CIRCUIT,7730,5145,24,21,2540,219,138,23,21,37,7511,5007,1,2503,09/30/07,2007-09-30,2007
NEW MEXICO,NEW MEXICO,NM,TENTH CIRCUIT,3232,2822,25,3,381,127,91,22,3,10,3105,2731,3,371,09/30/07,2007-09-30,2007
OKLAHOMA,OKLAHOMA NORTHERN,OKN,TENTH CIRCUIT,2648,2254,3,0,391,127,113,2,0,12,2521,2141,1,379,09/30/07,2007-09-30,2007
OKLAHOMA,OKLAHOMA EASTERN,OKE,TENTH CIRCUIT,1477,1198,24,2,251,72,42,23,2,3,1405,1156,1,248,09/30/07,2007-09-30,2007
OKLAHOMA,OKLAHOMA WESTERN,OKW,TENTH CIRCUIT,4841,3479,26,7,1329,166,124,26,7,9,4675,3355,0,1320,09/30/07,2007-09-30,2007
UTAH,UTAH,UT,TENTH CIRCUIT,6182,3688,21,1,2472,159,113,20,1,25,6023,3575,1,2447,09/30/07,2007-09-30,2007
WYOMING,WYOMING,WY,TENTH CIRCUIT,784,645,6,0,133,34,26,6,0,2,750,619,0,131,09/30/07,2007-09-30,2007
ALABAMA,ALABAMA NORTHERN,ALN,ELEVENTH CIRCUIT,14159,5641,67,5,8446,158,79,53,5,21,14001,5562,14,8425,09/30/07,2007-09-30,2007
ALABAMA,ALABAMA MIDDLE,ALM,ELEVENTH CIRCUIT,5274,1384,18,4,3868,90,54,15,4,17,5184,1330,3,3851,09/30/07,2007-09-30,2007
ALABAMA,ALABAMA SOUTHERN,ALS,ELEVENTH CIRCUIT,3743,994,21,1,2727,42,18,18,1,5,3701,976,3,2722,09/30/07,2007-09-30,2007
FLORIDA,FLORIDA NORTHERN,FLN,ELEVENTH CIRCUIT,2688,1927,21,3,737,119,88,17,3,11,2569,1839,4,726,09/30/07,2007-09-30,2007
FLORIDA,FLORIDA MIDDLE,FLM,ELEVENTH CIRCUIT,23027,13657,202,6,9162,883,625,182,6,70,22144,13032,20,9092,09/30/07,2007-09-30,2007
FLORIDA,FLORIDA SOUTHERN,FLS,ELEVENTH CIRCUIT,10857,7451,230,2,3172,669,430,210,2,26,10188,7021,20,3146,09/30/07,2007-09-30,2007
GEORGIA,GEORGIA NORTHERN,GAN,ELEVENTH CIRCUIT,30768,14535,222,0,16011,1096,598,197,0,301,29672,13937,25,15710,09/30/07,2007-09-30,2007
GEORGIA,GEORGIA MIDDLE,GAM,ELEVENTH CIRCUIT,9217,3196,13,7,6001,146,99,12,7,28,9071,3097,1,5973,09/30/07,2007-09-30,2007
GEORGIA,GEORGIA SOUTHERN,GAS,ELEVENTH CIRCUIT,8119,1562,25,9,6523,142,83,24,9,26,7977,1479,1,6497,09/30/07,2007-09-30,2007
DISTRICT OF COLUMBIA,DISTRICT OF COLUMBIA,DC,DC CIRCUIT,863,434,34,0,395,47,16,29,0,2,816,418,5,393,09/30/08,2008-09-30,2008
MAINE,MAINE,ME,FIRST CIRCUIT,2800,2273,17,8,502,173,135,16,8,14,2627,2138,1,488,09/30/08,2008-09-30,2008
MASSACHUSETTS,MASSACHUSETTS,MA,FIRST CIRCUIT,15636,11525,149,4,3957,340,189,130,4,16,15296,11336,19,3941,09/30/08,2008-09-30,2008
NEW HAMPSHIRE,NEW HAMPSHIRE,NH,FIRST CIRCUIT,3676,2775,27,1,873,351,262,23,1,65,3325,2513,4,808,09/30/08,2008-09-30,2008
RHODE ISLAND,RHODE ISLAND,RI,FIRST CIRCUIT,3919,3210,11,0,698,132,109,11,0,12,3787,3101,0,686,09/30/08,2008-09-30,2008
PUERTO RICO,PUERTO RICO,PR,FIRST CIRCUIT,8645,2101,109,22,6413,328,118,98,22,90,8317,1983,11,6323,09/30/08,2008-09-30,2008
CONNECTICUT,CONNECTICUT,CT,SECOND CIRCUIT,7706,5794,146,2,1764,397,245,135,2,15,7309,5549,11,1749,09/30/08,2008-09-30,2008
NEW YORK,NEW YORK NORTHERN,NYN,SECOND CIRCUIT,10911,7839,40,6,3023,248,144,38,6,57,10663,7695,2,2966,09/30/08,2008-09-30,2008
NEW YORK,NEW YORK EASTERN,NYE,SECOND CIRCUIT,15552,11665,146,0,3741,423,273,128,0,22,15129,11392,18,3719,09/30/08,2008-09-30,2008
NEW YORK,NEW YORK SOUTHERN,NYS,SECOND CIRCUIT,9537,7163,496,0,1869,741,226,482,0,24,8796,6937,14,1845,09/30/08,2008-09-30,2008
NEW YORK,NEW YORK WESTERN,NYW,SECOND CIRCUIT,9113,6435,47,5,2621,272,182,46,5,34,8841,6253,1,2587,09/30/08,2008-09-30,2008
VERMONT,VERMONT,VT,SECOND CIRCUIT,1155,854,2,2,297,46,31,1,2,12,1109,823,1,285,09/30/08,2008-09-30,2008
DELAWARE,DELAWARE,DE,THIRD CIRCUIT,2827,1379,603,1,830,729,101,603,1,10,2098,1278,0,820,09/30/08,2008-09-30,2008
NEW JERSEY,NEW JERSEY,NJ,THIRD CIRCUIT,24764,16523,334,0,7907,993,625,301,0,67,23771,15898,33,7840,09/30/08,2008-09-30,2008
PENNSYLVANIA,PENNSYLVANIA EASTERN,PAE,THIRD CIRCUIT,11023,6385,95,1,4542,372,234,90,1,47,10651,6151,5,4495,09/30/08,2008-09-30,2008
PENNSYLVANIA,PENNSYLVANIA MIDDLE,PAM,THIRD CIRCUIT,8480,5624,55,2,2799,259,144,54,2,59,8221,5480,1,2740,09/30/08,2008-09-30,2008
PENNSYLVANIA,PENNSYLVANIA WESTERN,PAW,THIRD CIRCUIT,12737,9010,147,6,3574,519,322,135,6,56,12218,8688,12,3518,09/30/08,2008-09-30,2008
VIRGIN ISLANDS,VIRGIN ISLANDS,VI,THIRD CIRCUIT,15,10,2,0,3,4,2,2,0,0,11,8,0,3,09/30/08,2008-09-30,2008
MARYLAND,MARYLAND,MD,FOURTH CIRCUIT,16926,10302,228,1,6395,525,318,165,1,41,16401,9984,63,6354,09/30/08,2008-09-30,2008
NORTH CAROLINA,NORTH CAROLINA EASTERN,NCE,FOURTH CIRCUIT,8956,3374,117,7,5458,334,192,104,7,31,8622,3182,13,5427,09/30/08,2008-09-30,2008
NORTH CAROLINA,NORTH CAROLINA MIDDLE,NCM,FOURTH CIRCUIT,6264,2995,22,2,3245,280,203,22,2,53,5984,2792,0,3192,09/30/08,2008-09-30,2008
NORTH CAROLINA,NORTH CAROLINA WESTERN,NCW,FOURTH CIRCUIT,6386,3841,52,2,2491,247,176,46,2,23,6139,3665,6,2468,09/30/08,2008-09-30,2008
SOUTH CAROLINA,SOUTH CAROLINA,SC,FOURTH CIRCUIT,7988,2922,69,0,4997,222,151,51,0,20,7766,2771,18,4977,09/30/08,2008-09-30,2008
VIRGINIA,VIRGINIA EASTERN,VAE,FOURTH CIRCUIT,19529,12247,140,2,7140,698,545,114,2,37,18831,11702,26,7103,09/30/08,2008-09-30,2008
VIRGINIA,VIRGINIA WESTERN,VAW,FOURTH CIRCUIT,6852,4511,46,5,2290,201,138,43,5,15,6651,4373,3,2275,09/30/08,2008-09-30,2008
WEST VIRGINIA,WEST VIRGINIA NORTHERN,WVN,FOURTH CIRCUIT,1994,1770,10,1,213,88,76,7,1,4,1906,1694,3,209,09/30/08,2008-09-30,2008
WEST VIRGINIA,WEST VIRGINIA SOUTHERN,WVS,FOURTH CIRCUIT,3083,2753,26,0,304,87,57,22,0,8,2996,2696,4,296,09/30/08,2008-09-30,2008
LOUISIANA,LOUISIANA EASTERN,LAE,FIFTH CIRCUIT,3208,1564,57,0,1587,182,112,56,0,14,3026,1452,1,1573,09/30/08,2008-09-30,2008
LOUISIANA,LOUISIANA MIDDLE,LAM,FIFTH CIRCUIT,1863,936,13,0,914,58,44,12,0,2,1805,892,1,912,09/30/08,2008-09-30,2008
LOUISIANA,LOUISIANA WESTERN,LAW,FIFTH CIRCUIT,10341,2921,33,8,7379,370,151,33,8,178,9971,2770,0,7201,09/30/08,2008-09-30,2008
MISSISSIPPI,MISSISSIPPI NORTHERN,MSN,FIFTH CIRCUIT,5467,2643,48,1,2775,159,86,48,1,24,5308,2557,0,2751,09/30/08,2008-09-30,2008
MISSISSIPPI,MISSISSIPPI SOUTHERN,MSS,FIFTH CIRCUIT,6349,2919,32,3,3395,172,116,31,3,22,6177,2803,1,3373,09/30/08,2008-09-30,2008
TEXAS,TEXAS NORTHERN,TXN,FIFTH CIRCUIT,15343,6687,228,5,8423,1081,730,220,5,126,14262,5957,8,8297,09/30/08,2008-09-30,2008
TEXAS,TEXAS EASTERN,TXE,FIFTH CIRCUIT,6288,3283,68,6,2931,487,359,66,6,56,5801,2924,2,2875,09/30/08,2008-09-30,2008
TEXAS,TEXAS SOUTHERN,TXS,FIFTH CIRCUIT,12053,5294,225,5,6529,764,480,203,5,76,11289,4814,22,6453,09/30/08,2008-09-30,2008
TEXAS,TEXAS WESTERN,TXW,FIFTH CIRCUIT,10077,5188,92,2,4795,552,370,86,2,94,9525,4818,6,4701,09/30/08,2008-09-30,2008
KENTUCKY,KENTUCKY EASTERN,KYE,SIXTH CIRCUIT,9684,7189,29,2,2464,266,210,29,2,25,9418,6979,0,2439,09/30/08,2008-09-30,2008
KENTUCKY,KENTUCKY WESTERN,KYW,SIXTH CIRCUIT,10752,7838,41,3,2870,205,147,40,3,15,10547,7691,1,2855,09/30/08,2008-09-30,2008
MICHIGAN,MICHIGAN EASTERN,MIE,SIXTH CIRCUIT,41227,30778,177,10,10262,1081,845,170,10,56,40146,29933,7,10206,09/30/08,2008-09-30,2008
MICHIGAN,MICHIGAN WESTERN,MIW,SIXTH CIRCUIT,12113,10269,54,6,1784,489,403,50,6,30,11624,9866,4,1754,09/30/08,2008-09-30,2008
OHIO,OHIO NORTHERN,OHN,SIXTH CIRCUIT,29060,21360,76,3,7621,709,531,68,3,107,28351,20829,8,7514,09/30/08,2008-09-30,2008
OHIO,OHIO SOUTHERN,OHS,SIXTH CIRCUIT,25578,16682,124,3,8765,746,504,122,3,113,24832,16178,2,8652,09/30/08,2008-09-30,2008
TENNESSEE,TENNESSEE EASTERN,TNE,SIXTH CIRCUIT,14923,8609,47,7,6260,261,184,44,7,26,14662,8425,3,6234,09/30/08,2008-09-30,2008
TENNESSEE,TENNESSEE MIDDLE,TNM,SIXTH CIRCUIT,11556,5889,102,2,5563,324,215,81,2,26,11232,5674,21,5537,09/30/08,2008-09-30,2008
TENNESSEE,TENNESSEE WESTERN,TNW,SIXTH CIRCUIT,18708,4642,41,0,14025,174,109,38,0,27,18534,4533,3,13998,09/30/08,2008-09-30,2008
ILLINOIS,ILLINOIS NORTHERN,ILN,SEVENTH CIRCUIT,38133,25818,179,1,12133,1040,844,163,1,30,37093,24974,16,12103,09/30/08,2008-09-30,2008
ILLINOIS,ILLINOIS CENTRAL,ILC,SEVENTH CIRCUIT,8776,6822,16,6,1932,170,135,15,6,14,8606,6687,1,1918,09/30/08,2008-09-30,2008
ILLINOIS,ILLINOIS SOUTHERN,ILS,SEVENTH CIRCUIT,5701,3141,21,3,2536,142,97,16,3,26,5559,3044,5,2510,09/30/08,2008-09-30,2008
INDIANA,INDIANA NORTHERN,INN,SEVENTH CIRCUIT,14041,10503,41,6,3491,284,219,34,6,25,13757,10284,7,3466,09/30/08,2008-09-30,2008
INDIANA,INDIANA SOUTHERN,INS,SEVENTH CIRCUIT,23497,15922,80,5,7490,497,380,72,5,40,23000,15542,8,7450,09/30/08,2008-09-30,2008
WISCONSIN,WISCONSIN EASTERN,WIE,SEVENTH CIRCUIT,13706,10053,21,8,3624,342,278,21,8,35,13364,9775,0,3589,09/30/08,2008-09-30,2008
WISCONSIN,WISCONSIN WESTERN,WIW,SEVENTH CIRCUIT,6589,5620,43,7,919,247,183,39,7,18,6342,5437,4,901,09/30/08,2008-09-30,2008
ARKANSAS,ARKANSAS EASTERN,ARE,EIGHTH CIRCUIT,8085,3968,12,5,4099,188,140,10,5,32,7897,3828,2,4067,09/30/08,2008-09-30,2008
ARKANSAS,ARKANSAS WESTERN,ARW,EIGHTH CIRCUIT,5156,2918,33,4,2200,266,180,32,4,49,4890,2738,1,2151,09/30/08,2008-09-30,2008
IOWA,IOWA NORTHERN,IAN,EIGHTH CIRCUIT,2808,2659,3,1,145,136,128,3,1,4,2672,2531,0,141,09/30/08,2008-09-30,2008
IOWA,IOWA SOUTHERN,IAS,EIGHTH CIRCUIT,5010,4463,8,2,537,162,149,8,2,3,4848,4314,0,534,09/30/08,2008-09-30,2008
MINNESOTA,MINNESOTA,MN,EIGHTH CIRCUIT,15556,12930,46,8,2572,756,669,45,8,34,14800,12261,1,2538,09/30/08,2008-09-30,2008
MISSOURI,MISSOURI EASTERN,MOE,EIGHTH CIRCUIT,12012,7821,43,4,4144,317,249,40,4,24,11695,7572,3,4120,09/30/08,2008-09-30,2008
MISSOURI,MISSOURI WESTERN,MOW,EIGHTH CIRCUIT,12407,8947,50,4,3406,314,235,50,4,25,12093,8712,0,3381,09/30/08,2008-09-30,2008
NEBRASKA,NEBRASKA,NE,EIGHTH CIRCUIT,6431,4590,28,11,1802,245,173,26,11,35,6186,4417,2,1767,09/30/08,2008-09-30,2008
NORTH DAKOTA,NORTH DAKOTA,ND,EIGHTH CIRCUIT,1330,1185,4,3,138,60,49,4,3,4,1270,1136,0,134,09/30/08,2008-09-30,2008
SOUTH DAKOTA,SOUTH DAKOTA,SD,EIGHTH CIRCUIT,1459,1248,1,1,209,96,77,1,1,17,1363,1171,0,192,09/30/08,2008-09-30,2008
ALASKA,ALASKA,AK,NINTH CIRCUIT,851,712,11,1,127,80,63,11,1,5,771,649,0,122,09/30/08,2008-09-30,2008
ARIZONA,ARIZONA,AZ,NINTH CIRCUIT,16908,13274,349,5,3280,852,528,302,5,17,16056,12746,47,3263,09/30/08,2008-09-30,2008
CALIFORNIA,CALIFORNIA NORTHERN,CAN,NINTH CIRCUIT,18965,12430,260,0,6275,968,652,171,0,145,17997,11778,89,6130,09/30/08,2008-09-30,2008
CALIFORNIA,CALIFORNIA EASTERN,CAE,NINTH CIRCUIT,28613,22860,131,5,5616,1075,811,113,5,145,27538,22049,18,5471,09/30/08,2008-09-30,2008
CALIFORNIA,CALIFORNIA CENTRAL,CAC,NINTH CIRCUIT,57145,42635,717,2,13787,3093,2293,620,2,174,54052,40342,97,13613,09/30/08,2008-09-30,2008
CALIFORNIA,CALIFORNIA SOUTHERN,CAS,NINTH CIRCUIT,12256,10210,58,0,1988,476,404,50,0,22,11780,9806,8,1966,09/30/08,2008-09-30,2008
HAWAII,HAWAII,HI,NINTH CIRCUIT,1810,1391,17,1,401,67,46,13,1,7,1743,1345,4,394,09/30/08,2008-09-30,2008
IDAHO,IDAHO,ID,NINTH CIRCUIT,4740,3913,23,8,796,186,136,18,8,24,4554,3777,5,772,09/30/08,2008-09-30,2008
MONTANA,MONTANA,MT,NINTH CIRCUIT,1894,1565,10,5,314,81,66,7,5,3,1813,1499,3,311,09/30/08,2008-09-30,2008
NEVADA,NEVADA,NV,NINTH CIRCUIT,16756,11264,166,1,5324,436,262,157,1,15,16320,11002,9,5309,09/30/08,2008-09-30,2008
OREGON,OREGON,OR,NINTH CIRCUIT,11615,8552,41,4,3018,339,230,36,4,69,11276,8322,5,2949,09/30/08,2008-09-30,2008
WASHINGTON,WASHINGTON EASTERN,WAE,NINTH CIRCUIT,5170,3984,14,5,1167,170,125,12,5,28,5000,3859,2,1139,09/30/08,2008-09-30,2008
WASHINGTON,WASHINGTON WESTERN,WAW,NINTH CIRCUIT,14730,10204,111,1,4412,462,300,90,1,69,14268,9904,21,4343,09/30/08,2008-09-30,2008
GUAM,GUAM,GUAM,NINTH CIRCUIT,128,115,NA,0,13,2,2,0,0,0,126,113,0,13,09/30/08,2008-09-30,2008
NORTHERN MARIANA ISLANDS,NORTHERN MARIANAS,NMI,NINTH CIRCUIT,14,14,NA,0,0,1,1,0,0,0,13,13,0,0,09/30/08,2008-09-30,2008
COLORADO,COLORADO,CO,TENTH CIRCUIT,19692,16779,91,3,2818,842,722,87,3,29,18850,16057,4,2789,09/30/08,2008-09-30,2008
KANSAS,KANSAS,KS,TENTH CIRCUIT,8642,5814,31,13,2784,248,169,30,13,36,8394,5645,1,2748,09/30/08,2008-09-30,2008
NEW MEXICO,NEW MEXICO,NM,TENTH CIRCUIT,4268,3826,33,1,408,197,149,27,1,20,4071,3677,6,388,09/30/08,2008-09-30,2008
OKLAHOMA,OKLAHOMA NORTHERN,OKN,TENTH CIRCUIT,3036,2652,13,0,371,140,124,9,0,7,2896,2528,4,364,09/30/08,2008-09-30,2008
OKLAHOMA,OKLAHOMA EASTERN,OKE,TENTH CIRCUIT,1694,1437,6,2,249,56,47,5,2,2,1638,1390,1,247,09/30/08,2008-09-30,2008
OKLAHOMA,OKLAHOMA WESTERN,OKW,TENTH CIRCUIT,5740,4185,20,11,1524,216,172,19,11,14,5524,4013,1,1510,09/30/08,2008-09-30,2008
UTAH,UTAH,UT,TENTH CIRCUIT,8403,4880,63,0,3460,340,245,61,0,34,8063,4635,2,3426,09/30/08,2008-09-30,2008
WYOMING,WYOMING,WY,TENTH CIRCUIT,774,643,11,2,118,51,34,11,2,4,723,609,0,114,09/30/08,2008-09-30,2008
ALABAMA,ALABAMA NORTHERN,ALN,ELEVENTH CIRCUIT,16115,7003,95,4,9013,289,190,81,4,14,15826,6813,14,8999,09/30/08,2008-09-30,2008
ALABAMA,ALABAMA MIDDLE,ALM,ELEVENTH CIRCUIT,6408,1822,26,4,4556,124,80,24,4,16,6284,1742,2,4540,09/30/08,2008-09-30,2008
ALABAMA,ALABAMA SOUTHERN,ALS,ELEVENTH CIRCUIT,5049,1379,30,1,3639,69,29,28,1,11,4980,1350,2,3628,09/30/08,2008-09-30,2008
FLORIDA,FLORIDA NORTHERN,FLN,ELEVENTH CIRCUIT,3808,3009,40,1,758,193,141,39,1,12,3615,2868,1,746,09/30/08,2008-09-30,2008
FLORIDA,FLORIDA MIDDLE,FLM,ELEVENTH CIRCUIT,38725,25432,425,3,12863,1968,1418,393,3,152,36757,24014,32,12711,09/30/08,2008-09-30,2008
FLORIDA,FLORIDA SOUTHERN,FLS,ELEVENTH CIRCUIT,18562,13424,323,5,4809,1314,917,307,5,84,17248,12507,16,4725,09/30/08,2008-09-30,2008
GEORGIA,GEORGIA NORTHERN,GAN,ELEVENTH CIRCUIT,37839,19718,318,3,17800,1499,975,291,3,230,36340,18743,27,17570,09/30/08,2008-09-30,2008
GEORGIA,GEORGIA MIDDLE,GAM,ELEVENTH CIRCUIT,10707,3920,41,13,6733,274,173,40,13,48,10433,3747,1,6685,09/30/08,2008-09-30,2008
GEORGIA,GEORGIA SOUTHERN,GAS,ELEVENTH CIRCUIT,9312,1923,39,3,7347,145,79,38,3,25,9167,1844,1,7322,09/30/08,2008-09-30,2008
DISTRICT OF COLUMBIA,DISTRICT OF COLUMBIA,DC,DC CIRCUIT,1095,698,43,0,354,84,39,39,0,6,1011,659,4,348,09/30/09,2009-09-30,2009
MAINE,MAINE,ME,FIRST CIRCUIT,3761,3117,54,5,585,237,159,51,5,22,3524,2958,3,563,09/30/09,2009-09-30,2009
MASSACHUSETTS,MASSACHUSETTS,MA,FIRST CIRCUIT,19805,16049,228,5,3522,694,474,196,5,18,19111,15575,32,3504,09/30/09,2009-09-30,2009
NEW HAMPSHIRE,NEW HAMPSHIRE,NH,FIRST CIRCUIT,4976,4000,57,2,917,523,377,52,2,92,4453,3623,5,825,09/30/09,2009-09-30,2009
RHODE ISLAND,RHODE ISLAND,RI,FIRST CIRCUIT,5096,4352,16,1,727,172,145,16,1,10,4924,4207,0,717,09/30/09,2009-09-30,2009
PUERTO RICO,PUERTO RICO,PR,FIRST CIRCUIT,10922,2953,159,19,7791,390,136,137,19,98,10532,2817,22,7693,09/30/09,2009-09-30,2009
CONNECTICUT,CONNECTICUT,CT,SECOND CIRCUIT,9710,8360,134,3,1212,450,310,117,3,19,9260,8050,17,1193,09/30/09,2009-09-30,2009
NEW YORK,NEW YORK NORTHERN,NYN,SECOND CIRCUIT,12185,9156,58,19,2952,335,197,56,19,63,11850,8959,2,2889,09/30/09,2009-09-30,2009
NEW YORK,NEW YORK EASTERN,NYE,SECOND CIRCUIT,20508,16790,247,0,3469,650,411,214,0,23,19858,16379,33,3446,09/30/09,2009-09-30,2009
NEW YORK,NEW YORK SOUTHERN,NYS,SECOND CIRCUIT,13252,9753,1644,0,1819,2121,445,1612,0,28,11131,9308,32,1791,09/30/09,2009-09-30,2009
NEW YORK,NEW YORK WESTERN,NYW,SECOND CIRCUIT,9457,6844,64,4,2545,326,210,62,4,50,9131,6634,2,2495,09/30/09,2009-09-30,2009
VERMONT,VERMONT,VT,SECOND CIRCUIT,1527,1176,2,2,347,58,45,2,2,9,1469,1131,0,338,09/30/09,2009-09-30,2009
DELAWARE,DELAWARE,DE,THIRD CIRCUIT,4592,2086,1662,4,815,1854,159,1661,4,5,2738,1927,1,810,09/30/09,2009-09-30,2009
NEW JERSEY,NEW JERSEY,NJ,THIRD CIRCUIT,34070,25420,413,3,8219,1502,1028,366,3,90,32568,24392,47,8129,09/30/09,2009-09-30,2009
PENNSYLVANIA,PENNSYLVANIA EASTERN,PAE,THIRD CIRCUIT,13019,8836,145,0,4038,531,333,136,0,62,12488,8503,9,3976,09/30/09,2009-09-30,2009
PENNSYLVANIA,PENNSYLVANIA MIDDLE,PAM,THIRD CIRCUIT,10158,7208,51,0,2897,312,200,48,0,63,9846,7008,3,2834,09/30/09,2009-09-30,2009
PENNSYLVANIA,PENNSYLVANIA WESTERN,PAW,THIRD CIRCUIT,13588,10317,180,7,3083,623,393,165,7,57,12965,9924,15,3026,09/30/09,2009-09-30,2009
VIRGIN ISLANDS,VIRGIN ISLANDS,VI,THIRD CIRCUIT,31,20,4,0,7,9,5,4,0,0,22,15,0,7,09/30/09,2009-09-30,2009
MARYLAND,MARYLAND,MD,FOURTH CIRCUIT,24179,17890,240,1,6048,874,653,174,1,46,23305,17237,66,6002,09/30/09,2009-09-30,2009
NORTH CAROLINA,NORTH CAROLINA EASTERN,NCE,FOURTH CIRCUIT,11326,4466,146,7,6707,521,329,135,7,50,10805,4137,11,6657,09/30/09,2009-09-30,2009
NORTH CAROLINA,NORTH CAROLINA MIDDLE,NCM,FOURTH CIRCUIT,7432,4138,31,0,3256,411,296,31,0,77,7021,3842,0,3179,09/30/09,2009-09-30,2009
NORTH CAROLINA,NORTH CAROLINA WESTERN,NCW,FOURTH CIRCUIT,8159,5507,81,4,2567,363,269,70,4,20,7796,5238,11,2547,09/30/09,2009-09-30,2009
SOUTH CAROLINA,SOUTH CAROLINA,SC,FOURTH CIRCUIT,9739,4600,105,4,5030,423,317,76,4,26,9316,4283,29,5004,09/30/09,2009-09-30,2009
VIRGINIA,VIRGINIA EASTERN,VAE,FOURTH CIRCUIT,26056,17406,251,1,8397,928,678,220,1,28,25128,16728,31,8369,09/30/09,2009-09-30,2009
VIRGINIA,VIRGINIA WESTERN,VAW,FOURTH CIRCUIT,9312,6425,38,1,2848,229,175,36,1,17,9083,6250,2,2831,09/30/09,2009-09-30,2009
WEST VIRGINIA,WEST VIRGINIA NORTHERN,WVN,FOURTH CIRCUIT,2863,2555,19,1,288,135,100,18,1,16,2728,2455,1,272,09/30/09,2009-09-30,2009
WEST VIRGINIA,WEST VIRGINIA SOUTHERN,WVS,FOURTH CIRCUIT,3489,3157,25,0,307,65,42,21,0,2,3424,3115,4,305,09/30/09,2009-09-30,2009
LOUISIANA,LOUISIANA EASTERN,LAE,FIFTH CIRCUIT,4337,2427,54,1,1855,265,202,50,1,12,4072,2225,4,1843,09/30/09,2009-09-30,2009
LOUISIANA,LOUISIANA MIDDLE,LAM,FIFTH CIRCUIT,2008,1127,20,1,860,87,59,20,1,7,1921,1068,0,853,09/30/09,2009-09-30,2009
LOUISIANA,LOUISIANA WESTERN,LAW,FIFTH CIRCUIT,11923,3137,71,9,8706,492,168,68,9,247,11431,2969,3,8459,09/30/09,2009-09-30,2009
MISSISSIPPI,MISSISSIPPI NORTHERN,MSN,FIFTH CIRCUIT,6959,3648,28,3,3280,211,145,27,3,36,6748,3503,1,3244,09/30/09,2009-09-30,2009
MISSISSIPPI,MISSISSIPPI SOUTHERN,MSS,FIFTH CIRCUIT,7495,4107,37,3,3347,229,178,35,3,12,7266,3929,2,3335,09/30/09,2009-09-30,2009
TEXAS,TEXAS NORTHERN,TXN,FIFTH CIRCUIT,19472,9302,437,8,9724,1628,1041,427,8,151,17844,8261,10,9573,09/30/09,2009-09-30,2009
TEXAS,TEXAS EASTERN,TXE,FIFTH CIRCUIT,7165,4000,94,2,3069,591,456,88,2,45,6574,3544,6,3024,09/30/09,2009-09-30,2009
TEXAS,TEXAS SOUTHERN,TXS,FIFTH CIRCUIT,13060,6322,342,3,6392,1079,670,326,3,79,11981,5652,16,6313,09/30/09,2009-09-30,2009
TEXAS,TEXAS WESTERN,TXW,FIFTH CIRCUIT,13192,6994,311,1,5883,1050,623,300,1,123,12142,6371,11,5760,09/30/09,2009-09-30,2009
KENTUCKY,KENTUCKY EASTERN,KYE,SIXTH CIRCUIT,12249,9363,43,2,2841,305,245,39,2,19,11944,9118,4,2822,09/30/09,2009-09-30,2009
KENTUCKY,KENTUCKY WESTERN,KYW,SIXTH CIRCUIT,12474,9387,47,6,3034,290,215,46,6,23,12184,9172,1,3011,09/30/09,2009-09-30,2009
MICHIGAN,MICHIGAN EASTERN,MIE,SIXTH CIRCUIT,51286,41887,192,14,9193,1362,1091,179,14,78,49924,40796,13,9115,09/30/09,2009-09-30,2009
MICHIGAN,MICHIGAN WESTERN,MIW,SIXTH CIRCUIT,15719,13751,73,16,1879,648,538,65,16,29,15071,13213,8,1850,09/30/09,2009-09-30,2009
OHIO,OHIO NORTHERN,OHN,SIXTH CIRCUIT,37595,30839,116,2,6638,1074,866,112,2,94,36521,29973,4,6544,09/30/09,2009-09-30,2009
OHIO,OHIO SOUTHERN,OHS,SIXTH CIRCUIT,32020,22817,112,6,9085,989,758,108,6,117,31031,22059,4,8968,09/30/09,2009-09-30,2009
TENNESSEE,TENNESSEE EASTERN,TNE,SIXTH CIRCUIT,19149,11963,74,11,7101,426,323,64,11,28,18723,11640,10,7073,09/30/09,2009-09-30,2009
TENNESSEE,TENNESSEE MIDDLE,TNM,SIXTH CIRCUIT,14833,8633,226,6,5967,558,350,173,6,28,14275,8283,53,5939,09/30/09,2009-09-30,2009
TENNESSEE,TENNESSEE WESTERN,TNW,SIXTH CIRCUIT,20299,5973,77,2,14247,226,131,65,2,28,20073,5842,12,14219,09/30/09,2009-09-30,2009
ILLINOIS,ILLINOIS NORTHERN,ILN,SEVENTH CIRCUIT,52663,39563,351,1,12746,1821,1466,322,1,30,50842,38097,29,12716,09/30/09,2009-09-30,2009
ILLINOIS,ILLINOIS CENTRAL,ILC,SEVENTH CIRCUIT,10496,8248,29,8,2211,258,202,28,8,20,10238,8046,1,2191,09/30/09,2009-09-30,2009
ILLINOIS,ILLINOIS SOUTHERN,ILS,SEVENTH CIRCUIT,6536,3977,30,3,2525,215,138,30,3,43,6321,3839,0,2482,09/30/09,2009-09-30,2009
INDIANA,INDIANA NORTHERN,INN,SEVENTH CIRCUIT,18437,14546,62,1,3828,316,238,57,1,20,18121,14308,5,3808,09/30/09,2009-09-30,2009
INDIANA,INDIANA SOUTHERN,INS,SEVENTH CIRCUIT,28451,19721,101,6,8623,596,448,92,6,50,27855,19273,9,8573,09/30/09,2009-09-30,2009
WISCONSIN,WISCONSIN EASTERN,WIE,SEVENTH CIRCUIT,18025,13974,81,3,3962,514,365,80,3,61,17511,13609,1,3901,09/30/09,2009-09-30,2009
WISCONSIN,WISCONSIN WESTERN,WIW,SEVENTH CIRCUIT,8513,7422,46,19,1026,308,219,37,19,33,8205,7203,9,993,09/30/09,2009-09-30,2009
ARKANSAS,ARKANSAS EASTERN,ARE,EIGHTH CIRCUIT,9669,4840,93,8,4728,339,200,91,8,40,9330,4640,2,4688,09/30/09,2009-09-30,2009
ARKANSAS,ARKANSAS WESTERN,ARW,EIGHTH CIRCUIT,6554,3928,43,5,2578,307,222,37,5,43,6247,3706,6,2535,09/30/09,2009-09-30,2009
IOWA,IOWA NORTHERN,IAN,EIGHTH CIRCUIT,3697,3502,11,2,181,165,148,11,2,3,3532,3354,0,178,09/30/09,2009-09-30,2009
IOWA,IOWA SOUTHERN,IAS,EIGHTH CIRCUIT,6195,5588,13,1,593,235,216,13,1,5,5960,5372,0,588,09/30/09,2009-09-30,2009
MINNESOTA,MINNESOTA,MN,EIGHTH CIRCUIT,20490,17529,157,14,2790,901,705,152,14,30,19589,16824,5,2760,09/30/09,2009-09-30,2009
MISSOURI,MISSOURI EASTERN,MOE,EIGHTH CIRCUIT,15299,11201,27,3,4068,378,330,25,3,20,14921,10871,2,4048,09/30/09,2009-09-30,2009
MISSOURI,MISSOURI WESTERN,MOW,EIGHTH CIRCUIT,14726,11065,59,6,3596,421,325,55,6,35,14305,10740,4,3561,09/30/09,2009-09-30,2009
NEBRASKA,NEBRASKA,NE,EIGHTH CIRCUIT,7347,5276,37,25,2007,308,214,35,25,32,7039,5062,2,1975,09/30/09,2009-09-30,2009
NORTH DAKOTA,NORTH DAKOTA,ND,EIGHTH CIRCUIT,1590,1418,5,3,164,67,57,4,3,3,1523,1361,1,161,09/30/09,2009-09-30,2009
SOUTH DAKOTA,SOUTH DAKOTA,SD,EIGHTH CIRCUIT,1790,1594,13,1,182,113,83,13,1,16,1677,1511,0,166,09/30/09,2009-09-30,2009
ALASKA,ALASKA,AK,NINTH CIRCUIT,933,780,14,0,139,98,66,13,0,19,835,714,1,120,09/30/09,2009-09-30,2009
ARIZONA,ARIZONA,AZ,NINTH CIRCUIT,31017,25431,563,3,5020,1553,978,493,3,79,29464,24453,70,4941,09/30/09,2009-09-30,2009
CALIFORNIA,CALIFORNIA NORTHERN,CAN,NINTH CIRCUIT,30052,20169,348,11,9524,1573,1103,237,11,222,28479,19066,111,9302,09/30/09,2009-09-30,2009
CALIFORNIA,CALIFORNIA EASTERN,CAE,NINTH CIRCUIT,44023,36450,220,20,7333,1527,1154,187,20,166,42496,35296,33,7167,09/30/09,2009-09-30,2009
CALIFORNIA,CALIFORNIA CENTRAL,CAC,NINTH CIRCUIT,97481,75047,1017,6,21409,4725,3680,860,6,177,92756,71367,157,21232,09/30/09,2009-09-30,2009
CALIFORNIA,CALIFORNIA SOUTHERN,CAS,NINTH CIRCUIT,19282,16105,112,3,3059,675,558,86,3,25,18607,15547,26,3034,09/30/09,2009-09-30,2009
HAWAII,HAWAII,HI,NINTH CIRCUIT,2941,2356,23,1,560,117,83,23,1,9,2824,2273,0,551,09/30/09,2009-09-30,2009
IDAHO,IDAHO,ID,NINTH CIRCUIT,7203,6313,46,9,835,312,247,39,9,17,6891,6066,7,818,09/30/09,2009-09-30,2009
MONTANA,MONTANA,MT,NINTH CIRCUIT,2593,2195,23,6,369,126,87,21,6,12,2467,2108,2,357,09/30/09,2009-09-30,2009
NEVADA,NEVADA,NV,NINTH CIRCUIT,27560,19790,383,0,7386,881,535,318,0,27,26679,19255,65,7359,09/30/09,2009-09-30,2009
OREGON,OREGON,OR,NINTH CIRCUIT,17200,13310,72,5,3813,601,441,61,5,94,16599,12869,11,3719,09/30/09,2009-09-30,2009
WASHINGTON,WASHINGTON EASTERN,WAE,NINTH CIRCUIT,7070,5615,47,6,1402,258,183,45,6,24,6812,5432,2,1378,09/30/09,2009-09-30,2009
WASHINGTON,WASHINGTON WESTERN,WAW,NINTH CIRCUIT,22450,16932,169,7,5323,843,590,149,7,78,21607,16342,20,5245,09/30/09,2009-09-30,2009
GUAM,GUAM,GUAM,NINTH CIRCUIT,212,194,2,0,16,6,3,2,0,1,206,191,0,15,09/30/09,2009-09-30,2009
NORTHERN MARIANA ISLANDS,NORTHERN MARIANAS,NMI,NINTH CIRCUIT,11,10,0,0,1,0,0,0,0,0,11,10,0,1,09/30/09,2009-09-30,2009
COLORADO,COLORADO,CO,TENTH CIRCUIT,26608,22597,171,7,3833,1330,1105,165,7,53,25278,21492,6,3780,09/30/09,2009-09-30,2009
KANSAS,KANSAS,KS,TENTH CIRCUIT,10588,7434,75,15,3064,356,236,71,15,34,10232,7198,4,3030,09/30/09,2009-09-30,2009
NEW MEXICO,NEW MEXICO,NM,TENTH CIRCUIT,5765,5264,43,1,456,279,227,37,1,13,5486,5037,6,443,09/30/09,2009-09-30,2009
OKLAHOMA,OKLAHOMA NORTHERN,OKN,TENTH CIRCUIT,4020,3648,4,0,368,198,185,4,0,9,3822,3463,0,359,09/30/09,2009-09-30,2009
OKLAHOMA,OKLAHOMA EASTERN,OKE,TENTH CIRCUIT,2213,1955,5,0,253,76,69,5,0,2,2137,1886,0,251,09/30/09,2009-09-30,2009
OKLAHOMA,OKLAHOMA WESTERN,OKW,TENTH CIRCUIT,7372,5595,60,5,1712,314,238,55,5,16,7058,5357,5,1696,09/30/09,2009-09-30,2009
UTAH,UTAH,UT,TENTH CIRCUIT,13660,8757,92,3,4808,595,445,86,3,61,13065,8312,6,4747,09/30/09,2009-09-30,2009
WYOMING,WYOMING,WY,TENTH CIRCUIT,1249,1065,17,1,159,82,53,15,1,6,1167,1012,2,153,09/30/09,2009-09-30,2009
ALABAMA,ALABAMA NORTHERN,ALN,ELEVENTH CIRCUIT,20014,9588,102,2,10322,424,292,94,2,36,19590,9296,8,10286,09/30/09,2009-09-30,2009
ALABAMA,ALABAMA MIDDLE,ALM,ELEVENTH CIRCUIT,8444,2581,36,2,5825,198,135,34,2,27,8246,2446,2,5798,09/30/09,2009-09-30,2009
ALABAMA,ALABAMA SOUTHERN,ALS,ELEVENTH CIRCUIT,6256,1922,54,1,4279,118,56,46,1,15,6138,1866,8,4264,09/30/09,2009-09-30,2009
FLORIDA,FLORIDA NORTHERN,FLN,ELEVENTH CIRCUIT,5308,4558,28,7,715,323,282,25,7,9,4985,4276,3,706,09/30/09,2009-09-30,2009
FLORIDA,FLORIDA MIDDLE,FLM,ELEVENTH CIRCUIT,57956,42264,638,26,15027,2989,2212,564,26,186,54967,40052,74,14841,09/30/09,2009-09-30,2009
FLORIDA,FLORIDA SOUTHERN,FLS,ELEVENTH CIRCUIT,27683,20672,261,3,6744,1493,1157,244,3,86,26190,19515,17,6658,09/30/09,2009-09-30,2009
GEORGIA,GEORGIA NORTHERN,GAN,ELEVENTH CIRCUIT,49488,30263,396,2,18827,2337,1805,363,2,167,47151,28458,33,18660,09/30/09,2009-09-30,2009
GEORGIA,GEORGIA MIDDLE,GAM,ELEVENTH CIRCUIT,12681,5154,49,24,7454,422,282,47,24,69,12259,4872,2,7385,09/30/09,2009-09-30,2009
GEORGIA,GEORGIA SOUTHERN,GAS,ELEVENTH CIRCUIT,11463,2865,66,13,8519,300,178,61,13,48,11163,2687,5,8471,09/30/09,2009-09-30,2009
DISTRICT OF COLUMBIA,DISTRICT OF COLUMBIA,DC,DC CIRCUIT,1286,852,64,0,370,113,54,49,0,10,1173,798,15,360,09/30/10,2010-09-30,2010
MAINE,MAINE,ME,FIRST CIRCUIT,4149,3556,21,11,561,217,159,18,11,29,3932,3397,3,532,09/30/10,2010-09-30,2010
MASSACHUSETTS,MASSACHUSETTS,MA,FIRST CIRCUIT,23485,18096,249,6,5131,567,348,194,6,16,22918,17748,55,5115,09/30/10,2010-09-30,2010
NEW HAMPSHIRE,NEW HAMPSHIRE,NH,FIRST CIRCUIT,5671,4593,41,0,1037,601,474,33,0,94,5070,4119,8,943,09/30/10,2010-09-30,2010
RHODE ISLAND,RHODE ISLAND,RI,FIRST CIRCUIT,5365,4620,27,0,718,169,133,24,0,12,5196,4487,3,706,09/30/10,2010-09-30,2010
PUERTO RICO,PUERTO RICO,PR,FIRST CIRCUIT,12232,4085,170,15,7962,420,162,149,15,94,11812,3923,21,7868,09/30/10,2010-09-30,2010
CONNECTICUT,CONNECTICUT,CT,SECOND CIRCUIT,11554,10258,140,5,1151,475,332,114,5,24,11079,9926,26,1127,09/30/10,2010-09-30,2010
NEW YORK,NEW YORK NORTHERN,NYN,SECOND CIRCUIT,12130,9330,44,22,2734,297,175,42,22,58,11833,9155,2,2676,09/30/10,2010-09-30,2010
NEW YORK,NEW YORK EASTERN,NYE,SECOND CIRCUIT,22803,19260,290,0,3251,728,430,269,0,29,22075,18830,21,3222,09/30/10,2010-09-30,2010
NEW YORK,NEW YORK SOUTHERN,NYS,SECOND CIRCUIT,13772,10729,883,0,2133,1325,427,850,0,21,12447,10302,33,2112,09/30/10,2010-09-30,2010
NEW YORK,NEW YORK WESTERN,NYW,SECOND CIRCUIT,9236,6744,33,3,2455,266,198,32,3,32,8970,6546,1,2423,09/30/10,2010-09-30,2010
VERMONT,VERMONT,VT,SECOND CIRCUIT,1676,1320,9,3,344,63,43,8,3,9,1613,1277,1,335,09/30/10,2010-09-30,2010
DELAWARE,DELAWARE,DE,THIRD CIRCUIT,4459,2530,1029,2,875,1159,102,1028,2,4,3300,2428,1,871,09/30/10,2010-09-30,2010
NEW JERSEY,NEW JERSEY,NJ,THIRD CIRCUIT,40775,31335,378,6,9055,1482,1066,321,6,88,39293,30269,57,8967,09/30/10,2010-09-30,2010
PENNSYLVANIA,PENNSYLVANIA EASTERN,PAE,THIRD CIRCUIT,15094,10206,161,7,4708,579,339,153,7,68,14515,9867,8,4640,09/30/10,2010-09-30,2010
PENNSYLVANIA,PENNSYLVANIA MIDDLE,PAM,THIRD CIRCUIT,10789,7682,47,8,3051,329,208,44,8,69,10460,7474,3,2982,09/30/10,2010-09-30,2010
PENNSYLVANIA,PENNSYLVANIA WESTERN,PAW,THIRD CIRCUIT,13588,10255,184,11,3138,568,338,167,11,52,13020,9917,17,3086,09/30/10,2010-09-30,2010
VIRGIN ISLANDS,VIRGIN ISLANDS,VI,THIRD CIRCUIT,24,17,3,0,4,7,4,3,0,0,17,13,0,4,09/30/10,2010-09-30,2010
MARYLAND,MARYLAND,MD,FOURTH CIRCUIT,29938,21903,300,7,7728,879,598,220,7,54,29059,21305,80,7674,09/30/10,2010-09-30,2010
NORTH CAROLINA,NORTH CAROLINA EASTERN,NCE,FOURTH CIRCUIT,11176,4318,147,11,6700,504,307,130,11,56,10672,4011,17,6644,09/30/10,2010-09-30,2010
NORTH CAROLINA,NORTH CAROLINA MIDDLE,NCM,FOURTH CIRCUIT,7397,4018,33,0,3346,439,306,31,0,102,6958,3712,2,3244,09/30/10,2010-09-30,2010
NORTH CAROLINA,NORTH CAROLINA WESTERN,NCW,FOURTH CIRCUIT,8785,6466,120,3,2196,482,352,107,3,20,8303,6114,13,2176,09/30/10,2010-09-30,2010
SOUTH CAROLINA,SOUTH CAROLINA,SC,FOURTH CIRCUIT,9559,4787,95,1,4675,396,309,70,1,15,9163,4478,25,4660,09/30/10,2010-09-30,2010
VIRGINIA,VIRGINIA EASTERN,VAE,FOURTH CIRCUIT,28511,19136,268,2,9105,939,673,228,2,36,27572,18463,40,9069,09/30/10,2010-09-30,2010
VIRGINIA,VIRGINIA WESTERN,VAW,FOURTH CIRCUIT,9173,6468,36,5,2664,230,173,32,5,20,8943,6295,4,2644,09/30/10,2010-09-30,2010
WEST VIRGINIA,WEST VIRGINIA NORTHERN,WVN,FOURTH CIRCUIT,2909,2576,27,0,306,121,85,26,0,10,2788,2491,1,296,09/30/10,2010-09-30,2010
WEST VIRGINIA,WEST VIRGINIA SOUTHERN,WVS,FOURTH CIRCUIT,3580,3260,19,0,301,91,71,19,0,1,3489,3189,0,300,09/30/10,2010-09-30,2010
LOUISIANA,LOUISIANA EASTERN,LAE,FIFTH CIRCUIT,4633,2480,51,1,2101,250,189,49,1,11,4383,2291,2,2090,09/30/10,2010-09-30,2010
LOUISIANA,LOUISIANA MIDDLE,LAM,FIFTH CIRCUIT,2067,1182,24,1,860,89,57,24,1,7,1978,1125,0,853,09/30/10,2010-09-30,2010
LOUISIANA,LOUISIANA WESTERN,LAW,FIFTH CIRCUIT,12536,3641,73,9,8813,429,174,69,9,177,12107,3467,4,8636,09/30/10,2010-09-30,2010
MISSISSIPPI,MISSISSIPPI NORTHERN,MSN,FIFTH CIRCUIT,6718,3534,27,16,3141,214,150,27,16,21,6504,3384,0,3120,09/30/10,2010-09-30,2010
MISSISSIPPI,MISSISSIPPI SOUTHERN,MSS,FIFTH CIRCUIT,7854,4595,44,3,3212,303,240,43,3,17,7551,4355,1,3195,09/30/10,2010-09-30,2010
TEXAS,TEXAS NORTHERN,TXN,FIFTH CIRCUIT,20847,10156,379,13,10299,1537,1007,366,13,151,19310,9149,13,10148,09/30/10,2010-09-30,2010
TEXAS,TEXAS EASTERN,TXE,FIFTH CIRCUIT,7903,4428,124,6,3344,583,419,114,6,43,7320,4009,10,3301,09/30/10,2010-09-30,2010
TEXAS,TEXAS SOUTHERN,TXS,FIFTH CIRCUIT,15491,6762,413,14,8300,1193,674,396,14,107,14298,6088,17,8193,09/30/10,2010-09-30,2010
TEXAS,TEXAS WESTERN,TXW,FIFTH CIRCUIT,13877,7547,239,3,6086,961,649,215,3,92,12916,6898,24,5994,09/30/10,2010-09-30,2010
KENTUCKY,KENTUCKY EASTERN,KYE,SIXTH CIRCUIT,12871,9745,31,6,3089,273,220,28,6,19,12598,9525,3,3070,09/30/10,2010-09-30,2010
KENTUCKY,KENTUCKY WESTERN,KYW,SIXTH CIRCUIT,12781,9540,51,7,3183,283,202,49,7,25,12498,9338,2,3158,09/30/10,2010-09-30,2010
MICHIGAN,MICHIGAN EASTERN,MIE,SIXTH CIRCUIT,53218,44722,159,10,8327,1383,1151,144,10,78,51835,43571,15,8249,09/30/10,2010-09-30,2010
MICHIGAN,MICHIGAN WESTERN,MIW,SIXTH CIRCUIT,16752,14672,50,16,2014,568,472,48,16,32,16184,14200,2,1982,09/30/10,2010-09-30,2010
OHIO,OHIO NORTHERN,OHN,SIXTH CIRCUIT,38902,32062,139,5,6696,1032,810,131,5,86,37870,31252,8,6610,09/30/10,2010-09-30,2010
OHIO,OHIO SOUTHERN,OHS,SIXTH CIRCUIT,33605,23690,69,9,9837,873,694,63,9,107,32732,22996,6,9730,09/30/10,2010-09-30,2010
TENNESSEE,TENNESSEE EASTERN,TNE,SIXTH CIRCUIT,17995,11390,105,19,6481,459,312,95,19,33,17536,11078,10,6448,09/30/10,2010-09-30,2010
TENNESSEE,TENNESSEE MIDDLE,TNM,SIXTH CIRCUIT,14456,8717,171,4,5564,459,313,120,4,22,13997,8404,51,5542,09/30/10,2010-09-30,2010
TENNESSEE,TENNESSEE WESTERN,TNW,SIXTH CIRCUIT,19146,5944,61,0,13141,216,130,54,0,32,18930,5814,7,13109,09/30/10,2010-09-30,2010
ILLINOIS,ILLINOIS NORTHERN,ILN,SEVENTH CIRCUIT,65443,50327,317,6,14793,1966,1625,282,6,53,63477,48702,35,14740,09/30/10,2010-09-30,2010
ILLINOIS,ILLINOIS CENTRAL,ILC,SEVENTH CIRCUIT,10727,8546,19,5,2157,207,172,19,5,11,10520,8374,0,2146,09/30/10,2010-09-30,2010
ILLINOIS,ILLINOIS SOUTHERN,ILS,SEVENTH CIRCUIT,6341,3860,23,1,2456,156,89,23,1,42,6185,3771,0,2414,09/30/10,2010-09-30,2010
INDIANA,INDIANA NORTHERN,INN,SEVENTH CIRCUIT,19538,15498,70,3,3966,351,253,65,3,29,19187,15245,5,3937,09/30/10,2010-09-30,2010
INDIANA,INDIANA SOUTHERN,INS,SEVENTH CIRCUIT,28905,20452,125,4,8324,634,458,119,4,53,28271,19994,6,8271,09/30/10,2010-09-30,2010
WISCONSIN,WISCONSIN EASTERN,WIE,SEVENTH CIRCUIT,20687,16148,32,16,4491,537,446,27,16,48,20150,15702,5,4443,09/30/10,2010-09-30,2010
WISCONSIN,WISCONSIN WESTERN,WIW,SEVENTH CIRCUIT,9541,8419,38,30,1054,372,285,29,30,28,9169,8134,9,1026,09/30/10,2010-09-30,2010
ARKANSAS,ARKANSAS EASTERN,ARE,EIGHTH CIRCUIT,9785,5059,24,5,4697,226,170,23,5,28,9559,4889,1,4669,09/30/10,2010-09-30,2010
ARKANSAS,ARKANSAS WESTERN,ARW,EIGHTH CIRCUIT,7033,4270,76,4,2683,336,225,72,4,35,6697,4045,4,2648,09/30/10,2010-09-30,2010
IOWA,IOWA NORTHERN,IAN,EIGHTH CIRCUIT,3649,3469,6,7,166,147,129,6,7,4,3502,3340,0,162,09/30/10,2010-09-30,2010
IOWA,IOWA SOUTHERN,IAS,EIGHTH CIRCUIT,6505,5841,21,1,642,213,187,21,1,4,6292,5654,0,638,09/30/10,2010-09-30,2010
MINNESOTA,MINNESOTA,MN,EIGHTH CIRCUIT,22628,19672,69,14,2873,805,687,69,14,35,21823,18985,0,2838,09/30/10,2010-09-30,2010
MISSOURI,MISSOURI EASTERN,MOE,EIGHTH CIRCUIT,17633,12946,48,5,4634,403,335,45,5,18,17230,12611,3,4616,09/30/10,2010-09-30,2010
MISSOURI,MISSOURI WESTERN,MOW,EIGHTH CIRCUIT,15854,11547,73,15,4218,399,282,66,15,35,15455,11265,7,4183,09/30/10,2010-09-30,2010
NEBRASKA,NEBRASKA,NE,EIGHTH CIRCUIT,7924,5798,64,29,2031,298,184,58,29,25,7626,5614,6,2006,09/30/10,2010-09-30,2010
NORTH DAKOTA,NORTH DAKOTA,ND,EIGHTH CIRCUIT,1651,1460,6,4,181,65,51,6,4,4,1586,1409,0,177,09/30/10,2010-09-30,2010
SOUTH DAKOTA,SOUTH DAKOTA,SD,EIGHTH CIRCUIT,2018,1813,18,4,183,107,75,18,4,10,1911,1738,0,173,09/30/10,2010-09-30,2010
ALASKA,ALASKA,AK,NINTH CIRCUIT,1132,926,16,1,189,84,62,16,1,5,1048,864,0,184,09/30/10,2010-09-30,2010
ARIZONA,ARIZONA,AZ,NINTH CIRCUIT,42216,34726,692,6,6789,1709,1083,549,6,68,40507,33643,143,6721,09/30/10,2010-09-30,2010
CALIFORNIA,CALIFORNIA NORTHERN,CAN,NINTH CIRCUIT,38632,25597,425,9,12601,1642,1131,255,9,247,36990,24466,170,12354,09/30/10,2010-09-30,2010
CALIFORNIA,CALIFORNIA EASTERN,CAE,NINTH CIRCUIT,54389,44194,242,42,9910,1479,1077,188,42,171,52910,43117,54,9739,09/30/10,2010-09-30,2010
CALIFORNIA,CALIFORNIA CENTRAL,CAC,NINTH CIRCUIT,138585,106627,1159,14,30783,5469,4388,850,14,215,133116,102239,309,30568,09/30/10,2010-09-30,2010
CALIFORNIA,CALIFORNIA SOUTHERN,CAS,NINTH CIRCUIT,23509,18888,142,3,4476,678,530,97,3,48,22831,18358,45,4428,09/30/10,2010-09-30,2010
HAWAII,HAWAII,HI,NINTH CIRCUIT,3862,3083,18,1,759,149,120,13,1,14,3713,2963,5,745,09/30/10,2010-09-30,2010
IDAHO,IDAHO,ID,NINTH CIRCUIT,8392,7366,57,12,956,396,320,50,12,13,7996,7046,7,943,09/30/10,2010-09-30,2010
MONTANA,MONTANA,MT,NINTH CIRCUIT,3167,2662,45,13,447,176,108,39,13,16,2991,2554,6,431,09/30/10,2010-09-30,2010
NEVADA,NEVADA,NV,NINTH CIRCUIT,30637,22931,484,1,7221,1015,617,359,1,38,29622,22314,125,7183,09/30/10,2010-09-30,2010
OREGON,OREGON,OR,NINTH CIRCUIT,20460,16062,69,16,4313,581,419,69,16,77,19879,15643,0,4236,09/30/10,2010-09-30,2010
WASHINGTON,WASHINGTON EASTERN,WAE,NINTH CIRCUIT,7471,6034,47,5,1385,246,173,45,5,23,7225,5861,2,1362,09/30/10,2010-09-30,2010
WASHINGTON,WASHINGTON WESTERN,WAW,NINTH CIRCUIT,26671,20627,291,3,5749,928,640,231,3,53,25743,19987,60,5696,09/30/10,2010-09-30,2010
GUAM,GUAM,GUAM,NINTH CIRCUIT,211,179,1,0,31,11,10,1,0,0,200,169,0,31,09/30/10,2010-09-30,2010
NORTHERN MARIANA ISLANDS,NORTHERN MARIANAS,NMI,NINTH CIRCUIT,9,9,0,0,0,2,2,0,0,0,7,7,0,0,09/30/10,2010-09-30,2010
COLORADO,COLORADO,CO,TENTH CIRCUIT,32636,27286,218,12,5120,1476,1193,197,12,74,31160,26093,21,5046,09/30/10,2010-09-30,2010
KANSAS,KANSAS,KS,TENTH CIRCUIT,11379,7993,59,19,3308,347,230,56,19,42,11032,7763,3,3266,09/30/10,2010-09-30,2010
NEW MEXICO,NEW MEXICO,NM,TENTH CIRCUIT,6659,6086,48,6,519,284,222,38,6,18,6375,5864,10,501,09/30/10,2010-09-30,2010
OKLAHOMA,OKLAHOMA NORTHERN,OKN,TENTH CIRCUIT,4564,4076,33,1,454,211,172,32,1,6,4353,3904,1,448,09/30/10,2010-09-30,2010
OKLAHOMA,OKLAHOMA EASTERN,OKE,TENTH CIRCUIT,2393,2137,12,2,241,81,58,11,2,9,2312,2079,1,232,09/30/10,2010-09-30,2010
OKLAHOMA,OKLAHOMA WESTERN,OKW,TENTH CIRCUIT,8271,6421,41,10,1799,273,205,38,10,20,7998,6216,3,1779,09/30/10,2010-09-30,2010
UTAH,UTAH,UT,TENTH CIRCUIT,17888,11943,83,4,5858,698,562,77,4,55,17190,11381,6,5803,09/30/10,2010-09-30,2010
WYOMING,WYOMING,WY,TENTH CIRCUIT,1560,1327,22,0,211,77,53,21,0,3,1483,1274,1,208,09/30/10,2010-09-30,2010
ALABAMA,ALABAMA NORTHERN,ALN,ELEVENTH CIRCUIT,20157,10358,104,9,9686,416,295,91,9,21,19741,10063,13,9665,09/30/10,2010-09-30,2010
ALABAMA,ALABAMA MIDDLE,ALM,ELEVENTH CIRCUIT,8320,2509,42,5,5764,223,150,41,5,27,8097,2359,1,5737,09/30/10,2010-09-30,2010
ALABAMA,ALABAMA SOUTHERN,ALS,ELEVENTH CIRCUIT,6212,2097,65,1,4048,143,71,58,1,12,6069,2026,7,4036,09/30/10,2010-09-30,2010
FLORIDA,FLORIDA NORTHERN,FLN,ELEVENTH CIRCUIT,5509,4811,45,3,650,338,288,41,3,6,5171,4523,4,644,09/30/10,2010-09-30,2010
FLORIDA,FLORIDA MIDDLE,FLM,ELEVENTH CIRCUIT,66881,49952,763,34,16124,2995,2163,622,34,169,63886,47789,141,15955,09/30/10,2010-09-30,2010
FLORIDA,FLORIDA SOUTHERN,FLS,ELEVENTH CIRCUIT,39160,28752,378,4,10020,1702,1253,349,4,90,37458,27499,29,9930,09/30/10,2010-09-30,2010
GEORGIA,GEORGIA NORTHERN,GAN,ELEVENTH CIRCUIT,54948,34356,352,8,20232,1910,1501,326,8,75,53038,32855,26,20157,09/30/10,2010-09-30,2010
GEORGIA,GEORGIA MIDDLE,GAM,ELEVENTH CIRCUIT,12953,5410,75,34,7434,465,301,72,34,58,12488,5109,3,7376,09/30/10,2010-09-30,2010
GEORGIA,GEORGIA SOUTHERN,GAS,ELEVENTH CIRCUIT,10892,2754,106,6,8026,345,198,103,6,38,10547,2556,3,7988,09/30/10,2010-09-30,2010
DISTRICT OF COLUMBIA,DISTRICT OF COLUMBIA,DC,DC CIRCUIT,1063,819,40,0,204,81,37,37,0,7,982,782,3,197,09/30/11,2011-09-30,2011
MAINE,MAINE,ME,FIRST CIRCUIT,3835,3249,31,5,550,231,176,27,5,23,3604,3073,4,527,09/30/11,2011-09-30,2011
MASSACHUSETTS,MASSACHUSETTS,MA,FIRST CIRCUIT,21208,15871,225,36,5075,578,353,180,36,8,20630,15518,45,5067,09/30/11,2011-09-30,2011
NEW HAMPSHIRE,NEW HAMPSHIRE,NH,FIRST CIRCUIT,5132,3922,53,1,1156,528,391,48,1,88,4604,3531,5,1068,09/30/11,2011-09-30,2011
RHODE ISLAND,RHODE ISLAND,RI,FIRST CIRCUIT,5250,4352,13,0,884,151,127,13,0,10,5099,4225,0,874,09/30/11,2011-09-30,2011
PUERTO RICO,PUERTO RICO,PR,FIRST CIRCUIT,11827,4181,181,44,7421,464,172,157,44,91,11363,4009,24,7330,09/30/11,2011-09-30,2011
CONNECTICUT,CONNECTICUT,CT,SECOND CIRCUIT,10179,9116,115,0,948,404,293,90,0,21,9775,8823,25,927,09/30/11,2011-09-30,2011
NEW YORK,NEW YORK NORTHERN,NYN,SECOND CIRCUIT,9966,7717,39,11,2198,249,161,38,11,38,9717,7556,1,2160,09/30/11,2011-09-30,2011
NEW YORK,NEW YORK EASTERN,NYE,SECOND CIRCUIT,20585,18477,232,0,1874,702,459,213,0,28,19883,18018,19,1846,09/30/11,2011-09-30,2011
NEW YORK,NEW YORK SOUTHERN,NYS,SECOND CIRCUIT,12865,10214,768,5,1850,1172,368,746,5,25,11693,9846,22,1825,09/30/11,2011-09-30,2011
NEW YORK,NEW YORK WESTERN,NYW,SECOND CIRCUIT,7423,5384,44,3,1992,271,169,44,3,55,7152,5215,0,1937,09/30/11,2011-09-30,2011
VERMONT,VERMONT,VT,SECOND CIRCUIT,1243,1013,1,5,224,50,37,1,5,7,1193,976,0,217,09/30/11,2011-09-30,2011
DELAWARE,DELAWARE,DE,THIRD CIRCUIT,4195,2561,470,2,1116,615,93,468,2,6,3580,2468,2,1110,09/30/11,2011-09-30,2011
NEW JERSEY,NEW JERSEY,NJ,THIRD CIRCUIT,39688,31109,306,3,8270,1240,878,272,3,87,38448,30231,34,8183,09/30/11,2011-09-30,2011
PENNSYLVANIA,PENNSYLVANIA EASTERN,PAE,THIRD CIRCUIT,13924,9424,131,8,4361,487,293,123,8,63,13437,9131,8,4298,09/30/11,2011-09-30,2011
PENNSYLVANIA,PENNSYLVANIA MIDDLE,PAM,THIRD CIRCUIT,9310,6616,38,3,2653,283,193,36,3,51,9027,6423,2,2602,09/30/11,2011-09-30,2011
PENNSYLVANIA,PENNSYLVANIA WESTERN,PAW,THIRD CIRCUIT,12159,9064,135,5,2955,452,278,123,5,46,11707,8786,12,2909,09/30/11,2011-09-30,2011
VIRGIN ISLANDS,VIRGIN ISLANDS,VI,THIRD CIRCUIT,22,21,1,0,0,11,10,1,0,0,11,11,0,0,09/30/11,2011-09-30,2011
MARYLAND,MARYLAND,MD,FOURTH CIRCUIT,26829,21248,191,3,5387,686,494,145,3,44,26143,20754,46,5343,09/30/11,2011-09-30,2011
NORTH CAROLINA,NORTH CAROLINA EASTERN,NCE,FOURTH CIRCUIT,10288,3670,165,10,6443,484,267,148,10,59,9804,3403,17,6384,09/30/11,2011-09-30,2011
NORTH CAROLINA,NORTH CAROLINA MIDDLE,NCM,FOURTH CIRCUIT,6279,3131,37,0,3111,307,212,35,0,60,5972,2919,2,3051,09/30/11,2011-09-30,2011
NORTH CAROLINA,NORTH CAROLINA WESTERN,NCW,FOURTH CIRCUIT,7799,5419,100,7,2273,386,270,92,7,17,7413,5149,8,2256,09/30/11,2011-09-30,2011
SOUTH CAROLINA,SOUTH CAROLINA,SC,FOURTH CIRCUIT,8406,4104,98,4,4199,406,304,75,4,22,8000,3800,23,4177,09/30/11,2011-09-30,2011
VIRGINIA,VIRGINIA EASTERN,VAE,FOURTH CIRCUIT,26504,17430,192,5,8877,755,546,163,5,41,25749,16884,29,8836,09/30/11,2011-09-30,2011
VIRGINIA,VIRGINIA WESTERN,VAW,FOURTH CIRCUIT,7968,5593,36,3,2336,185,138,32,3,12,7783,5455,4,2324,09/30/11,2011-09-30,2011
WEST VIRGINIA,WEST VIRGINIA NORTHERN,WVN,FOURTH CIRCUIT,2399,2077,21,1,300,120,83,16,1,20,2279,1994,5,280,09/30/11,2011-09-30,2011
WEST VIRGINIA,WEST VIRGINIA SOUTHERN,WVS,FOURTH CIRCUIT,2706,2353,38,1,314,103,60,37,1,5,2603,2293,1,309,09/30/11,2011-09-30,2011
LOUISIANA,LOUISIANA EASTERN,LAE,FIFTH CIRCUIT,4458,2386,45,0,2027,253,187,41,0,25,4205,2199,4,2002,09/30/11,2011-09-30,2011
LOUISIANA,LOUISIANA MIDDLE,LAM,FIFTH CIRCUIT,2093,1067,7,0,1019,81,71,6,0,4,2012,996,1,1015,09/30/11,2011-09-30,2011
LOUISIANA,LOUISIANA WESTERN,LAW,FIFTH CIRCUIT,11455,3080,45,13,8317,320,146,42,13,119,11135,2934,3,8198,09/30/11,2011-09-30,2011
MISSISSIPPI,MISSISSIPPI NORTHERN,MSN,FIFTH CIRCUIT,6217,3119,33,7,3058,173,118,33,7,15,6044,3001,0,3043,09/30/11,2011-09-30,2011
MISSISSIPPI,MISSISSIPPI SOUTHERN,MSS,FIFTH CIRCUIT,7737,4547,35,0,3155,229,176,35,0,18,7508,4371,0,3137,09/30/11,2011-09-30,2011
TEXAS,TEXAS NORTHERN,TXN,FIFTH CIRCUIT,19121,8672,334,12,10099,1285,801,328,12,140,17836,7871,6,9959,09/30/11,2011-09-30,2011
TEXAS,TEXAS EASTERN,TXE,FIFTH CIRCUIT,7120,3671,112,7,3330,527,366,108,7,46,6593,3305,4,3284,09/30/11,2011-09-30,2011
TEXAS,TEXAS SOUTHERN,TXS,FIFTH CIRCUIT,15305,6064,338,5,8896,1025,612,316,5,91,14280,5452,22,8805,09/30/11,2011-09-30,2011
TEXAS,TEXAS WESTERN,TXW,FIFTH CIRCUIT,12412,6456,217,6,5732,856,559,195,6,95,11556,5897,22,5637,09/30/11,2011-09-30,2011
KENTUCKY,KENTUCKY EASTERN,KYE,SIXTH CIRCUIT,11077,8222,32,2,2820,240,189,31,2,17,10837,8033,1,2803,09/30/11,2011-09-30,2011
KENTUCKY,KENTUCKY WESTERN,KYW,SIXTH CIRCUIT,11500,8565,44,6,2885,229,161,44,6,18,11271,8404,0,2867,09/30/11,2011-09-30,2011
MICHIGAN,MICHIGAN EASTERN,MIE,SIXTH CIRCUIT,46118,38189,183,10,7736,1179,932,163,10,74,44939,37257,20,7662,09/30/11,2011-09-30,2011
MICHIGAN,MICHIGAN WESTERN,MIW,SIXTH CIRCUIT,14483,12458,37,13,1975,516,429,35,13,39,13967,12029,2,1936,09/30/11,2011-09-30,2011
OHIO,OHIO NORTHERN,OHN,SIXTH CIRCUIT,32413,26350,83,2,5978,756,606,79,2,69,31657,25744,4,5909,09/30/11,2011-09-30,2011
OHIO,OHIO SOUTHERN,OHS,SIXTH CIRCUIT,28950,20133,58,12,8747,701,542,54,12,93,28249,19591,4,8654,09/30/11,2011-09-30,2011
TENNESSEE,TENNESSEE EASTERN,TNE,SIXTH CIRCUIT,16346,9955,79,14,6298,342,241,66,14,21,16004,9714,13,6277,09/30/11,2011-09-30,2011
TENNESSEE,TENNESSEE MIDDLE,TNM,SIXTH CIRCUIT,13508,7938,117,4,5449,404,306,77,4,17,13104,7632,40,5432,09/30/11,2011-09-30,2011
TENNESSEE,TENNESSEE WESTERN,TNW,SIXTH CIRCUIT,17877,5340,63,2,12472,281,188,58,2,33,17596,5152,5,12439,09/30/11,2011-09-30,2011
ILLINOIS,ILLINOIS NORTHERN,ILN,SEVENTH CIRCUIT,60976,45970,334,3,14668,1784,1438,300,3,43,59192,44532,34,14625,09/30/11,2011-09-30,2011
ILLINOIS,ILLINOIS CENTRAL,ILC,SEVENTH CIRCUIT,9170,7358,23,1,1788,204,160,23,1,20,8966,7198,0,1768,09/30/11,2011-09-30,2011
ILLINOIS,ILLINOIS SOUTHERN,ILS,SEVENTH CIRCUIT,5508,3451,10,3,2044,121,92,10,3,16,5387,3359,0,2028,09/30/11,2011-09-30,2011
INDIANA,INDIANA NORTHERN,INN,SEVENTH CIRCUIT,16477,13006,36,3,3432,278,213,35,3,27,16199,12793,1,3405,09/30/11,2011-09-30,2011
INDIANA,INDIANA SOUTHERN,INS,SEVENTH CIRCUIT,24727,17612,84,5,7026,487,361,80,5,41,24240,17251,4,6985,09/30/11,2011-09-30,2011
WISCONSIN,WISCONSIN EASTERN,WIE,SEVENTH CIRCUIT,19841,15120,49,12,4660,515,409,47,12,47,19326,14711,2,4613,09/30/11,2011-09-30,2011
WISCONSIN,WISCONSIN WESTERN,WIW,SEVENTH CIRCUIT,8319,7160,44,19,1096,320,232,34,19,35,7999,6928,10,1061,09/30/11,2011-09-30,2011
ARKANSAS,ARKANSAS EASTERN,ARE,EIGHTH CIRCUIT,9022,4434,31,3,4554,206,145,29,3,29,8816,4289,2,4525,09/30/11,2011-09-30,2011
ARKANSAS,ARKANSAS WESTERN,ARW,EIGHTH CIRCUIT,6265,3837,39,17,2372,237,154,38,17,28,6028,3683,1,2344,09/30/11,2011-09-30,2011
IOWA,IOWA NORTHERN,IAN,EIGHTH CIRCUIT,3053,2878,8,9,158,161,141,6,9,5,2892,2737,2,153,09/30/11,2011-09-30,2011
IOWA,IOWA SOUTHERN,IAS,EIGHTH CIRCUIT,5258,4681,18,4,555,197,174,17,4,2,5061,4507,1,553,09/30/11,2011-09-30,2011
MINNESOTA,MINNESOTA,MN,EIGHTH CIRCUIT,19919,16950,102,12,2855,723,569,99,12,43,19196,16381,3,2812,09/30/11,2011-09-30,2011
MISSOURI,MISSOURI EASTERN,MOE,EIGHTH CIRCUIT,16313,11813,33,4,4463,279,230,29,4,16,16034,11583,4,4447,09/30/11,2011-09-30,2011
MISSOURI,MISSOURI WESTERN,MOW,EIGHTH CIRCUIT,14127,10333,74,7,3713,397,291,69,7,30,13730,10042,5,3683,09/30/11,2011-09-30,2011
NEBRASKA,NEBRASKA,NE,EIGHTH CIRCUIT,7073,5031,52,15,1971,277,181,52,15,25,6796,4850,0,1946,09/30/11,2011-09-30,2011
NORTH DAKOTA,NORTH DAKOTA,ND,EIGHTH CIRCUIT,1354,1202,9,0,143,62,51,9,0,2,1292,1151,0,141,09/30/11,2011-09-30,2011
SOUTH DAKOTA,SOUTH DAKOTA,SD,EIGHTH CIRCUIT,1934,1738,8,6,182,95,68,6,6,15,1839,1670,2,167,09/30/11,2011-09-30,2011
ALASKA,ALASKA,AK,NINTH CIRCUIT,1019,857,4,2,156,62,45,4,2,11,957,812,0,145,09/30/11,2011-09-30,2011
ARIZONA,ARIZONA,AZ,NINTH CIRCUIT,39148,32920,474,11,5742,1382,970,348,11,52,37766,31950,126,5690,09/30/11,2011-09-30,2011
CALIFORNIA,CALIFORNIA NORTHERN,CAN,NINTH CIRCUIT,36663,23520,431,17,12690,1354,901,253,17,178,35309,22619,178,12512,09/30/11,2011-09-30,2011
CALIFORNIA,CALIFORNIA EASTERN,CAE,NINTH CIRCUIT,51481,40730,221,30,10500,1310,955,166,30,159,50171,39775,55,10341,09/30/11,2011-09-30,2011
CALIFORNIA,CALIFORNIA CENTRAL,CAC,NINTH CIRCUIT,139882,103674,1172,9,35024,4641,3599,808,9,223,135241,100075,364,34801,09/30/11,2011-09-30,2011
CALIFORNIA,CALIFORNIA SOUTHERN,CAS,NINTH CIRCUIT,22285,17722,159,2,4402,643,498,91,2,52,21642,17224,68,4350,09/30/11,2011-09-30,2011
HAWAII,HAWAII,HI,NINTH CIRCUIT,3566,2721,32,1,812,166,127,26,1,12,3400,2594,6,800,09/30/11,2011-09-30,2011
IDAHO,IDAHO,ID,NINTH CIRCUIT,7912,6927,61,13,910,304,234,51,13,5,7608,6693,10,905,09/30/11,2011-09-30,2011
MONTANA,MONTANA,MT,NINTH CIRCUIT,2705,2265,17,9,414,115,77,16,9,13,2590,2188,1,401,09/30/11,2011-09-30,2011
NEVADA,NEVADA,NV,NINTH CIRCUIT,26239,19942,482,5,5810,1018,648,336,5,29,25221,19294,146,5781,09/30/11,2011-09-30,2011
OREGON,OREGON,OR,NINTH CIRCUIT,18281,14278,60,18,3925,563,423,57,18,65,17718,13855,3,3860,09/30/11,2011-09-30,2011
WASHINGTON,WASHINGTON EASTERN,WAE,NINTH CIRCUIT,6490,5043,47,7,1393,217,145,43,7,22,6273,4898,4,1371,09/30/11,2011-09-30,2011
WASHINGTON,WASHINGTON WESTERN,WAW,NINTH CIRCUIT,26389,20403,262,5,5718,928,641,216,5,65,25461,19762,46,5653,09/30/11,2011-09-30,2011
GUAM,GUAM,GUAM,NINTH CIRCUIT,146,117,0,0,29,12,11,0,0,1,134,106,0,28,09/30/11,2011-09-30,2011
NORTHERN MARIANA ISLANDS,NORTHERN MARIANAS,NMI,NINTH CIRCUIT,4,3,0,0,1,1,1,0,0,0,3,2,0,1,09/30/11,2011-09-30,2011
COLORADO,COLORADO,CO,TENTH CIRCUIT,31092,25850,131,4,5107,1164,980,120,4,60,29928,24870,11,5047,09/30/11,2011-09-30,2011
KANSAS,KANSAS,KS,TENTH CIRCUIT,10402,7139,72,26,3165,322,194,65,26,37,10080,6945,7,3128,09/30/11,2011-09-30,2011
NEW MEXICO,NEW MEXICO,NM,TENTH CIRCUIT,5897,5368,57,2,470,229,168,50,2,9,5668,5200,7,461,09/30/11,2011-09-30,2011
OKLAHOMA,OKLAHOMA NORTHERN,OKN,TENTH CIRCUIT,3947,3515,8,2,422,130,115,8,2,5,3817,3400,0,417,09/30/11,2011-09-30,2011
OKLAHOMA,OKLAHOMA EASTERN,OKE,TENTH CIRCUIT,2118,1900,5,7,205,55,41,5,7,1,2063,1859,0,204,09/30/11,2011-09-30,2011
OKLAHOMA,OKLAHOMA WESTERN,OKW,TENTH CIRCUIT,7425,5762,42,9,1612,234,175,40,9,10,7191,5587,2,1602,09/30/11,2011-09-30,2011
UTAH,UTAH,UT,TENTH CIRCUIT,19046,12606,91,4,6345,644,516,80,4,44,18402,12090,11,6301,09/30/11,2011-09-30,2011
WYOMING,WYOMING,WY,TENTH CIRCUIT,1469,1209,16,1,243,81,61,14,1,5,1388,1148,2,238,09/30/11,2011-09-30,2011
ALABAMA,ALABAMA NORTHERN,ALN,ELEVENTH CIRCUIT,17830,8524,95,12,9199,416,305,81,12,18,17414,8219,14,9181,09/30/11,2011-09-30,2011
ALABAMA,ALABAMA MIDDLE,ALM,ELEVENTH CIRCUIT,7842,2194,40,4,5604,162,104,36,4,18,7680,2090,4,5586,09/30/11,2011-09-30,2011
ALABAMA,ALABAMA SOUTHERN,ALS,ELEVENTH CIRCUIT,5631,1879,43,2,3707,104,56,40,2,6,5527,1823,3,3701,09/30/11,2011-09-30,2011
FLORIDA,FLORIDA NORTHERN,FLN,ELEVENTH CIRCUIT,4692,4086,37,2,567,292,248,36,2,6,4400,3838,1,561,09/30/11,2011-09-30,2011
FLORIDA,FLORIDA MIDDLE,FLM,ELEVENTH CIRCUIT,56972,42692,627,17,13635,2494,1792,532,17,152,54478,40900,95,13483,09/30/11,2011-09-30,2011
FLORIDA,FLORIDA SOUTHERN,FLS,ELEVENTH CIRCUIT,38404,28260,354,6,9778,1411,1016,311,6,72,36993,27244,43,9706,09/30/11,2011-09-30,2011
GEORGIA,GEORGIA NORTHERN,GAN,ELEVENTH CIRCUIT,53825,30968,294,8,22555,1606,1254,261,8,83,52219,29714,33,22472,09/30/11,2011-09-30,2011
GEORGIA,GEORGIA MIDDLE,GAM,ELEVENTH CIRCUIT,12064,4642,51,30,7341,429,280,49,30,70,11635,4362,2,7271,09/30/11,2011-09-30,2011
GEORGIA,GEORGIA SOUTHERN,GAS,ELEVENTH CIRCUIT,9777,2313,77,8,7378,265,156,71,8,29,9512,2157,6,7349,09/30/11,2011-09-30,2011
DISTRICT OF COLUMBIA,DISTRICT OF COLUMBIA,DC,DC CIRCUIT,913,751,34,0,128,65,37,27,0,1,848,714,7,127,09/30/12,2012-09-30,2012
MAINE,MAINE,ME,FIRST CIRCUIT,3125,2662,26,8,429,197,139,24,8,26,2928,2523,2,403,09/30/12,2012-09-30,2012
MASSACHUSETTS,MASSACHUSETTS,MA,FIRST CIRCUIT,17793,13054,193,32,4513,466,262,148,32,23,17327,12792,45,4490,09/30/12,2012-09-30,2012
NEW HAMPSHIRE,NEW HAMPSHIRE,NH,FIRST CIRCUIT,4240,3195,32,0,1013,351,221,31,0,99,3889,2974,1,914,09/30/12,2012-09-30,2012
RHODE ISLAND,RHODE ISLAND,RI,FIRST CIRCUIT,4237,3560,25,0,652,167,128,24,0,15,4070,3432,1,637,09/30/12,2012-09-30,2012
PUERTO RICO,PUERTO RICO,PR,FIRST CIRCUIT,10727,3795,202,38,6692,431,141,181,38,71,10296,3654,21,6621,09/30/12,2012-09-30,2012
CONNECTICUT,CONNECTICUT,CT,SECOND CIRCUIT,8546,7423,133,7,983,376,235,108,7,26,8170,7188,25,957,09/30/12,2012-09-30,2012
NEW YORK,NEW YORK NORTHERN,NYN,SECOND CIRCUIT,8542,6740,42,23,1737,233,138,42,23,30,8309,6602,0,1707,09/30/12,2012-09-30,2012
NEW YORK,NEW YORK EASTERN,NYE,SECOND CIRCUIT,17721,15904,245,1,1570,651,401,231,1,17,17070,15503,14,1553,09/30/12,2012-09-30,2012
NEW YORK,NEW YORK SOUTHERN,NYS,SECOND CIRCUIT,11198,8702,861,2,1598,1221,315,843,2,26,9977,8387,18,1572,09/30/12,2012-09-30,2012
NEW YORK,NEW YORK WESTERN,NYW,SECOND CIRCUIT,6362,4629,41,2,1690,264,185,41,2,36,6098,4444,0,1654,09/30/12,2012-09-30,2012
VERMONT,VERMONT,VT,SECOND CIRCUIT,1052,826,3,4,219,65,45,3,4,13,987,781,0,206,09/30/12,2012-09-30,2012
DELAWARE,DELAWARE,DE,THIRD CIRCUIT,3879,2315,554,4,947,738,111,554,4,10,3141,2204,0,937,09/30/12,2012-09-30,2012
NEW JERSEY,NEW JERSEY,NJ,THIRD CIRCUIT,33431,25913,335,1,7182,1144,773,296,1,74,32287,25140,39,7108,09/30/12,2012-09-30,2012
PENNSYLVANIA,PENNSYLVANIA EASTERN,PAE,THIRD CIRCUIT,12550,8221,116,2,4211,452,272,107,2,71,12098,7949,9,4140,09/30/12,2012-09-30,2012
PENNSYLVANIA,PENNSYLVANIA MIDDLE,PAM,THIRD CIRCUIT,7751,5400,38,5,2307,245,161,36,5,42,7506,5239,2,2265,09/30/12,2012-09-30,2012
PENNSYLVANIA,PENNSYLVANIA WESTERN,PAW,THIRD CIRCUIT,9838,6955,130,9,2744,375,199,119,9,48,9463,6756,11,2696,09/30/12,2012-09-30,2012
VIRGIN ISLANDS,VIRGIN ISLANDS,VI,THIRD CIRCUIT,35,20,7,0,8,9,2,6,0,1,26,18,1,7,09/30/12,2012-09-30,2012
MARYLAND,MARYLAND,MD,FOURTH CIRCUIT,24064,19242,177,5,4640,616,432,140,5,39,23448,18810,37,4601,09/30/12,2012-09-30,2012
NORTH CAROLINA,NORTH CAROLINA EASTERN,NCE,FOURTH CIRCUIT,9472,3021,178,10,6263,482,255,157,10,60,8990,2766,21,6203,09/30/12,2012-09-30,2012
NORTH CAROLINA,NORTH CAROLINA MIDDLE,NCM,FOURTH CIRCUIT,5818,2540,23,2,3253,281,190,21,2,68,5537,2350,2,3185,09/30/12,2012-09-30,2012
NORTH CAROLINA,NORTH CAROLINA WESTERN,NCW,FOURTH CIRCUIT,6865,4415,77,7,2366,305,205,71,7,22,6560,4210,6,2344,09/30/12,2012-09-30,2012
SOUTH CAROLINA,SOUTH CAROLINA,SC,FOURTH CIRCUIT,8085,3572,83,4,4425,338,247,72,4,14,7747,3325,11,4411,09/30/12,2012-09-30,2012
VIRGINIA,VIRGINIA EASTERN,VAE,FOURTH CIRCUIT,23481,14982,126,0,8372,598,459,107,0,31,22883,14523,19,8341,09/30/12,2012-09-30,2012
VIRGINIA,VIRGINIA WESTERN,VAW,FOURTH CIRCUIT,7153,4923,25,1,2204,158,124,24,1,9,6995,4799,1,2195,09/30/12,2012-09-30,2012
WEST VIRGINIA,WEST VIRGINIA NORTHERN,WVN,FOURTH CIRCUIT,1795,1528,14,0,253,79,59,14,0,6,1716,1469,0,247,09/30/12,2012-09-30,2012
WEST VIRGINIA,WEST VIRGINIA SOUTHERN,WVS,FOURTH CIRCUIT,2310,2007,25,0,278,79,48,25,0,6,2231,1959,0,272,09/30/12,2012-09-30,2012
LOUISIANA,LOUISIANA EASTERN,LAE,FIFTH CIRCUIT,3984,2080,42,1,1860,228,173,36,1,17,3756,1907,6,1843,09/30/12,2012-09-30,2012
LOUISIANA,LOUISIANA MIDDLE,LAM,FIFTH CIRCUIT,1898,1018,15,1,864,72,54,15,1,2,1826,964,0,862,09/30/12,2012-09-30,2012
LOUISIANA,LOUISIANA WESTERN,LAW,FIFTH CIRCUIT,10462,2654,43,6,7759,242,113,42,6,81,10220,2541,1,7678,09/30/12,2012-09-30,2012
MISSISSIPPI,MISSISSIPPI NORTHERN,MSN,FIFTH CIRCUIT,5681,2640,33,4,3004,139,88,33,4,14,5542,2552,0,2990,09/30/12,2012-09-30,2012
MISSISSIPPI,MISSISSIPPI SOUTHERN,MSS,FIFTH CIRCUIT,7127,4031,46,1,3049,208,154,45,1,8,6919,3877,1,3041,09/30/12,2012-09-30,2012
TEXAS,TEXAS NORTHERN,TXN,FIFTH CIRCUIT,18084,7758,243,16,10067,999,642,231,16,110,17085,7116,12,9957,09/30/12,2012-09-30,2012
TEXAS,TEXAS EASTERN,TXE,FIFTH CIRCUIT,6433,3048,100,2,3283,466,320,96,2,48,5967,2728,4,3235,09/30/12,2012-09-30,2012
TEXAS,TEXAS SOUTHERN,TXS,FIFTH CIRCUIT,13459,5116,214,3,8123,782,506,196,3,74,12677,4610,18,8049,09/30/12,2012-09-30,2012
TEXAS,TEXAS WESTERN,TXW,FIFTH CIRCUIT,11338,5724,154,6,5454,732,500,147,6,79,10606,5224,7,5375,09/30/12,2012-09-30,2012
KENTUCKY,KENTUCKY EASTERN,KYE,SIXTH CIRCUIT,9822,7253,32,8,2529,197,144,30,8,15,9625,7109,2,2514,09/30/12,2012-09-30,2012
KENTUCKY,KENTUCKY WESTERN,KYW,SIXTH CIRCUIT,10626,7717,41,6,2862,243,179,38,6,20,10383,7538,3,2842,09/30/12,2012-09-30,2012
MICHIGAN,MICHIGAN EASTERN,MIE,SIXTH CIRCUIT,39146,32194,219,10,6719,919,637,198,10,70,38227,31557,21,6649,09/30/12,2012-09-30,2012
MICHIGAN,MICHIGAN WESTERN,MIW,SIXTH CIRCUIT,12362,10511,42,5,1804,429,342,38,5,44,11933,10169,4,1760,09/30/12,2012-09-30,2012
OHIO,OHIO NORTHERN,OHN,SIXTH CIRCUIT,26942,22005,53,5,4876,604,482,49,5,65,26338,21523,4,4811,09/30/12,2012-09-30,2012
OHIO,OHIO SOUTHERN,OHS,SIXTH CIRCUIT,25206,17609,41,1,7555,517,408,37,1,71,24689,17201,4,7484,09/30/12,2012-09-30,2012
TENNESSEE,TENNESSEE EASTERN,TNE,SIXTH CIRCUIT,14471,8304,64,12,6091,302,214,55,12,21,14169,8090,9,6070,09/30/12,2012-09-30,2012
TENNESSEE,TENNESSEE MIDDLE,TNM,SIXTH CIRCUIT,12334,7274,115,1,4944,309,217,76,1,15,12025,7057,39,4929,09/30/12,2012-09-30,2012
TENNESSEE,TENNESSEE WESTERN,TNW,SIXTH CIRCUIT,17830,4910,55,1,12864,192,116,46,1,29,17638,4794,9,12835,09/30/12,2012-09-30,2012
ILLINOIS,ILLINOIS NORTHERN,ILN,SEVENTH CIRCUIT,57289,40474,318,0,16497,1747,1388,291,0,68,55542,39086,27,16429,09/30/12,2012-09-30,2012
ILLINOIS,ILLINOIS CENTRAL,ILC,SEVENTH CIRCUIT,7829,6291,26,1,1511,172,134,25,1,12,7657,6157,1,1499,09/30/12,2012-09-30,2012
ILLINOIS,ILLINOIS SOUTHERN,ILS,SEVENTH CIRCUIT,4805,3073,14,1,1717,100,68,13,1,18,4705,3005,1,1699,09/30/12,2012-09-30,2012
INDIANA,INDIANA NORTHERN,INN,SEVENTH CIRCUIT,14560,11040,39,6,3475,214,148,37,6,23,14346,10892,2,3452,09/30/12,2012-09-30,2012
INDIANA,INDIANA SOUTHERN,INS,SEVENTH CIRCUIT,21909,15516,70,1,6322,458,355,67,1,35,21451,15161,3,6287,09/30/12,2012-09-30,2012
WISCONSIN,WISCONSIN EASTERN,WIE,SEVENTH CIRCUIT,18732,13660,46,17,5009,425,325,41,17,42,18307,13335,5,4967,09/30/12,2012-09-30,2012
WISCONSIN,WISCONSIN WESTERN,WIW,SEVENTH CIRCUIT,7225,6096,53,21,1055,307,208,47,21,31,6918,5888,6,1024,09/30/12,2012-09-30,2012
ARKANSAS,ARKANSAS EASTERN,ARE,EIGHTH CIRCUIT,7895,3744,26,3,4121,166,121,25,3,16,7729,3623,1,4105,09/30/12,2012-09-30,2012
ARKANSAS,ARKANSAS WESTERN,ARW,EIGHTH CIRCUIT,5160,3214,18,9,1918,213,153,18,9,32,4947,3061,0,1886,09/30/12,2012-09-30,2012
IOWA,IOWA NORTHERN,IAN,EIGHTH CIRCUIT,2506,2318,8,5,174,132,117,8,5,1,2374,2201,0,173,09/30/12,2012-09-30,2012
IOWA,IOWA SOUTHERN,IAS,EIGHTH CIRCUIT,4223,3773,11,2,436,165,147,10,2,6,4058,3626,1,430,09/30/12,2012-09-30,2012
MINNESOTA,MINNESOTA,MN,EIGHTH CIRCUIT,17666,14664,51,10,2938,622,519,47,10,43,17044,14145,4,2895,09/30/12,2012-09-30,2012
MISSOURI,MISSOURI EASTERN,MOE,EIGHTH CIRCUIT,15013,10968,36,1,4008,289,238,34,1,16,14724,10730,2,3992,09/30/12,2012-09-30,2012
MISSOURI,MISSOURI WESTERN,MOW,EIGHTH CIRCUIT,12199,8719,79,3,3398,337,236,77,3,21,11862,8483,2,3377,09/30/12,2012-09-30,2012
NEBRASKA,NEBRASKA,NE,EIGHTH CIRCUIT,5872,4108,20,6,1734,167,119,19,6,19,5705,3989,1,1715,09/30/12,2012-09-30,2012
NORTH DAKOTA,NORTH DAKOTA,ND,EIGHTH CIRCUIT,1060,936,3,1,120,34,30,3,1,0,1026,906,0,120,09/30/12,2012-09-30,2012
SOUTH DAKOTA,SOUTH DAKOTA,SD,EIGHTH CIRCUIT,1620,1469,4,3,144,67,53,4,3,7,1553,1416,0,137,09/30/12,2012-09-30,2012
ALASKA,ALASKA,AK,NINTH CIRCUIT,841,699,3,1,138,50,34,3,1,12,791,665,0,126,09/30/12,2012-09-30,2012
ARIZONA,ARIZONA,AZ,NINTH CIRCUIT,30135,25688,467,3,3974,1215,796,363,3,51,28920,24892,104,3923,09/30/12,2012-09-30,2012
CALIFORNIA,CALIFORNIA NORTHERN,CAN,NINTH CIRCUIT,28935,17684,264,22,10963,1105,766,158,22,157,27830,16918,106,10806,09/30/12,2012-09-30,2012
CALIFORNIA,CALIFORNIA EASTERN,CAE,NINTH CIRCUIT,39481,31303,203,40,7929,1100,757,151,40,146,38381,30546,52,7783,09/30/12,2012-09-30,2012
CALIFORNIA,CALIFORNIA CENTRAL,CAC,NINTH CIRCUIT,111909,85130,966,7,25803,3670,2864,628,7,168,108239,82266,338,25635,09/30/12,2012-09-30,2012
CALIFORNIA,CALIFORNIA SOUTHERN,CAS,NINTH CIRCUIT,18359,14564,113,1,3681,511,393,65,1,52,17848,14171,48,3629,09/30/12,2012-09-30,2012
HAWAII,HAWAII,HI,NINTH CIRCUIT,2672,2032,10,3,627,97,73,7,3,14,2575,1959,3,613,09/30/12,2012-09-30,2012
IDAHO,IDAHO,ID,NINTH CIRCUIT,6690,5906,34,14,736,268,209,28,14,17,6422,5697,6,719,09/30/12,2012-09-30,2012
MONTANA,MONTANA,MT,NINTH CIRCUIT,2175,1784,30,2,359,114,72,27,2,13,2061,1712,3,346,09/30/12,2012-09-30,2012
NEVADA,NEVADA,NV,NINTH CIRCUIT,19434,15299,378,1,3755,690,418,240,1,30,18744,14881,138,3725,09/30/12,2012-09-30,2012
OREGON,OREGON,OR,NINTH CIRCUIT,16048,12497,58,8,3485,453,317,58,8,70,15595,12180,0,3415,09/30/12,2012-09-30,2012
WASHINGTON,WASHINGTON EASTERN,WAE,NINTH CIRCUIT,5726,4534,18,5,1169,142,105,16,5,16,5584,4429,2,1153,09/30/12,2012-09-30,2012
WASHINGTON,WASHINGTON WESTERN,WAW,NINTH CIRCUIT,22955,18363,201,1,4390,797,585,165,1,46,22158,17778,36,4344,09/30/12,2012-09-30,2012
GUAM,GUAM,GUAM,NINTH CIRCUIT,153,119,2,0,32,6,4,2,0,0,147,115,0,32,09/30/12,2012-09-30,2012
NORTHERN MARIANA ISLANDS,NORTHERN MARIANAS,NMI,NINTH CIRCUIT,11,9,1,0,1,2,1,1,0,0,9,8,0,1,09/30/12,2012-09-30,2012
COLORADO,COLORADO,CO,TENTH CIRCUIT,27578,22808,126,2,4642,964,794,121,2,47,26614,22014,5,4595,09/30/12,2012-09-30,2012
KANSAS,KANSAS,KS,TENTH CIRCUIT,9301,6089,51,11,3150,235,147,49,11,28,9066,5942,2,3122,09/30/12,2012-09-30,2012
NEW MEXICO,NEW MEXICO,NM,TENTH CIRCUIT,4937,4454,43,1,439,185,144,36,1,4,4752,4310,7,435,09/30/12,2012-09-30,2012
OKLAHOMA,OKLAHOMA NORTHERN,OKN,TENTH CIRCUIT,3642,3228,9,2,403,127,113,8,2,4,3515,3115,1,399,09/30/12,2012-09-30,2012
OKLAHOMA,OKLAHOMA EASTERN,OKE,TENTH CIRCUIT,1903,1711,2,2,187,48,41,2,2,2,1855,1670,0,185,09/30/12,2012-09-30,2012
OKLAHOMA,OKLAHOMA WESTERN,OKW,TENTH CIRCUIT,6727,5312,20,6,1389,166,132,14,6,14,6561,5180,6,1375,09/30/12,2012-09-30,2012
UTAH,UTAH,UT,TENTH CIRCUIT,16545,11083,67,0,5395,436,348,59,0,29,16109,10735,8,5366,09/30/12,2012-09-30,2012
WYOMING,WYOMING,WY,TENTH CIRCUIT,1307,1104,15,2,186,78,58,13,2,5,1229,1046,2,181,09/30/12,2012-09-30,2012
ALABAMA,ALABAMA NORTHERN,ALN,ELEVENTH CIRCUIT,15901,7454,56,5,8384,289,218,48,5,16,15612,7236,8,8368,09/30/12,2012-09-30,2012
ALABAMA,ALABAMA MIDDLE,ALM,ELEVENTH CIRCUIT,7935,1917,21,2,5995,171,137,20,2,12,7764,1780,1,5983,09/30/12,2012-09-30,2012
ALABAMA,ALABAMA SOUTHERN,ALS,ELEVENTH CIRCUIT,4808,1519,34,0,3255,95,61,26,0,8,4713,1458,8,3247,09/30/12,2012-09-30,2012
FLORIDA,FLORIDA NORTHERN,FLN,ELEVENTH CIRCUIT,3887,3245,61,1,580,276,205,53,1,17,3611,3040,8,563,09/30/12,2012-09-30,2012
FLORIDA,FLORIDA MIDDLE,FLM,ELEVENTH CIRCUIT,47513,34611,518,15,12367,2028,1411,437,15,164,45485,33200,81,12203,09/30/12,2012-09-30,2012
FLORIDA,FLORIDA SOUTHERN,FLS,ELEVENTH CIRCUIT,32802,23288,317,1,9196,1085,752,281,1,51,31717,22536,36,9145,09/30/12,2012-09-30,2012
GEORGIA,GEORGIA NORTHERN,GAN,ELEVENTH CIRCUIT,47329,26560,263,12,20493,1434,1114,243,12,64,45895,25446,20,20429,09/30/12,2012-09-30,2012
GEORGIA,GEORGIA MIDDLE,GAM,ELEVENTH CIRCUIT,10726,4003,57,17,6649,362,241,54,17,50,10364,3762,3,6599,09/30/12,2012-09-30,2012
GEORGIA,GEORGIA SOUTHERN,GAS,ELEVENTH CIRCUIT,9024,2136,70,8,6808,228,125,68,8,25,8796,2011,2,6783,09/30/12,2012-09-30,2012
DISTRICT OF COLUMBIA,DISTRICT OF COLUMBIA,DC,DC CIRCUIT,855,696,35,0,124,64,31,30,0,3,791,665,5,121,09/30/13,2013-09-30,2013
MAINE,MAINE,ME,FIRST CIRCUIT,2575,2140,22,6,407,152,101,21,6,24,2423,2039,1,383,09/30/13,2013-09-30,2013
MASSACHUSETTS,MASSACHUSETTS,MA,FIRST CIRCUIT,13201,10323,130,26,2722,427,271,90,26,40,12774,10052,40,2682,09/30/13,2013-09-30,2013
NEW HAMPSHIRE,NEW HAMPSHIRE,NH,FIRST CIRCUIT,3376,2533,37,0,806,263,162,30,0,71,3113,2371,7,735,09/30/13,2013-09-30,2013
RHODE ISLAND,RHODE ISLAND,RI,FIRST CIRCUIT,3547,2989,13,0,545,130,109,12,0,9,3417,2880,1,536,09/30/13,2013-09-30,2013
PUERTO RICO,PUERTO RICO,PR,FIRST CIRCUIT,11043,3872,225,21,6925,417,144,196,21,56,10626,3728,29,6869,09/30/13,2013-09-30,2013
CONNECTICUT,CONNECTICUT,CT,SECOND CIRCUIT,7321,6235,115,2,969,326,210,101,2,13,6995,6025,14,956,09/30/13,2013-09-30,2013
NEW YORK,NEW YORK NORTHERN,NYN,SECOND CIRCUIT,7838,6219,34,8,1577,179,111,31,8,29,7659,6108,3,1548,09/30/13,2013-09-30,2013
NEW YORK,NEW YORK EASTERN,NYE,SECOND CIRCUIT,14314,12647,237,0,1426,585,333,227,0,21,13729,12314,10,1405,09/30/13,2013-09-30,2013
NEW YORK,NEW YORK SOUTHERN,NYS,SECOND CIRCUIT,9298,7487,369,1,1422,678,284,346,1,28,8620,7203,23,1394,09/30/13,2013-09-30,2013
NEW YORK,NEW YORK WESTERN,NYW,SECOND CIRCUIT,5742,4030,46,3,1663,212,132,45,3,32,5530,3898,1,1631,09/30/13,2013-09-30,2013
VERMONT,VERMONT,VT,SECOND CIRCUIT,933,742,1,1,188,36,30,1,1,4,897,712,0,184,09/30/13,2013-09-30,2013
DELAWARE,DELAWARE,DE,THIRD CIRCUIT,3581,1897,937,0,730,1083,123,937,0,6,2498,1774,0,724,09/30/13,2013-09-30,2013
NEW JERSEY,NEW JERSEY,NJ,THIRD CIRCUIT,28882,22149,293,1,6439,916,596,252,1,67,27966,21553,41,6372,09/30/13,2013-09-30,2013
PENNSYLVANIA,PENNSYLVANIA EASTERN,PAE,THIRD CIRCUIT,11973,7141,135,5,4691,470,274,128,5,62,11503,6867,7,4629,09/30/13,2013-09-30,2013
PENNSYLVANIA,PENNSYLVANIA MIDDLE,PAM,THIRD CIRCUIT,6855,4639,52,2,2162,220,127,49,2,42,6635,4512,3,2120,09/30/13,2013-09-30,2013
PENNSYLVANIA,PENNSYLVANIA WESTERN,PAW,THIRD CIRCUIT,8735,5782,106,7,2840,347,210,94,7,36,8388,5572,12,2804,09/30/13,2013-09-30,2013
VIRGIN ISLANDS,VIRGIN ISLANDS,VI,THIRD CIRCUIT,21,15,1,0,5,8,7,1,0,0,13,8,0,5,09/30/13,2013-09-30,2013
MARYLAND,MARYLAND,MD,FOURTH CIRCUIT,23193,17735,189,4,5265,570,379,143,4,44,22623,17356,46,5221,09/30/13,2013-09-30,2013
NORTH CAROLINA,NORTH CAROLINA EASTERN,NCE,FOURTH CIRCUIT,8429,2577,128,1,5723,309,164,106,1,38,8120,2413,22,5685,09/30/13,2013-09-30,2013
NORTH CAROLINA,NORTH CAROLINA MIDDLE,NCM,FOURTH CIRCUIT,5126,2162,22,2,2940,211,155,21,2,33,4915,2007,1,2907,09/30/13,2013-09-30,2013
NORTH CAROLINA,NORTH CAROLINA WESTERN,NCW,FOURTH CIRCUIT,5883,3480,57,4,2342,241,162,49,4,26,5642,3318,8,2316,09/30/13,2013-09-30,2013
SOUTH CAROLINA,SOUTH CAROLINA,SC,FOURTH CIRCUIT,7618,3150,64,4,4400,247,176,56,4,11,7371,2974,8,4389,09/30/13,2013-09-30,2013
VIRGINIA,VIRGINIA EASTERN,VAE,FOURTH CIRCUIT,20239,12398,156,1,7684,487,332,125,1,29,19752,12066,31,7655,09/30/13,2013-09-30,2013
VIRGINIA,VIRGINIA WESTERN,VAW,FOURTH CIRCUIT,6339,4208,31,3,2097,129,95,27,3,4,6210,4113,4,2093,09/30/13,2013-09-30,2013
WEST VIRGINIA,WEST VIRGINIA NORTHERN,WVN,FOURTH CIRCUIT,1627,1379,10,0,238,52,42,9,0,1,1575,1337,1,237,09/30/13,2013-09-30,2013
WEST VIRGINIA,WEST VIRGINIA SOUTHERN,WVS,FOURTH CIRCUIT,2138,1820,27,1,290,71,39,26,1,5,2067,1781,1,285,09/30/13,2013-09-30,2013
LOUISIANA,LOUISIANA EASTERN,LAE,FIFTH CIRCUIT,3764,1987,34,0,1743,206,155,33,0,18,3558,1832,1,1725,09/30/13,2013-09-30,2013
LOUISIANA,LOUISIANA MIDDLE,LAM,FIFTH CIRCUIT,1821,1030,9,0,782,51,41,9,0,1,1770,989,0,781,09/30/13,2013-09-30,2013
LOUISIANA,LOUISIANA WESTERN,LAW,FIFTH CIRCUIT,10387,2390,43,5,7949,134,77,34,5,18,10253,2313,9,7931,09/30/13,2013-09-30,2013
MISSISSIPPI,MISSISSIPPI NORTHERN,MSN,FIFTH CIRCUIT,5654,2371,26,3,3254,121,76,26,3,16,5533,2295,0,3238,09/30/13,2013-09-30,2013
MISSISSIPPI,MISSISSIPPI SOUTHERN,MSS,FIFTH CIRCUIT,7284,3937,21,1,3325,173,144,19,1,9,7111,3793,2,3316,09/30/13,2013-09-30,2013
TEXAS,TEXAS NORTHERN,TXN,FIFTH CIRCUIT,15353,6406,229,4,8713,843,527,217,4,94,14510,5879,12,8619,09/30/13,2013-09-30,2013
TEXAS,TEXAS EASTERN,TXE,FIFTH CIRCUIT,5942,2786,67,1,3088,370,282,60,1,27,5572,2504,7,3061,09/30/13,2013-09-30,2013
TEXAS,TEXAS SOUTHERN,TXS,FIFTH CIRCUIT,11480,4277,202,1,7000,628,375,194,1,58,10852,3902,8,6942,09/30/13,2013-09-30,2013
TEXAS,TEXAS WESTERN,TXW,FIFTH CIRCUIT,10005,5024,148,2,4831,645,438,134,2,71,9360,4586,14,4760,09/30/13,2013-09-30,2013
KENTUCKY,KENTUCKY EASTERN,KYE,SIXTH CIRCUIT,9278,6754,45,3,2476,183,116,43,3,21,9095,6638,2,2455,09/30/13,2013-09-30,2013
KENTUCKY,KENTUCKY WESTERN,KYW,SIXTH CIRCUIT,9394,6738,42,4,2608,194,126,41,4,21,9200,6612,1,2587,09/30/13,2013-09-30,2013
MICHIGAN,MICHIGAN EASTERN,MIE,SIXTH CIRCUIT,33146,26967,167,13,5998,704,472,149,13,69,32442,26495,18,5929,09/30/13,2013-09-30,2013
MICHIGAN,MICHIGAN WESTERN,MIW,SIXTH CIRCUIT,10886,9193,44,8,1641,353,276,40,8,29,10533,8917,4,1612,09/30/13,2013-09-30,2013
OHIO,OHIO NORTHERN,OHN,SIXTH CIRCUIT,26404,21235,54,5,5110,488,383,49,5,51,25916,20852,5,5059,09/30/13,2013-09-30,2013
OHIO,OHIO SOUTHERN,OHS,SIXTH CIRCUIT,22291,15759,49,7,6476,456,365,42,7,42,21835,15394,7,6434,09/30/13,2013-09-30,2013
TENNESSEE,TENNESSEE EASTERN,TNE,SIXTH CIRCUIT,13628,7502,60,7,6059,262,189,50,7,16,13366,7313,10,6043,09/30/13,2013-09-30,2013
TENNESSEE,TENNESSEE MIDDLE,TNM,SIXTH CIRCUIT,11633,6816,99,5,4713,261,180,65,5,11,11372,6636,34,4702,09/30/13,2013-09-30,2013
TENNESSEE,TENNESSEE WESTERN,TNW,SIXTH CIRCUIT,17649,4812,59,0,12778,163,90,51,0,22,17486,4722,8,12756,09/30/13,2013-09-30,2013
ILLINOIS,ILLINOIS NORTHERN,ILN,SEVENTH CIRCUIT,56300,37437,344,0,18519,1458,1077,303,0,78,54842,36360,41,18441,09/30/13,2013-09-30,2013
ILLINOIS,ILLINOIS CENTRAL,ILC,SEVENTH CIRCUIT,6940,5347,42,0,1551,163,110,40,0,13,6777,5237,2,1538,09/30/13,2013-09-30,2013
ILLINOIS,ILLINOIS SOUTHERN,ILS,SEVENTH CIRCUIT,4885,2978,12,2,1893,80,53,11,2,14,4805,2925,1,1879,09/30/13,2013-09-30,2013
INDIANA,INDIANA NORTHERN,INN,SEVENTH CIRCUIT,13907,10621,43,5,3238,214,141,40,5,28,13693,10480,3,3210,09/30/13,2013-09-30,2013
INDIANA,INDIANA SOUTHERN,INS,SEVENTH CIRCUIT,20588,14235,84,3,6265,428,323,77,3,24,20160,13912,7,6241,09/30/13,2013-09-30,2013
WISCONSIN,WISCONSIN EASTERN,WIE,SEVENTH CIRCUIT,17067,12310,29,4,4724,342,270,27,4,41,16725,12040,2,4683,09/30/13,2013-09-30,2013
WISCONSIN,WISCONSIN WESTERN,WIW,SEVENTH CIRCUIT,6406,5344,28,21,1013,233,158,23,21,31,6173,5186,5,982,09/30/13,2013-09-30,2013
ARKANSAS,ARKANSAS EASTERN,ARE,EIGHTH CIRCUIT,7847,3402,27,3,4414,145,102,25,3,14,7702,3300,2,4400,09/30/13,2013-09-30,2013
ARKANSAS,ARKANSAS WESTERN,ARW,EIGHTH CIRCUIT,4733,2711,29,11,1981,164,105,24,11,23,4569,2606,5,1958,09/30/13,2013-09-30,2013
IOWA,IOWA NORTHERN,IAN,EIGHTH CIRCUIT,2209,2073,3,5,128,81,71,2,5,3,2128,2002,1,125,09/30/13,2013-09-30,2013
IOWA,IOWA SOUTHERN,IAS,EIGHTH CIRCUIT,3683,3275,13,1,394,159,143,13,1,2,3524,3132,0,392,09/30/13,2013-09-30,2013
MINNESOTA,MINNESOTA,MN,EIGHTH CIRCUIT,15003,12442,64,11,2485,461,360,57,11,33,14542,12082,7,2452,09/30/13,2013-09-30,2013
MISSOURI,MISSOURI EASTERN,MOE,EIGHTH CIRCUIT,14970,10344,129,0,4496,336,198,127,0,10,14634,10146,2,4486,09/30/13,2013-09-30,2013
MISSOURI,MISSOURI WESTERN,MOW,EIGHTH CIRCUIT,10981,8084,41,4,2852,261,195,37,4,25,10720,7889,4,2827,09/30/13,2013-09-30,2013
NEBRASKA,NEBRASKA,NE,EIGHTH CIRCUIT,5362,3685,33,10,1632,166,109,31,10,14,5196,3576,2,1618,09/30/13,2013-09-30,2013
NORTH DAKOTA,NORTH DAKOTA,ND,EIGHTH CIRCUIT,872,782,4,0,86,36,30,4,0,2,836,752,0,84,09/30/13,2013-09-30,2013
SOUTH DAKOTA,SOUTH DAKOTA,SD,EIGHTH CIRCUIT,1366,1236,4,4,122,59,42,4,4,9,1307,1194,0,113,09/30/13,2013-09-30,2013
ALASKA,ALASKA,AK,NINTH CIRCUIT,638,509,8,0,110,63,34,8,0,10,575,475,0,100,09/30/13,2013-09-30,2013
ARIZONA,ARIZONA,AZ,NINTH CIRCUIT,24046,20554,340,2,3146,925,617,263,2,39,23121,19937,77,3107,09/30/13,2013-09-30,2013
CALIFORNIA,CALIFORNIA NORTHERN,CAN,NINTH CIRCUIT,21841,13028,255,15,8541,877,588,153,15,119,20964,12440,102,8422,09/30/13,2013-09-30,2013
CALIFORNIA,CALIFORNIA EASTERN,CAE,NINTH CIRCUIT,30685,24510,156,25,5994,889,665,106,25,93,29796,23845,50,5901,09/30/13,2013-09-30,2013
CALIFORNIA,CALIFORNIA CENTRAL,CAC,NINTH CIRCUIT,82861,66298,761,4,15797,2827,2154,536,4,132,80034,64144,225,15665,09/30/13,2013-09-30,2013
CALIFORNIA,CALIFORNIA SOUTHERN,CAS,NINTH CIRCUIT,13816,11027,86,0,2702,479,363,56,0,59,13337,10664,30,2643,09/30/13,2013-09-30,2013
HAWAII,HAWAII,HI,NINTH CIRCUIT,2313,1698,21,0,594,96,68,16,0,12,2217,1630,5,582,09/30/13,2013-09-30,2013
IDAHO,IDAHO,ID,NINTH CIRCUIT,5643,5094,28,5,516,174,140,22,5,7,5469,4954,6,509,09/30/13,2013-09-30,2013
MONTANA,MONTANA,MT,NINTH CIRCUIT,1851,1574,13,2,262,79,52,11,2,14,1772,1522,2,248,09/30/13,2013-09-30,2013
NEVADA,NEVADA,NV,NINTH CIRCUIT,14483,11781,283,2,2417,547,346,172,2,27,13936,11435,111,2390,09/30/13,2013-09-30,2013
OREGON,OREGON,OR,NINTH CIRCUIT,13677,11022,41,12,2602,377,267,36,12,62,13300,10755,5,2540,09/30/13,2013-09-30,2013
WASHINGTON,WASHINGTON EASTERN,WAE,NINTH CIRCUIT,5253,4172,27,1,1053,128,98,21,1,8,5125,4074,6,1045,09/30/13,2013-09-30,2013
WASHINGTON,WASHINGTON WESTERN,WAW,NINTH CIRCUIT,20477,16089,161,1,4224,653,486,120,1,44,19824,15603,41,4180,09/30/13,2013-09-30,2013
GUAM,GUAM,GUAM,NINTH CIRCUIT,159,129,1,0,28,9,6,1,0,1,150,123,0,27,09/30/13,2013-09-30,2013
NORTHERN MARIANA ISLANDS,NORTHERN MARIANAS,NMI,NINTH CIRCUIT,7,6,1,0,0,2,1,1,0,0,5,5,0,0,09/30/13,2013-09-30,2013
COLORADO,COLORADO,CO,TENTH CIRCUIT,23976,19937,146,4,3885,789,599,136,4,46,23187,19338,10,3839,09/30/13,2013-09-30,2013
KANSAS,KANSAS,KS,TENTH CIRCUIT,8604,5360,52,10,3182,190,104,46,10,30,8414,5256,6,3152,09/30/13,2013-09-30,2013
NEW MEXICO,NEW MEXICO,NM,TENTH CIRCUIT,4502,4052,39,1,410,155,115,33,1,6,4347,3937,6,404,09/30/13,2013-09-30,2013
OKLAHOMA,OKLAHOMA NORTHERN,OKN,TENTH CIRCUIT,3191,2821,5,1,364,91,81,5,1,4,3100,2740,0,360,09/30/13,2013-09-30,2013
OKLAHOMA,OKLAHOMA EASTERN,OKE,TENTH CIRCUIT,1657,1490,3,2,162,46,41,3,2,0,1611,1449,0,162,09/30/13,2013-09-30,2013
OKLAHOMA,OKLAHOMA WESTERN,OKW,TENTH CIRCUIT,6133,4855,22,12,1243,168,122,20,12,13,5965,4733,2,1230,09/30/13,2013-09-30,2013
UTAH,UTAH,UT,TENTH CIRCUIT,14939,10121,44,1,4773,307,245,38,1,23,14632,9876,6,4750,09/30/13,2013-09-30,2013
WYOMING,WYOMING,WY,TENTH CIRCUIT,1241,1087,16,0,138,76,57,15,0,4,1165,1030,1,134,09/30/13,2013-09-30,2013
ALABAMA,ALABAMA NORTHERN,ALN,ELEVENTH CIRCUIT,15058,7029,60,2,7967,290,220,52,2,16,14768,6809,8,7951,09/30/13,2013-09-30,2013
ALABAMA,ALABAMA MIDDLE,ALM,ELEVENTH CIRCUIT,7963,1821,29,4,6109,124,82,27,4,11,7839,1739,2,6098,09/30/13,2013-09-30,2013
ALABAMA,ALABAMA SOUTHERN,ALS,ELEVENTH CIRCUIT,4657,1402,19,0,3236,71,45,17,0,9,4586,1357,2,3227,09/30/13,2013-09-30,2013
FLORIDA,FLORIDA NORTHERN,FLN,ELEVENTH CIRCUIT,3415,2854,47,5,509,244,189,34,5,16,3171,2665,13,493,09/30/13,2013-09-30,2013
FLORIDA,FLORIDA MIDDLE,FLM,ELEVENTH CIRCUIT,42512,30528,464,13,11505,1747,1210,376,13,146,40765,29318,88,11359,09/30/13,2013-09-30,2013
FLORIDA,FLORIDA SOUTHERN,FLS,ELEVENTH CIRCUIT,31996,21435,301,5,10253,1000,671,258,5,64,30996,20764,43,10189,09/30/13,2013-09-30,2013
GEORGIA,GEORGIA NORTHERN,GAN,ELEVENTH CIRCUIT,41285,23386,241,11,17647,1156,833,231,11,81,40129,22553,10,17566,09/30/13,2013-09-30,2013
GEORGIA,GEORGIA MIDDLE,GAM,ELEVENTH CIRCUIT,10276,3630,43,7,6596,280,188,41,7,44,9996,3442,2,6552,09/30/13,2013-09-30,2013
GEORGIA,GEORGIA SOUTHERN,GAS,ELEVENTH CIRCUIT,8744,1961,52,2,6729,182,118,50,2,12,8562,1843,2,6717,09/30/13,2013-09-30,2013
DISTRICT OF COLUMBIA,DISTRICT OF COLUMBIA,DC,DC CIRCUIT,783,630,45,0,108,79,32,42,0,5,704,598,3,103,09/30/14,2014-09-30,2014
MAINE,MAINE,ME,FIRST CIRCUIT,2135,1754,13,8,360,109,65,11,8,25,2026,1689,2,335,09/30/14,2014-09-30,2014
MASSACHUSETTS,MASSACHUSETTS,MA,FIRST CIRCUIT,10789,8457,115,17,2200,462,310,97,17,38,10327,8147,18,2162,09/30/14,2014-09-30,2014
NEW HAMPSHIRE,NEW HAMPSHIRE,NH,FIRST CIRCUIT,2704,2067,29,2,606,204,144,25,2,33,2500,1923,4,573,09/30/14,2014-09-30,2014
RHODE ISLAND,RHODE ISLAND,RI,FIRST CIRCUIT,3124,2618,4,0,502,104,94,4,0,6,3020,2524,0,496,09/30/14,2014-09-30,2014
PUERTO RICO,PUERTO RICO,PR,FIRST CIRCUIT,11377,4366,205,27,6779,374,118,175,27,54,11003,4248,30,6725,09/30/14,2014-09-30,2014
CONNECTICUT,CONNECTICUT,CT,SECOND CIRCUIT,7001,5836,94,1,1070,292,204,75,1,12,6709,5632,19,1058,09/30/14,2014-09-30,2014
NEW YORK,NEW YORK NORTHERN,NYN,SECOND CIRCUIT,7177,5683,19,11,1464,143,94,18,11,20,7034,5589,1,1444,09/30/14,2014-09-30,2014
NEW YORK,NEW YORK EASTERN,NYE,SECOND CIRCUIT,12936,11094,219,3,1614,536,303,203,3,21,12400,10791,16,1593,09/30/14,2014-09-30,2014
NEW YORK,NEW YORK SOUTHERN,NYS,SECOND CIRCUIT,8438,6559,452,1,1405,740,256,427,1,35,7698,6303,25,1370,09/30/14,2014-09-30,2014
NEW YORK,NEW YORK WESTERN,NYW,SECOND CIRCUIT,4954,3596,43,4,1311,186,112,42,4,28,4768,3484,1,1283,09/30/14,2014-09-30,2014
VERMONT,VERMONT,VT,SECOND CIRCUIT,769,593,4,1,171,48,32,4,1,11,721,561,0,160,09/30/14,2014-09-30,2014
DELAWARE,DELAWARE,DE,THIRD CIRCUIT,3070,1755,539,3,748,687,112,539,3,8,2383,1643,0,740,09/30/14,2014-09-30,2014
NEW JERSEY,NEW JERSEY,NJ,THIRD CIRCUIT,27931,20649,336,3,6939,881,526,287,3,61,27050,20123,49,6878,09/30/14,2014-09-30,2014
PENNSYLVANIA,PENNSYLVANIA EASTERN,PAE,THIRD CIRCUIT,10610,6129,109,4,4368,367,206,100,4,57,10243,5923,9,4311,09/30/14,2014-09-30,2014
PENNSYLVANIA,PENNSYLVANIA MIDDLE,PAM,THIRD CIRCUIT,6208,4041,43,1,2123,225,135,40,1,49,5983,3906,3,2074,09/30/14,2014-09-30,2014
PENNSYLVANIA,PENNSYLVANIA WESTERN,PAW,THIRD CIRCUIT,7717,5127,99,7,2484,240,118,82,7,33,7477,5009,17,2451,09/30/14,2014-09-30,2014
VIRGIN ISLANDS,VIRGIN ISLANDS,VI,THIRD CIRCUIT,24,16,0,0,8,3,3,0,0,0,21,13,0,8,09/30/14,2014-09-30,2014
MARYLAND,MARYLAND,MD,FOURTH CIRCUIT,21006,15202,141,2,5661,461,308,105,2,46,20545,14894,36,5615,09/30/14,2014-09-30,2014
NORTH CAROLINA,NORTH CAROLINA EASTERN,NCE,FOURTH CIRCUIT,7686,2306,117,4,5259,286,145,98,4,39,7400,2161,19,5220,09/30/14,2014-09-30,2014
NORTH CAROLINA,NORTH CAROLINA MIDDLE,NCM,FOURTH CIRCUIT,4522,1908,26,3,2585,138,103,23,3,9,4384,1805,3,2576,09/30/14,2014-09-30,2014
NORTH CAROLINA,NORTH CAROLINA WESTERN,NCW,FOURTH CIRCUIT,4875,2743,38,0,2094,165,114,35,0,16,4710,2629,3,2078,09/30/14,2014-09-30,2014
SOUTH CAROLINA,SOUTH CAROLINA,SC,FOURTH CIRCUIT,7524,3072,33,4,4414,201,157,26,4,13,7323,2915,7,4401,09/30/14,2014-09-30,2014
VIRGINIA,VIRGINIA EASTERN,VAE,FOURTH CIRCUIT,18634,11146,142,1,7345,484,328,129,1,26,18150,10818,13,7319,09/30/14,2014-09-30,2014
VIRGINIA,VIRGINIA WESTERN,VAW,FOURTH CIRCUIT,5932,3963,12,2,1955,110,87,10,2,11,5822,3876,2,1944,09/30/14,2014-09-30,2014
WEST VIRGINIA,WEST VIRGINIA NORTHERN,WVN,FOURTH CIRCUIT,1455,1250,8,0,197,45,32,8,0,5,1410,1218,0,192,09/30/14,2014-09-30,2014
WEST VIRGINIA,WEST VIRGINIA SOUTHERN,WVS,FOURTH CIRCUIT,1969,1712,31,2,224,68,33,29,2,4,1901,1679,2,220,09/30/14,2014-09-30,2014
LOUISIANA,LOUISIANA EASTERN,LAE,FIFTH CIRCUIT,3623,1733,35,0,1855,171,126,33,0,12,3452,1607,2,1843,09/30/14,2014-09-30,2014
LOUISIANA,LOUISIANA MIDDLE,LAM,FIFTH CIRCUIT,1662,854,10,0,798,43,30,10,0,3,1619,824,0,795,09/30/14,2014-09-30,2014
LOUISIANA,LOUISIANA WESTERN,LAW,FIFTH CIRCUIT,10170,2018,71,7,8074,158,68,67,7,16,10012,1950,4,8058,09/30/14,2014-09-30,2014
MISSISSIPPI,MISSISSIPPI NORTHERN,MSN,FIFTH CIRCUIT,5047,2099,30,2,2916,104,63,30,2,9,4943,2036,0,2907,09/30/14,2014-09-30,2014
MISSISSIPPI,MISSISSIPPI SOUTHERN,MSS,FIFTH CIRCUIT,6431,3373,33,2,3022,189,150,30,2,6,6242,3223,3,3016,09/30/14,2014-09-30,2014
TEXAS,TEXAS NORTHERN,TXN,FIFTH CIRCUIT,13401,5495,199,11,7696,740,464,190,11,75,12661,5031,9,7621,09/30/14,2014-09-30,2014
TEXAS,TEXAS EASTERN,TXE,FIFTH CIRCUIT,5138,2457,65,2,2614,319,236,60,2,21,4819,2221,5,2593,09/30/14,2014-09-30,2014
TEXAS,TEXAS SOUTHERN,TXS,FIFTH CIRCUIT,9796,3663,169,6,5958,577,358,155,6,58,9219,3305,14,5900,09/30/14,2014-09-30,2014
TEXAS,TEXAS WESTERN,TXW,FIFTH CIRCUIT,8627,4176,82,0,4369,510,385,76,0,49,8117,3791,6,4320,09/30/14,2014-09-30,2014
KENTUCKY,KENTUCKY EASTERN,KYE,SIXTH CIRCUIT,8719,6303,18,3,2395,150,116,17,3,14,8569,6187,1,2381,09/30/14,2014-09-30,2014
KENTUCKY,KENTUCKY WESTERN,KYW,SIXTH CIRCUIT,8738,6428,36,2,2272,131,79,35,2,15,8607,6349,1,2257,09/30/14,2014-09-30,2014
MICHIGAN,MICHIGAN EASTERN,MIE,SIXTH CIRCUIT,27872,22362,131,16,5363,485,304,117,16,48,27387,22058,14,5315,09/30/14,2014-09-30,2014
MICHIGAN,MICHIGAN WESTERN,MIW,SIXTH CIRCUIT,8970,7497,37,4,1432,245,177,37,4,27,8725,7320,0,1405,09/30/14,2014-09-30,2014
OHIO,OHIO NORTHERN,OHN,SIXTH CIRCUIT,22600,18606,40,0,3954,404,326,35,0,43,22196,18280,5,3911,09/30/14,2014-09-30,2014
OHIO,OHIO SOUTHERN,OHS,SIXTH CIRCUIT,19857,14025,37,1,5794,378,300,35,1,42,19479,13725,2,5752,09/30/14,2014-09-30,2014
TENNESSEE,TENNESSEE EASTERN,TNE,SIXTH CIRCUIT,12389,6814,49,3,5523,159,110,38,3,8,12230,6704,11,5515,09/30/14,2014-09-30,2014
TENNESSEE,TENNESSEE MIDDLE,TNM,SIXTH CIRCUIT,10517,6040,83,1,4393,220,158,57,1,4,10297,5882,26,4389,09/30/14,2014-09-30,2014
TENNESSEE,TENNESSEE WESTERN,TNW,SIXTH CIRCUIT,17212,4256,38,0,12918,139,91,34,0,14,17073,4165,4,12904,09/30/14,2014-09-30,2014
ILLINOIS,ILLINOIS NORTHERN,ILN,SEVENTH CIRCUIT,51673,32630,237,2,18804,1166,871,212,2,81,50507,31759,25,18723,09/30/14,2014-09-30,2014
ILLINOIS,ILLINOIS CENTRAL,ILC,SEVENTH CIRCUIT,6073,4923,10,2,1138,112,91,9,2,10,5961,4832,1,1128,09/30/14,2014-09-30,2014
ILLINOIS,ILLINOIS SOUTHERN,ILS,SEVENTH CIRCUIT,4208,2715,13,0,1480,78,54,13,0,11,4130,2661,0,1469,09/30/14,2014-09-30,2014
INDIANA,INDIANA NORTHERN,INN,SEVENTH CIRCUIT,11952,9102,24,0,2826,172,133,20,0,19,11780,8969,4,2807,09/30/14,2014-09-30,2014
INDIANA,INDIANA SOUTHERN,INS,SEVENTH CIRCUIT,18147,12534,81,3,5529,326,221,78,3,24,17821,12313,3,5505,09/30/14,2014-09-30,2014
WISCONSIN,WISCONSIN EASTERN,WIE,SEVENTH CIRCUIT,16056,11620,25,6,4405,277,218,21,6,32,15779,11402,4,4373,09/30/14,2014-09-30,2014
WISCONSIN,WISCONSIN WESTERN,WIW,SEVENTH CIRCUIT,5632,4733,31,15,853,206,140,26,15,25,5426,4593,5,828,09/30/14,2014-09-30,2014
ARKANSAS,ARKANSAS EASTERN,ARE,EIGHTH CIRCUIT,7280,3156,9,5,4110,115,76,7,5,27,7165,3080,2,4083,09/30/14,2014-09-30,2014
ARKANSAS,ARKANSAS WESTERN,ARW,EIGHTH CIRCUIT,4057,2237,33,7,1778,145,90,30,7,16,3912,2147,3,1762,09/30/14,2014-09-30,2014
IOWA,IOWA NORTHERN,IAN,EIGHTH CIRCUIT,2056,1933,5,3,115,71,62,5,3,1,1985,1871,0,114,09/30/14,2014-09-30,2014
IOWA,IOWA SOUTHERN,IAS,EIGHTH CIRCUIT,3211,2859,11,1,340,109,91,10,1,7,3102,2768,1,333,09/30/14,2014-09-30,2014
MINNESOTA,MINNESOTA,MN,EIGHTH CIRCUIT,12704,10705,45,5,1949,428,359,44,5,20,12276,10346,1,1929,09/30/14,2014-09-30,2014
MISSOURI,MISSOURI EASTERN,MOE,EIGHTH CIRCUIT,12453,8711,33,1,3707,192,148,31,1,11,12261,8563,2,3696,09/30/14,2014-09-30,2014
MISSOURI,MISSOURI WESTERN,MOW,EIGHTH CIRCUIT,9226,6627,45,4,2550,194,133,43,4,14,9032,6494,2,2536,09/30/14,2014-09-30,2014
NEBRASKA,NEBRASKA,NE,EIGHTH CIRCUIT,4817,3285,13,8,1509,119,84,13,8,12,4698,3201,0,1497,09/30/14,2014-09-30,2014
NORTH DAKOTA,NORTH DAKOTA,ND,EIGHTH CIRCUIT,707,629,3,1,74,27,20,3,1,3,680,609,0,71,09/30/14,2014-09-30,2014
SOUTH DAKOTA,SOUTH DAKOTA,SD,EIGHTH CIRCUIT,1235,1115,5,0,115,48,33,5,0,10,1187,1082,0,105,09/30/14,2014-09-30,2014
ALASKA,ALASKA,AK,NINTH CIRCUIT,458,384,2,1,71,46,35,2,1,8,412,349,0,63,09/30/14,2014-09-30,2014
ARIZONA,ARIZONA,AZ,NINTH CIRCUIT,20907,17982,297,8,2620,716,469,219,8,20,20191,17513,78,2600,09/30/14,2014-09-30,2014
CALIFORNIA,CALIFORNIA NORTHERN,CAN,NINTH CIRCUIT,15430,9331,216,14,5868,779,495,154,14,115,14651,8836,62,5753,09/30/14,2014-09-30,2014
CALIFORNIA,CALIFORNIA EASTERN,CAE,NINTH CIRCUIT,22383,18246,99,18,4020,624,438,70,18,98,21759,17808,29,3922,09/30/14,2014-09-30,2014
CALIFORNIA,CALIFORNIA CENTRAL,CAC,NINTH CIRCUIT,60545,48574,559,3,11408,2194,1721,363,3,106,58351,46853,196,11302,09/30/14,2014-09-30,2014
CALIFORNIA,CALIFORNIA SOUTHERN,CAS,NINTH CIRCUIT,10992,8878,72,0,2041,412,307,55,0,49,10580,8571,17,1992,09/30/14,2014-09-30,2014
HAWAII,HAWAII,HI,NINTH CIRCUIT,1805,1271,10,1,523,68,51,6,1,10,1737,1220,4,513,09/30/14,2014-09-30,2014
IDAHO,IDAHO,ID,NINTH CIRCUIT,4976,4480,19,7,470,152,118,18,7,9,4824,4362,1,461,09/30/14,2014-09-30,2014
MONTANA,MONTANA,MT,NINTH CIRCUIT,1625,1412,15,1,197,86,64,15,1,6,1539,1348,0,191,09/30/14,2014-09-30,2014
NEVADA,NEVADA,NV,NINTH CIRCUIT,11676,9556,224,2,1889,432,267,140,2,19,11244,9289,84,1870,09/30/14,2014-09-30,2014
OREGON,OREGON,OR,NINTH CIRCUIT,12660,10337,36,2,2285,286,216,30,2,38,12374,10121,6,2247,09/30/14,2014-09-30,2014
WASHINGTON,WASHINGTON EASTERN,WAE,NINTH CIRCUIT,4840,3872,21,2,945,104,75,17,2,10,4736,3797,4,935,09/30/14,2014-09-30,2014
WASHINGTON,WASHINGTON WESTERN,WAW,NINTH CIRCUIT,17380,13640,135,3,3601,521,378,99,3,40,16859,13262,36,3561,09/30/14,2014-09-30,2014
GUAM,GUAM,GUAM,NINTH CIRCUIT,147,114,0,0,33,6,6,0,0,0,141,108,0,33,09/30/14,2014-09-30,2014
NORTHERN MARIANA ISLANDS,NORTHERN MARIANAS,NMI,NINTH CIRCUIT,5,5,0,0,0,0,0,0,0,0,5,5,0,0,09/30/14,2014-09-30,2014
COLORADO,COLORADO,CO,TENTH CIRCUIT,18460,15568,75,2,2813,521,419,69,2,29,17939,15149,6,2784,09/30/14,2014-09-30,2014
KANSAS,KANSAS,KS,TENTH CIRCUIT,7720,4603,31,9,3077,209,140,29,9,31,7511,4463,2,3046,09/30/14,2014-09-30,2014
NEW MEXICO,NEW MEXICO,NM,TENTH CIRCUIT,3956,3631,36,0,289,131,95,33,0,3,3825,3536,3,286,09/30/14,2014-09-30,2014
OKLAHOMA,OKLAHOMA NORTHERN,OKN,TENTH CIRCUIT,2915,2625,3,1,286,73,69,3,1,0,2842,2556,0,286,09/30/14,2014-09-30,2014
OKLAHOMA,OKLAHOMA EASTERN,OKE,TENTH CIRCUIT,1551,1418,5,2,126,24,18,4,2,0,1527,1400,1,126,09/30/14,2014-09-30,2014
OKLAHOMA,OKLAHOMA WESTERN,OKW,TENTH CIRCUIT,5603,4399,22,4,1178,120,89,21,4,6,5483,4310,1,1172,09/30/14,2014-09-30,2014
UTAH,UTAH,UT,TENTH CIRCUIT,13828,8927,19,0,4882,239,204,17,0,18,13589,8723,2,4864,09/30/14,2014-09-30,2014
WYOMING,WYOMING,WY,TENTH CIRCUIT,1031,902,10,1,118,49,35,10,1,3,982,867,0,115,09/30/14,2014-09-30,2014
ALABAMA,ALABAMA NORTHERN,ALN,ELEVENTH CIRCUIT,13220,6586,47,0,6587,239,188,41,0,10,12981,6398,6,6577,09/30/14,2014-09-30,2014
ALABAMA,ALABAMA MIDDLE,ALM,ELEVENTH CIRCUIT,7916,1628,8,0,6280,93,79,7,0,7,7823,1549,1,6273,09/30/14,2014-09-30,2014
ALABAMA,ALABAMA SOUTHERN,ALS,ELEVENTH CIRCUIT,4383,1303,30,1,3049,78,45,24,1,8,4305,1258,6,3041,09/30/14,2014-09-30,2014
FLORIDA,FLORIDA NORTHERN,FLN,ELEVENTH CIRCUIT,3062,2467,44,4,547,183,129,40,4,10,2879,2338,4,537,09/30/14,2014-09-30,2014
FLORIDA,FLORIDA MIDDLE,FLM,ELEVENTH CIRCUIT,36694,25526,391,18,10754,1408,957,321,18,109,35286,24569,70,10645,09/30/14,2014-09-30,2014
FLORIDA,FLORIDA SOUTHERN,FLS,ELEVENTH CIRCUIT,30424,17935,294,10,12183,778,502,214,10,50,29646,17433,80,12133,09/30/14,2014-09-30,2014
GEORGIA,GEORGIA NORTHERN,GAN,ELEVENTH CIRCUIT,35643,19916,169,13,15545,873,653,161,13,46,34770,19263,8,15499,09/30/14,2014-09-30,2014
GEORGIA,GEORGIA MIDDLE,GAM,ELEVENTH CIRCUIT,9489,3032,44,9,6404,211,132,43,9,27,9278,2900,1,6377,09/30/14,2014-09-30,2014
GEORGIA,GEORGIA SOUTHERN,GAS,ELEVENTH CIRCUIT,8409,1833,23,2,6551,119,87,19,2,11,8290,1746,4,6540,09/30/14,2014-09-30,2014
DISTRICT OF COLUMBIA,DISTRICT OF COLUMBIA,DC,DC CIRCUIT,723,573,19,0,131,51,33,16,0,2,672,540,3,129,09/30/15,2015-09-30,2015
MAINE,MAINE,ME,FIRST CIRCUIT,1930,1606,13,7,303,125,88,12,7,17,1805,1518,1,286,09/30/15,2015-09-30,2015
MASSACHUSETTS,MASSACHUSETTS,MA,FIRST CIRCUIT,9280,6930,109,12,2229,402,277,77,12,36,8878,6653,32,2193,09/30/15,2015-09-30,2015
NEW HAMPSHIRE,NEW HAMPSHIRE,NH,FIRST CIRCUIT,2211,1654,24,1,532,145,87,23,1,34,2066,1567,1,498,09/30/15,2015-09-30,2015
RHODE ISLAND,RHODE ISLAND,RI,FIRST CIRCUIT,2611,2167,9,0,434,91,80,6,0,4,2520,2087,3,430,09/30/15,2015-09-30,2015
PUERTO RICO,PUERTO RICO,PR,FIRST CIRCUIT,10533,4343,157,17,6016,311,123,132,17,39,10222,4220,25,5977,09/30/15,2015-09-30,2015
CONNECTICUT,CONNECTICUT,CT,SECOND CIRCUIT,6486,5264,98,2,1122,240,144,84,2,10,6246,5120,14,1112,09/30/15,2015-09-30,2015
NEW YORK,NEW YORK NORTHERN,NYN,SECOND CIRCUIT,6671,5159,42,11,1459,169,89,41,11,28,6502,5070,1,1431,09/30/15,2015-09-30,2015
NEW YORK,NEW YORK EASTERN,NYE,SECOND CIRCUIT,11663,9317,246,3,2097,550,308,216,3,23,11113,9009,30,2074,09/30/15,2015-09-30,2015
NEW YORK,NEW YORK SOUTHERN,NYS,SECOND CIRCUIT,7795,5794,465,3,1488,747,226,444,3,29,7048,5568,21,1459,09/30/15,2015-09-30,2015
NEW YORK,NEW YORK WESTERN,NYW,SECOND CIRCUIT,4553,3206,48,2,1297,180,97,48,2,33,4373,3109,0,1264,09/30/15,2015-09-30,2015
VERMONT,VERMONT,VT,SECOND CIRCUIT,664,520,0,4,140,39,30,0,4,5,625,490,0,135,09/30/15,2015-09-30,2015
DELAWARE,DELAWARE,DE,THIRD CIRCUIT,2699,1593,396,0,701,553,140,395,0,9,2146,1453,1,692,09/30/15,2015-09-30,2015
NEW JERSEY,NEW JERSEY,NJ,THIRD CIRCUIT,25652,18194,247,0,7211,727,465,194,0,68,24925,17729,53,7143,09/30/15,2015-09-30,2015
PENNSYLVANIA,PENNSYLVANIA EASTERN,PAE,THIRD CIRCUIT,9583,5326,104,2,4151,309,150,98,2,59,9274,5176,6,4092,09/30/15,2015-09-30,2015
PENNSYLVANIA,PENNSYLVANIA MIDDLE,PAM,THIRD CIRCUIT,5797,3719,49,2,2027,194,101,48,2,43,5603,3618,1,1984,09/30/15,2015-09-30,2015
PENNSYLVANIA,PENNSYLVANIA WESTERN,PAW,THIRD CIRCUIT,7136,4671,69,6,2390,243,147,60,6,30,6893,4524,9,2360,09/30/15,2015-09-30,2015
VIRGIN ISLANDS,VIRGIN ISLANDS,VI,THIRD CIRCUIT,20,13,2,0,5,5,3,2,0,0,15,10,0,5,09/30/15,2015-09-30,2015
MARYLAND,MARYLAND,MD,FOURTH CIRCUIT,18521,13020,180,1,5320,484,303,135,1,45,18037,12717,45,5275,09/30/15,2015-09-30,2015
NORTH CAROLINA,NORTH CAROLINA EASTERN,NCE,FOURTH CIRCUIT,7308,2236,96,10,4966,248,131,64,10,43,7060,2105,32,4923,09/30/15,2015-09-30,2015
NORTH CAROLINA,NORTH CAROLINA MIDDLE,NCM,FOURTH CIRCUIT,4269,1785,20,0,2464,118,91,18,0,9,4151,1694,2,2455,09/30/15,2015-09-30,2015
NORTH CAROLINA,NORTH CAROLINA WESTERN,NCW,FOURTH CIRCUIT,4317,2367,36,2,1912,160,108,30,2,20,4157,2259,6,1892,09/30/15,2015-09-30,2015
SOUTH CAROLINA,SOUTH CAROLINA,SC,FOURTH CIRCUIT,7080,2828,30,0,4222,175,133,23,0,19,6905,2695,7,4203,09/30/15,2015-09-30,2015
VIRGINIA,VIRGINIA EASTERN,VAE,FOURTH CIRCUIT,17633,10256,301,2,7074,571,262,283,2,24,17062,9994,18,7050,09/30/15,2015-09-30,2015
VIRGINIA,VIRGINIA WESTERN,VAW,FOURTH CIRCUIT,5585,3544,48,5,1988,142,82,46,5,9,5443,3462,2,1979,09/30/15,2015-09-30,2015
WEST VIRGINIA,WEST VIRGINIA NORTHERN,WVN,FOURTH CIRCUIT,1316,1116,8,1,191,46,37,7,1,1,1270,1079,1,190,09/30/15,2015-09-30,2015
WEST VIRGINIA,WEST VIRGINIA SOUTHERN,WVS,FOURTH CIRCUIT,1925,1652,16,1,256,60,40,15,1,4,1865,1612,1,252,09/30/15,2015-09-30,2015
LOUISIANA,LOUISIANA EASTERN,LAE,FIFTH CIRCUIT,3446,1493,30,1,1922,127,88,29,1,9,3319,1405,1,1913,09/30/15,2015-09-30,2015
LOUISIANA,LOUISIANA MIDDLE,LAM,FIFTH CIRCUIT,1615,796,10,0,809,52,42,8,0,2,1563,754,2,807,09/30/15,2015-09-30,2015
LOUISIANA,LOUISIANA WESTERN,LAW,FIFTH CIRCUIT,8893,1675,67,4,7147,145,70,60,4,11,8748,1605,7,7136,09/30/15,2015-09-30,2015
MISSISSIPPI,MISSISSIPPI NORTHERN,MSN,FIFTH CIRCUIT,4680,1907,14,1,2758,80,53,14,1,12,4600,1854,0,2746,09/30/15,2015-09-30,2015
MISSISSIPPI,MISSISSIPPI SOUTHERN,MSS,FIFTH CIRCUIT,6183,3229,32,3,2919,141,99,29,3,10,6042,3130,3,2909,09/30/15,2015-09-30,2015
TEXAS,TEXAS NORTHERN,TXN,FIFTH CIRCUIT,12325,4937,178,7,7203,658,421,169,7,61,11667,4516,9,7142,09/30/15,2015-09-30,2015
TEXAS,TEXAS EASTERN,TXE,FIFTH CIRCUIT,4626,2056,65,1,2504,325,236,63,1,25,4301,1820,2,2479,09/30/15,2015-09-30,2015
TEXAS,TEXAS SOUTHERN,TXS,FIFTH CIRCUIT,9313,3234,162,2,5911,528,323,150,2,49,8785,2911,12,5862,09/30/15,2015-09-30,2015
TEXAS,TEXAS WESTERN,TXW,FIFTH CIRCUIT,8044,3800,106,0,4132,490,343,100,0,41,7554,3457,6,4091,09/30/15,2015-09-30,2015
KENTUCKY,KENTUCKY EASTERN,KYE,SIXTH CIRCUIT,7981,5581,47,6,2347,164,105,47,6,6,7817,5476,0,2341,09/30/15,2015-09-30,2015
KENTUCKY,KENTUCKY WESTERN,KYW,SIXTH CIRCUIT,7707,5416,22,5,2263,102,63,22,5,11,7605,5353,0,2252,09/30/15,2015-09-30,2015
MICHIGAN,MICHIGAN EASTERN,MIE,SIXTH CIRCUIT,25725,20029,117,10,5568,484,319,105,10,50,25241,19710,12,5518,09/30/15,2015-09-30,2015
MICHIGAN,MICHIGAN WESTERN,MIW,SIXTH CIRCUIT,7597,6159,27,15,1396,192,139,23,15,15,7405,6020,4,1381,09/30/15,2015-09-30,2015
OHIO,OHIO NORTHERN,OHN,SIXTH CIRCUIT,20628,16832,38,0,3758,393,311,36,0,46,20235,16521,2,3712,09/30/15,2015-09-30,2015
OHIO,OHIO SOUTHERN,OHS,SIXTH CIRCUIT,18681,12667,26,6,5982,345,278,23,6,38,18336,12389,3,5944,09/30/15,2015-09-30,2015
TENNESSEE,TENNESSEE EASTERN,TNE,SIXTH CIRCUIT,11614,6172,35,7,5400,162,113,27,7,15,11452,6059,8,5385,09/30/15,2015-09-30,2015
TENNESSEE,TENNESSEE MIDDLE,TNM,SIXTH CIRCUIT,9485,4945,69,1,4470,165,114,41,1,9,9320,4831,28,4461,09/30/15,2015-09-30,2015
TENNESSEE,TENNESSEE WESTERN,TNW,SIXTH CIRCUIT,15545,3654,26,0,11865,108,70,24,0,14,15437,3584,2,11851,09/30/15,2015-09-30,2015
ILLINOIS,ILLINOIS NORTHERN,ILN,SEVENTH CIRCUIT,48601,27866,341,1,20392,1090,715,317,1,56,47511,27151,24,20336,09/30/15,2015-09-30,2015
ILLINOIS,ILLINOIS CENTRAL,ILC,SEVENTH CIRCUIT,5434,4373,26,2,1033,131,85,26,2,18,5303,4288,0,1015,09/30/15,2015-09-30,2015
ILLINOIS,ILLINOIS SOUTHERN,ILS,SEVENTH CIRCUIT,3939,2508,14,5,1412,75,49,14,5,7,3864,2459,0,1405,09/30/15,2015-09-30,2015
INDIANA,INDIANA NORTHERN,INN,SEVENTH CIRCUIT,11033,8132,29,7,2865,119,77,24,7,11,10914,8055,5,2854,09/30/15,2015-09-30,2015
INDIANA,INDIANA SOUTHERN,INS,SEVENTH CIRCUIT,16270,11103,39,6,5122,276,216,37,6,17,15994,10887,2,5105,09/30/15,2015-09-30,2015
WISCONSIN,WISCONSIN EASTERN,WIE,SEVENTH CIRCUIT,14322,10088,21,10,4203,225,173,19,10,23,14097,9915,2,4180,09/30/15,2015-09-30,2015
WISCONSIN,WISCONSIN WESTERN,WIW,SEVENTH CIRCUIT,4827,4019,18,18,772,170,117,14,18,21,4657,3902,4,751,09/30/15,2015-09-30,2015
ARKANSAS,ARKANSAS EASTERN,ARE,EIGHTH CIRCUIT,6773,2891,20,5,3857,124,82,20,5,17,6649,2809,0,3840,09/30/15,2015-09-30,2015
ARKANSAS,ARKANSAS WESTERN,ARW,EIGHTH CIRCUIT,3486,1924,23,9,1530,109,74,18,9,8,3377,1850,5,1522,09/30/15,2015-09-30,2015
IOWA,IOWA NORTHERN,IAN,EIGHTH CIRCUIT,1794,1674,2,7,111,74,59,2,7,6,1720,1615,0,105,09/30/15,2015-09-30,2015
IOWA,IOWA SOUTHERN,IAS,EIGHTH CIRCUIT,2769,2438,12,1,318,105,86,12,1,6,2664,2352,0,312,09/30/15,2015-09-30,2015
MINNESOTA,MINNESOTA,MN,EIGHTH CIRCUIT,10976,9298,40,14,1624,362,293,39,14,16,10614,9005,1,1608,09/30/15,2015-09-30,2015
MISSOURI,MISSOURI EASTERN,MOE,EIGHTH CIRCUIT,11540,7801,14,1,3724,143,112,12,1,18,11397,7689,2,3706,09/30/15,2015-09-30,2015
MISSOURI,MISSOURI WESTERN,MOW,EIGHTH CIRCUIT,8017,5597,31,5,2384,176,127,28,5,16,7841,5470,3,2368,09/30/15,2015-09-30,2015
NEBRASKA,NEBRASKA,NE,EIGHTH CIRCUIT,4244,2848,8,6,1380,90,64,5,6,13,4154,2784,3,1367,09/30/15,2015-09-30,2015
NORTH DAKOTA,NORTH DAKOTA,ND,EIGHTH CIRCUIT,592,539,1,1,51,32,30,0,1,1,560,509,1,50,09/30/15,2015-09-30,2015
SOUTH DAKOTA,SOUTH DAKOTA,SD,EIGHTH CIRCUIT,1110,988,6,5,111,47,25,6,5,11,1063,963,0,100,09/30/15,2015-09-30,2015
ALASKA,ALASKA,AK,NINTH CIRCUIT,426,341,6,0,79,42,29,6,0,7,384,312,0,72,09/30/15,2015-09-30,2015
ARIZONA,ARIZONA,AZ,NINTH CIRCUIT,17448,14835,244,2,2367,582,377,176,2,27,16866,14458,68,2340,09/30/15,2015-09-30,2015
CALIFORNIA,CALIFORNIA NORTHERN,CAN,NINTH CIRCUIT,11892,6668,190,1,5033,647,424,141,1,81,11245,6244,49,4952,09/30/15,2015-09-30,2015
CALIFORNIA,CALIFORNIA EASTERN,CAE,NINTH CIRCUIT,17681,13983,82,14,3601,507,348,68,14,76,17174,13635,14,3525,09/30/15,2015-09-30,2015
CALIFORNIA,CALIFORNIA CENTRAL,CAC,NINTH CIRCUIT,48487,37167,431,3,10886,1833,1457,265,3,108,46654,35710,166,10778,09/30/15,2015-09-30,2015
CALIFORNIA,CALIFORNIA SOUTHERN,CAS,NINTH CIRCUIT,8889,6982,30,1,1876,317,258,21,1,37,8572,6724,9,1839,09/30/15,2015-09-30,2015
HAWAII,HAWAII,HI,NINTH CIRCUIT,1593,1126,14,1,452,80,57,13,1,9,1513,1069,1,443,09/30/15,2015-09-30,2015
IDAHO,IDAHO,ID,NINTH CIRCUIT,4162,3716,19,4,423,146,119,16,4,7,4016,3597,3,416,09/30/15,2015-09-30,2015
MONTANA,MONTANA,MT,NINTH CIRCUIT,1310,1131,6,3,170,57,40,4,3,10,1253,1091,2,160,09/30/15,2015-09-30,2015
NEVADA,NEVADA,NV,NINTH CIRCUIT,9902,7824,194,0,1884,400,273,108,0,19,9502,7551,86,1865,09/30/15,2015-09-30,2015
OREGON,OREGON,OR,NINTH CIRCUIT,11134,9017,25,2,2090,205,151,22,2,30,10929,8866,3,2060,09/30/15,2015-09-30,2015
WASHINGTON,WASHINGTON EASTERN,WAE,NINTH CIRCUIT,4450,3501,12,2,935,75,58,12,2,3,4375,3443,0,932,09/30/15,2015-09-30,2015
WASHINGTON,WASHINGTON WESTERN,WAW,NINTH CIRCUIT,14567,10904,94,1,3568,377,279,69,1,28,14190,10625,25,3540,09/30/15,2015-09-30,2015
GUAM,GUAM,GUAM,NINTH CIRCUIT,133,106,0,0,27,14,13,0,0,1,119,93,0,26,09/30/15,2015-09-30,2015
NORTHERN MARIANA ISLANDS,NORTHERN MARIANAS,NMI,NINTH CIRCUIT,6,5,0,0,1,2,2,0,0,0,4,3,0,1,09/30/15,2015-09-30,2015
COLORADO,COLORADO,CO,TENTH CIRCUIT,15389,12586,86,4,2710,456,345,77,4,27,14933,12241,9,2683,09/30/15,2015-09-30,2015
KANSAS,KANSAS,KS,TENTH CIRCUIT,6998,3984,27,8,2979,174,117,23,8,26,6824,3867,4,2953,09/30/15,2015-09-30,2015
NEW MEXICO,NEW MEXICO,NM,TENTH CIRCUIT,3508,3201,35,3,269,150,107,31,3,9,3358,3094,4,260,09/30/15,2015-09-30,2015
OKLAHOMA,OKLAHOMA NORTHERN,OKN,TENTH CIRCUIT,2523,2206,3,0,313,68,62,2,0,3,2455,2144,1,310,09/30/15,2015-09-30,2015
OKLAHOMA,OKLAHOMA EASTERN,OKE,TENTH CIRCUIT,1459,1282,6,2,168,39,27,6,2,3,1420,1255,0,165,09/30/15,2015-09-30,2015
OKLAHOMA,OKLAHOMA WESTERN,OKW,TENTH CIRCUIT,5213,4101,18,3,1091,130,100,17,3,10,5083,4001,1,1081,09/30/15,2015-09-30,2015
UTAH,UTAH,UT,TENTH CIRCUIT,12520,7666,37,0,4817,216,158,37,0,21,12304,7508,0,4796,09/30/15,2015-09-30,2015
WYOMING,WYOMING,WY,TENTH CIRCUIT,921,822,3,0,96,31,28,2,0,1,890,794,1,95,09/30/15,2015-09-30,2015
ALABAMA,ALABAMA NORTHERN,ALN,ELEVENTH CIRCUIT,12986,6379,61,1,6545,204,138,59,1,6,12782,6241,2,6539,09/30/15,2015-09-30,2015
ALABAMA,ALABAMA MIDDLE,ALM,ELEVENTH CIRCUIT,8175,1565,14,5,6591,107,78,12,5,12,8068,1487,2,6579,09/30/15,2015-09-30,2015
ALABAMA,ALABAMA SOUTHERN,ALS,ELEVENTH CIRCUIT,4344,1224,24,0,3096,50,28,18,0,4,4294,1196,6,3092,09/30/15,2015-09-30,2015
FLORIDA,FLORIDA NORTHERN,FLN,ELEVENTH CIRCUIT,2863,2255,35,4,569,144,107,28,4,5,2719,2148,7,564,09/30/15,2015-09-30,2015
FLORIDA,FLORIDA MIDDLE,FLM,ELEVENTH CIRCUIT,31459,21459,345,16,9637,1227,858,258,16,94,30232,20601,87,9543,09/30/15,2015-09-30,2015
FLORIDA,FLORIDA SOUTHERN,FLS,ELEVENTH CIRCUIT,24728,13934,275,3,10515,679,424,209,3,42,24049,13510,66,10473,09/30/15,2015-09-30,2015
GEORGIA,GEORGIA NORTHERN,GAN,ELEVENTH CIRCUIT,34288,18197,141,7,15942,671,499,133,7,31,33617,17698,8,15911,09/30/15,2015-09-30,2015
GEORGIA,GEORGIA MIDDLE,GAM,ELEVENTH CIRCUIT,9083,2771,21,18,6273,162,88,21,18,35,8921,2683,0,6238,09/30/15,2015-09-30,2015
GEORGIA,GEORGIA SOUTHERN,GAS,ELEVENTH CIRCUIT,7869,1576,14,9,6270,99,69,11,9,10,7770,1507,3,6260,09/30/15,2015-09-30,2015
DISTRICT OF COLUMBIA,DISTRICT OF COLUMBIA,DC,DC CIRCUIT,697,538,27,0,132,45,21,19,0,5,652,517,8,127,09/30/16,2016-09-30,2016
MASSACHUSETTS,MASSACHUSETTS,MA,FIRST CIRCUIT,8866,6012,125,11,2718,416,279,97,11,29,8450,5733,28,2689,09/30/16,2016-09-30,2016
MAINE,MAINE,ME,FIRST CIRCUIT,1613,1323,11,4,275,96,72,8,4,12,1517,1251,3,263,09/30/16,2016-09-30,2016
NEW HAMPSHIRE,NEW HAMPSHIRE,NH,FIRST CIRCUIT,1877,1412,17,1,447,173,122,16,1,34,1704,1290,1,413,09/30/16,2016-09-30,2016
PUERTO RICO,PUERTO RICO,PR,FIRST CIRCUIT,5529,2351,125,9,3044,215,50,117,9,39,5314,2301,8,3005,09/30/16,2016-09-30,2016
RHODE ISLAND,RHODE ISLAND,RI,FIRST CIRCUIT,2362,1805,7,0,550,78,65,6,0,7,2284,1740,1,543,09/30/16,2016-09-30,2016
CONNECTICUT,CONNECTICUT,CT,SECOND CIRCUIT,5909,4709,75,3,1122,259,173,66,3,17,5650,4536,9,1105,09/30/16,2016-09-30,2016
NEW YORK,NEW YORK EASTERN,NYE,SECOND CIRCUIT,11843,8677,197,1,2968,480,299,166,1,14,11363,8378,31,2954,09/30/16,2016-09-30,2016
NEW YORK,NEW YORK NORTHERN,NYN,SECOND CIRCUIT,6237,4825,40,20,1352,184,102,37,20,25,6053,4723,3,1327,09/30/16,2016-09-30,2016
NEW YORK,NEW YORK SOUTHERN,NYS,SECOND CIRCUIT,7627,5436,479,1,1664,772,244,452,1,28,6855,5192,27,1636,09/30/16,2016-09-30,2016
NEW YORK,NEW YORK WESTERN,NYW,SECOND CIRCUIT,4182,2972,39,3,1168,172,102,37,3,30,4010,2870,2,1138,09/30/16,2016-09-30,2016
VERMONT,VERMONT,VT,SECOND CIRCUIT,603,489,1,0,113,46,39,1,0,6,557,450,0,107,09/30/16,2016-09-30,2016
DELAWARE,DELAWARE,DE,THIRD CIRCUIT,2879,1504,584,0,739,747,107,584,0,4,2132,1397,0,735,09/30/16,2016-09-30,2016
NEW JERSEY,NEW JERSEY,NJ,THIRD CIRCUIT,25633,16880,248,5,8498,775,489,194,5,85,24858,16391,54,8413,09/30/16,2016-09-30,2016
PENNSYLVANIA,PENNSYLVANIA EASTERN,PAE,THIRD CIRCUIT,9335,4910,85,2,4338,322,186,77,2,57,9013,4724,8,4281,09/30/16,2016-09-30,2016
PENNSYLVANIA,PENNSYLVANIA MIDDLE,PAM,THIRD CIRCUIT,5457,3424,32,2,1999,165,98,31,2,34,5292,3326,1,1965,09/30/16,2016-09-30,2016
PENNSYLVANIA,PENNSYLVANIA WESTERN,PAW,THIRD CIRCUIT,7157,4512,104,8,2533,284,156,92,8,28,6873,4356,12,2505,09/30/16,2016-09-30,2016
VIRGIN ISLANDS,VIRGIN ISLANDS,VI,THIRD CIRCUIT,24,18,0,0,6,2,0,0,0,0,22,16,0,6,09/30/16,2016-09-30,2016
MARYLAND,MARYLAND,MD,FOURTH CIRCUIT,17213,11475,137,6,5595,371,224,95,6,46,16842,11251,42,5549,09/30/16,2016-09-30,2016
NORTH CAROLINA,NORTH CAROLINA EASTERN,NCE,FOURTH CIRCUIT,6765,2223,80,8,4454,204,90,61,8,45,6561,2133,19,4409,09/30/16,2016-09-30,2016
NORTH CAROLINA,NORTH CAROLINA MIDDLE,NCM,FOURTH CIRCUIT,4019,1682,17,0,2320,123,96,16,0,11,3896,1586,1,2309,09/30/16,2016-09-30,2016
NORTH CAROLINA,NORTH CAROLINA WESTERN,NCW,FOURTH CIRCUIT,4300,2212,39,1,2048,141,88,33,1,19,4159,2124,6,2029,09/30/16,2016-09-30,2016
SOUTH CAROLINA,SOUTH CAROLINA,SC,FOURTH CIRCUIT,6730,2652,29,7,4040,156,109,26,7,12,6574,2543,3,4028,09/30/16,2016-09-30,2016
VIRGINIA,VIRGINIA EASTERN,VAE,FOURTH CIRCUIT,17375,9906,106,3,7358,351,234,87,3,25,17024,9672,19,7333,09/30/16,2016-09-30,2016
VIRGINIA,VIRGINIA WESTERN,VAW,FOURTH CIRCUIT,5595,3407,21,7,2160,84,50,18,7,9,5511,3357,3,2151,09/30/16,2016-09-30,2016
WEST VIRGINIA,WEST VIRGINIA NORTHERN,WVN,FOURTH CIRCUIT,1336,1119,15,1,201,50,33,15,1,1,1286,1086,0,200,09/30/16,2016-09-30,2016
WEST VIRGINIA,WEST VIRGINIA SOUTHERN,WVS,FOURTH CIRCUIT,2,1752,32,0,216,83,43,31,0,9,1917,1709,1,207,09/30/16,2016-09-30,2016
LOUISIANA,LOUISIANA EASTERN,LAE,FIFTH CIRCUIT,3361,1549,25,0,1787,117,81,24,0,12,3244,1468,1,1775,09/30/16,2016-09-30,2016
LOUISIANA,LOUISIANA MIDDLE,LAM,FIFTH CIRCUIT,1518,798,14,0,702,41,22,13,0,2,1477,776,1,700,09/30/16,2016-09-30,2016
LOUISIANA,LOUISIANA WESTERN,LAW,FIFTH CIRCUIT,8945,1721,64,7,7153,165,82,56,7,20,8780,1639,8,7133,09/30/16,2016-09-30,2016
MISSISSIPPI,MISSISSIPPI NORTHERN,MSN,FIFTH CIRCUIT,4656,1942,16,9,2689,92,51,16,9,16,4564,1891,0,2673,09/30/16,2016-09-30,2016
MISSISSIPPI,MISSISSIPPI SOUTHERN,MSS,FIFTH CIRCUIT,6619,3491,38,1,3089,172,123,35,1,13,6447,3368,3,3076,09/30/16,2016-09-30,2016
TEXAS,TEXAS EASTERN,TXE,FIFTH CIRCUIT,4718,2067,84,0,2567,334,227,76,0,31,4384,1840,8,2536,09/30/16,2016-09-30,2016
TEXAS,TEXAS NORTHERN,TXN,FIFTH CIRCUIT,12104,4784,205,7,7106,719,442,197,7,71,11385,4342,8,7035,09/30/16,2016-09-30,2016
TEXAS,TEXAS SOUTHERN,TXS,FIFTH CIRCUIT,9013,3203,314,2,5488,700,335,307,2,51,8313,2868,7,5437,09/30/16,2016-09-30,2016
TEXAS,TEXAS WESTERN,TXW,FIFTH CIRCUIT,7845,3730,178,0,3924,586,362,170,0,41,7259,3368,8,3883,09/30/16,2016-09-30,2016
KENTUCKY,KENTUCKY EASTERN,KYE,SIXTH CIRCUIT,7890,5434,15,4,2437,106,75,14,4,13,7784,5359,1,2424,09/30/16,2016-09-30,2016
KENTUCKY,KENTUCKY WESTERN,KYW,SIXTH CIRCUIT,7417,4803,17,11,2585,118,76,16,11,14,7299,4727,1,2571,09/30/16,2016-09-30,2016
MICHIGAN,MICHIGAN EASTERN,MIE,SIXTH CIRCUIT,24250,18670,116,16,5448,406,242,100,16,48,23844,18428,16,5400,09/30/16,2016-09-30,2016
MICHIGAN,MICHIGAN WESTERN,MIW,SIXTH CIRCUIT,7116,5656,28,4,1428,186,138,24,4,20,6930,5518,4,1408,09/30/16,2016-09-30,2016
OHIO,OHIO NORTHERN,OHN,SIXTH CIRCUIT,19686,16016,74,0,3596,360,241,70,0,49,19326,15775,4,3547,09/30/16,2016-09-30,2016
OHIO,OHIO SOUTHERN,OHS,SIXTH CIRCUIT,17617,12022,15,2,5578,263,199,14,2,48,17354,11823,1,5530,09/30/16,2016-09-30,2016
TENNESSEE,TENNESSEE EASTERN,TNE,SIXTH CIRCUIT,11425,5984,53,8,5380,212,138,45,8,21,11213,5846,8,5359,09/30/16,2016-09-30,2016
TENNESSEE,TENNESSEE MIDDLE,TNM,SIXTH CIRCUIT,9574,4830,75,0,4669,180,106,57,0,17,9394,4724,18,4652,09/30/16,2016-09-30,2016
TENNESSEE,TENNESSEE WESTERN,TNW,SIXTH CIRCUIT,14997,3528,35,0,11434,100,52,29,0,19,14897,3476,6,11415,09/30/16,2016-09-30,2016
ILLINOIS,ILLINOIS CENTRAL,ILC,SEVENTH CIRCUIT,5163,4217,4,3,939,104,84,4,3,13,5059,4133,0,926,09/30/16,2016-09-30,2016
ILLINOIS,ILLINOIS NORTHERN,ILN,SEVENTH CIRCUIT,45832,25550,121,3,20155,757,571,110,3,70,45075,24979,11,20085,09/30/16,2016-09-30,2016
ILLINOIS,ILLINOIS SOUTHERN,ILS,SEVENTH CIRCUIT,3855,2532,5,5,1313,81,56,5,5,15,3774,2476,0,1298,09/30/16,2016-09-30,2016
INDIANA,INDIANA NORTHERN,INN,SEVENTH CIRCUIT,10026,7210,34,5,2777,166,115,31,5,15,9860,7095,3,2762,09/30/16,2016-09-30,2016
INDIANA,INDIANA SOUTHERN,INS,SEVENTH CIRCUIT,14666,9873,35,4,4754,229,172,35,4,18,14437,9701,0,4736,09/30/16,2016-09-30,2016
WISCONSIN,WISCONSIN EASTERN,WIE,SEVENTH CIRCUIT,12817,8471,26,16,4304,232,163,24,16,29,12585,8308,2,4275,09/30/16,2016-09-30,2016
WISCONSIN,WISCONSIN WESTERN,WIW,SEVENTH CIRCUIT,4498,3676,20,20,782,177,112,17,20,28,4321,3564,3,754,09/30/16,2016-09-30,2016
ARKANSAS,ARKANSAS EASTERN,ARE,EIGHTH CIRCUIT,7269,3159,14,8,4088,150,110,14,8,18,7119,3049,0,4070,09/30/16,2016-09-30,2016
ARKANSAS,ARKANSAS WESTERN,ARW,EIGHTH CIRCUIT,3265,1759,15,7,1484,104,68,12,7,17,3161,1691,3,1467,09/30/16,2016-09-30,2016
IOWA,IOWA NORTHERN,IAN,EIGHTH CIRCUIT,1714,1553,1,10,150,88,72,1,10,5,1626,1481,0,145,09/30/16,2016-09-30,2016
IOWA,IOWA SOUTHERN,IAS,EIGHTH CIRCUIT,2636,2271,6,9,350,104,82,6,9,7,2532,2189,0,343,09/30/16,2016-09-30,2016
MINNESOTA,MINNESOTA,MN,EIGHTH CIRCUIT,9773,8213,23,13,1524,325,273,23,13,16,9448,7940,0,1508,09/30/16,2016-09-30,2016
MISSOURI,MISSOURI EASTERN,MOE,EIGHTH CIRCUIT,11100,7107,272,5,3716,418,115,270,5,28,10682,6992,2,3688,09/30/16,2016-09-30,2016
MISSOURI,MISSOURI WESTERN,MOW,EIGHTH CIRCUIT,7468,5114,27,2,2324,139,93,26,2,17,7329,5021,1,2307,09/30/16,2016-09-30,2016
NORTH DAKOTA,NORTH DAKOTA,ND,EIGHTH CIRCUIT,666,574,7,5,80,34,21,6,5,2,632,553,1,78,09/30/16,2016-09-30,2016
NEBRASKA,NEBRASKA,NE,EIGHTH CIRCUIT,4114,2701,17,14,1381,111,65,15,14,16,4003,2636,2,1365,09/30/16,2016-09-30,2016
SOUTH DAKOTA,SOUTH DAKOTA,SD,EIGHTH CIRCUIT,1078,969,2,4,103,40,25,0,4,11,1038,944,2,92,09/30/16,2016-09-30,2016
ALASKA,ALASKA,AK,NINTH CIRCUIT,433,354,20,0,59,46,24,20,0,2,387,330,0,57,09/30/16,2016-09-30,2016
ARIZONA,ARIZONA,AZ,NINTH CIRCUIT,15894,13059,258,2,2575,556,329,191,2,34,15338,12730,67,2541,09/30/16,2016-09-30,2016
CALIFORNIA,CALIFORNIA CENTRAL,CAC,NINTH CIRCUIT,42222,31080,456,9,10676,1755,1379,282,9,84,40467,29701,174,10592,09/30/16,2016-09-30,2016
CALIFORNIA,CALIFORNIA EASTERN,CAE,NINTH CIRCUIT,15525,11867,70,15,3572,520,361,51,15,92,15005,11506,19,3480,09/30/16,2016-09-30,2016
CALIFORNIA,CALIFORNIA NORTHERN,CAN,NINTH CIRCUIT,10603,5540,185,2,4876,575,355,108,2,110,10028,5185,77,4766,09/30/16,2016-09-30,2016
CALIFORNIA,CALIFORNIA SOUTHERN,CAS,NINTH CIRCUIT,8261,6402,38,1,1820,310,249,24,1,36,7951,6153,14,1784,09/30/16,2016-09-30,2016
GUAM,GUAM,GUAM,NINTH CIRCUIT,115,92,0,0,23,7,7,0,0,0,108,85,0,23,09/30/16,2016-09-30,2016
HAWAII,HAWAII,HI,NINTH CIRCUIT,1463,982,20,0,461,58,32,19,0,7,1405,950,1,454,09/30/16,2016-09-30,2016
IDAHO,IDAHO,ID,NINTH CIRCUIT,3841,3395,16,2,428,93,73,12,2,6,3748,3322,4,422,09/30/16,2016-09-30,2016
MONTANA,MONTANA,MT,NINTH CIRCUIT,1365,1143,11,4,207,62,38,11,4,9,1303,1105,0,198,09/30/16,2016-09-30,2016
NORTHERN MARIANA ISLANDS,NORTHERN MARIANAS,NMI,NINTH CIRCUIT,7,4,2,0,1,3,0,0,0,0,4,3,0,1,09/30/16,2016-09-30,2016
NEVADA,NEVADA,NV,NINTH CIRCUIT,9062,6957,203,0,1897,299,164,105,0,25,8763,6793,98,1872,09/30/16,2016-09-30,2016
OREGON,OREGON,OR,NINTH CIRCUIT,9488,7434,26,5,2022,228,155,25,5,42,9260,7279,1,1980,09/30/16,2016-09-30,2016
WASHINGTON,WASHINGTON EASTERN,WAE,NINTH CIRCUIT,4120,3119,10,3,988,75,52,9,3,11,4045,3067,1,977,09/30/16,2016-09-30,2016
WASHINGTON,WASHINGTON WESTERN,WAW,NINTH CIRCUIT,12735,9176,99,3,3456,348,248,66,3,31,12387,8928,33,3425,09/30/16,2016-09-30,2016
COLORADO,COLORADO,CO,TENTH CIRCUIT,13190,10476,74,0,2638,407,301,71,0,33,12783,10175,3,2605,09/30/16,2016-09-30,2016
KANSAS,KANSAS,KS,TENTH CIRCUIT,6550,3774,109,18,2649,254,99,105,18,32,6296,3675,4,2617,09/30/16,2016-09-30,2016
NEW MEXICO,NEW MEXICO,NM,TENTH CIRCUIT,3315,2971,31,2,311,116,82,27,2,5,3199,2889,4,306,09/30/16,2016-09-30,2016
OKLAHOMA,OKLAHOMA EASTERN,OKE,TENTH CIRCUIT,1371,1241,5,5,119,38,26,5,5,1,1333,1215,0,118,09/30/16,2016-09-30,2016
OKLAHOMA,OKLAHOMA NORTHERN,OKN,TENTH CIRCUIT,2459,2189,4,2,264,52,46,4,2,0,2407,2143,0,264,09/30/16,2016-09-30,2016
OKLAHOMA,OKLAHOMA WESTERN,OKW,TENTH CIRCUIT,5330,4152,29,0,1149,145,115,24,0,6,5185,4037,5,1143,09/30/16,2016-09-30,2016
UTAH,UTAH,UT,TENTH CIRCUIT,11667,6907,28,0,4732,213,152,26,0,35,11454,6755,2,4697,09/30/16,2016-09-30,2016
WYOMING,WYOMING,WY,TENTH CIRCUIT,936,830,4,0,100,40,33,4,0,1,896,797,0,99,09/30/16,2016-09-30,2016
ALABAMA,ALABAMA MIDDLE,ALM,ELEVENTH CIRCUIT,8004,1664,14,0,6326,73,52,14,0,7,7931,1612,0,6319,09/30/16,2016-09-30,2016
ALABAMA,ALABAMA NORTHERN,ALN,ELEVENTH CIRCUIT,13618,6600,26,1,6991,157,124,23,1,9,13461,6476,3,6982,09/30/16,2016-09-30,2016
ALABAMA,ALABAMA SOUTHERN,ALS,ELEVENTH CIRCUIT,4463,1235,21,0,3207,48,26,17,0,5,4415,1209,4,3202,09/30/16,2016-09-30,2016
FLORIDA,FLORIDA MIDDLE,FLM,ELEVENTH CIRCUIT,25940,17281,325,17,8315,1010,684,237,17,70,24930,16597,88,8245,09/30/16,2016-09-30,2016
FLORIDA,FLORIDA NORTHERN,FLN,ELEVENTH CIRCUIT,2457,1937,42,3,475,150,103,38,3,6,2307,1834,4,469,09/30/16,2016-09-30,2016
FLORIDA,FLORIDA SOUTHERN,FLS,ELEVENTH CIRCUIT,19305,10140,278,2,8881,625,362,212,2,45,18680,9778,66,8836,09/30/16,2016-09-30,2016
GEORGIA,GEORGIA MIDDLE,GAM,ELEVENTH CIRCUIT,8380,2576,31,31,5742,196,105,31,31,29,8184,2471,0,5713,09/30/16,2016-09-30,2016
GEORGIA,GEORGIA NORTHERN,GAN,ELEVENTH CIRCUIT,32399,16450,118,1,15830,611,464,110,1,36,31788,15986,8,15794,09/30/16,2016-09-30,2016
GEORGIA,GEORGIA SOUTHERN,GAS,ELEVENTH CIRCUIT,7291,1435,29,9,5818,109,61,27,9,12,7182,1374,2,5806,09/30/16,2016-09-30,2016
